id,name,shares,likes,loves,wow,cares,sad,angry,haha,reactions_count,comments,Summary,posted_on,Video_URL,Image_URL,URL,Positive_Reactions,Negative_Reactions,Sentiment Analysis,Rating
pfbid0wyNiKAyDaHYJqCGQMCTW5xABvUHu46jd4aSMgD3TPGahLk7ujmb9t3Mi9fXhrC9Vl,OpenAI,284,1300,136,109,0,0,0,0,1545,733,"We're releasing an API for accessing new AI models developed by OpenAI. You can ""program"" the API in natural language with just a few examples of your task. See how companies are using the API today, or join our waitlist: https://beta.openai.com",2020-06-11T00:00:00,['blob:https://www.facebook.com/c170d012-b239-45aa-9943-d87262575034'],https://scontent.fcai19-7.fna.fbcdn.net/v/t15.13418-10/103479749_631282460792212_6062680365921539734_n.jpg?stp=dst-jpg_p180x540&_nc_cat=110&ccb=1-7&_nc_sid=ad6a45&_nc_ohc=kPjD5Jy4JdgAX9Yg5bO&_nc_ht=scontent.fcai19-7.fna&oh=00_AfA4v2AuR2pKSrR-iAf94DihRTAmGyOZnkiHysy0HAvOgA&oe=64E18B04,https://www.facebook.com/openai/posts/pfbid0wyNiKAyDaHYJqCGQMCTW5xABvUHu46jd4aSMgD3TPGahLk7ujmb9t3Mi9fXhrC9Vl?__cft__[0]=AZWSsvRXVjkonxu6jpY5OIMHPk8qHmkm49FjE1CGyYM_C2vJC11bjblk3YyqBhoIPsforMrV1iTE2MHNrSxexhLe_eQaXbAOceM73AkYVSlYV9-hojhdzuRFcHGiO9ZXC5sECi5y7wGjboUrG5eNfnFWShTP9_CqJijXtadPmmxoalpwShPS2fJoahEeyZ7873QkN_-zocnkT4blWrwiUZyGIlcYE9rYp3H3Bc2niJFwHA&__tn__=%2CO%2CP-R,1829,0,positive,1829
pfbid0GZpryjspf2Eoj5Bpa8sXd4ieZtkB4F94ok23H9KJH5Es1zYVjTp6UmzEa5H1aCGGl,OpenAI,33,510,37,0,0,0,0,0,547,104,"Since 2012, the amount of compute for training to AlexNet-level performance on ImageNet has been decreasing exponentially — halving every 16 months, in total a 44x improvement. By contrast, Moore's Law would only have yielded an 11x cost improvement: https://openai.com/blog/ai-and-efficiency/",2020-05-05T00:00:00,[],https://scontent.fcai19-7.fna.fbcdn.net/v/t1.6435-9/95582019_1399137263608215_6705405446204686336_n.png?stp=dst-png_s960x960&_nc_cat=104&ccb=1-7&_nc_sid=730e14&_nc_ohc=T6CcLRuGX6MAX9PP9oV&_nc_ht=scontent.fcai19-7.fna&oh=00_AfBEr71MbSpwwDjTzJ1Ej_m9-Adyn-DK7X9K2gbosBEb2A&oe=6504C4A3,https://www.facebook.com/openai/posts/pfbid0GZpryjspf2Eoj5Bpa8sXd4ieZtkB4F94ok23H9KJH5Es1zYVjTp6UmzEa5H1aCGGl?__cft__[0]=AZXv8UTFSPHL9ffYYQPCmmT-O3k14hB2BtPuEdALqoYZwchcir7oBbiZ4VnwJjZIo6VqK6MmIivZ2tuHliyNtFIYmjsWAyi0MT6u-L-HPkwOiGySPE4PUd2pVjR4ifMhiZhiNyW4ECaZ3kwU1bGaOoyn32BTSW-MdrDUNjYbRlVNXk1IiZ89vCmqpAq9-ZpUdapIfUwwoEy0fedssTsYijHj&__tn__=%2CO%2CP-R,580,0,positive,580
pfbid033pMwdo8Pxp5E5N3GdKfFdosTt4exRnSAMPp7UfjQosTuB4uZLTtKbNP3zJkZLuTdl,OpenAI,114,485,55,39,0,0,0,0,579,55,"Introducing Jukebox, a neural net that generates music, including rudimentary singing, as raw audio in a variety of genres and artist styles. We're releasing a tool for everyone to explore the generated samples, as well as the model and code: https://openai.com/blog/jukebox/",2020-04-30T00:00:00,['blob:https://www.facebook.com/19318294-e052-46f0-992b-0a877967f978'],https://scontent.fcai19-7.fna.fbcdn.net/v/t15.13418-10/94976179_802439936951914_8132937521811161088_n.jpg?stp=dst-jpg_p640x640&_nc_cat=102&ccb=1-7&_nc_sid=ad6a45&_nc_ohc=33Bg0zDjmsUAX_QOYKC&_nc_ht=scontent.fcai19-7.fna&oh=00_AfA2OqS8r1gN72Csz_YdQnE2UJbZ9HFXhS0wv4iWUUSVQw&oe=64E24189,https://www.facebook.com/openai/posts/pfbid033pMwdo8Pxp5E5N3GdKfFdosTt4exRnSAMPp7UfjQosTuB4uZLTtKbNP3zJkZLuTdl?__cft__[0]=AZXA8oizn3il5GqcKkuwy1RblO0uewZ72BASTWANzbZa55LwNI7aclWv9oHG7KvxzivmOMryhNheJ8kvdJ7NKi8wsWDN_djo31lPvZ0wO78Qj_l_EIo1if5qJK8bNeg3sGjtN9ghacpOIDe_Ckr9HCprkV9vigi0JCv68neW8MhiFgmsqJ_nnZZ_xH-x2cx9fuqVqf9gZHs2CBHmBXjZdWbMTsXhI3POXtTxcrurB5RIZw&__tn__=%2CO%2CP-R,693,0,positive,693
pfbid02NfLZeZ48Mp9Htu2zLSf715ogRjSc9xAh1Edipa3P7bdfCVZaaqcMyJjXHAJ6u494l,OpenAI,116,635,60,0,0,0,0,0,695,50,We're standardizing OpenAI's deep learning framework on PyTorch to increase our research productivity at scale on GPUs (and have just released a PyTorch version of Spinning Up in Deep RL): https://twitter.com/OpenAI/status/1222927584033247232,2020-01-30T00:00:00,[],https://scontent.fcai19-7.fna.fbcdn.net/v/t1.6435-9/83896874_1320269424828333_6405901231872540672_n.png?stp=dst-png_s960x960&_nc_cat=108&ccb=1-7&_nc_sid=730e14&_nc_ohc=BZ4676CQm60AX_GRHXE&_nc_ht=scontent.fcai19-7.fna&oh=00_AfCHlmcG__Irhtp8Fm-g0KEvpHwvDP-xrHbRItVwBBz7Sw&oe=6504ECC9,https://www.facebook.com/openai/posts/pfbid02NfLZeZ48Mp9Htu2zLSf715ogRjSc9xAh1Edipa3P7bdfCVZaaqcMyJjXHAJ6u494l?__cft__[0]=AZWhwSjQ9ULOHM5yeH75B-SFEcAIaw9iT0Ctbb8he9DWJ0ZRoWmKat6UbeQ1fnz9NZhtlUJFRt75IF-fNBfZDAg7D62W01XKSZlTX_RzRMFUrJi4T5ePl8rlMFM7OOPeyjxt8HqYgjxxqmdCQPYJsfAEk10MQHaos_6Hc4fcFdJ0ZeUPa_IVMG9T1JBc7g3NbiMcVhDkmDlD4Y1STEKCVTm2&__tn__=%2CO%2CP-R,811,0,positive,811
pfbid0NnmKiKds5X5PH3WoG4AJEt7MgMJ2LeJ3HFVnFqm224ttfZCcUCFdMocTz2mrLTLyl,OpenAI,44,416,41,0,0,0,0,0,457,30,"We're releasing ""Dota 2 with Large Scale Deep Reinforcement Learning"", a scientific paper analyzing our findings from our 3-year Dota project: https://openai.com/projects/five/One highlight — we trained a new agent, Rerun, which has a 98% win rate vs the version that beat @OGEsports.",2019-12-13T00:00:00,[],https://external.fcai19-7.fna.fbcdn.net/emg1/v/t13/10332535334742334873?url=https%3A%2F%2Fopenai.com%2Fcontent%2Fimages%2F2019%2F12%2FOPEN_AI_DOTA_FINALS_3_DSC1231.JPG&fb_obo=1&utld=openai.com&stp=c0.95.2000.1044a_dst-jpg_flffffff_q75_s500x261&ccb=13-1&oh=06_AbGWdmxc1cQEMgj8anWhzBSDfGVwWLALAPp7NruWeL6LSg&oe=64DECBFA&_nc_sid=ff403b,https://www.facebook.com/openai/posts/pfbid0NnmKiKds5X5PH3WoG4AJEt7MgMJ2LeJ3HFVnFqm224ttfZCcUCFdMocTz2mrLTLyl?__cft__[0]=AZUT5LThj4xX81WV7-Wy6Swsi5Ozy90FdgxRKax_BBP9BArzW6yx04LOImPxJWbBxfR_kO6Wta6Dr5RvhMKCL-2ZHO1ftLqY0DFzVU5U-s3631QAhazw4rKTPvX0PF_O8MEgWZntuKIPvdIjgQjlbv3hWQxNpW4nMB2hJyKOtKmp6POjFn2_qKMM1iHiZX8SkEnlTdiiMoUUC9gLVl2ytKgV&__tn__=%2CO%2CP-R,501,0,positive,501
pfbid0heWDwGwrYD1c6emE1z3kPjZyoAvd1CLavPQVdq3ia21N4URJ4Ex5J5fDYSwA3mqsl,OpenAI,43,306,0,24,0,0,0,0,330,16,"A surprising deep learning mystery:Contrary to conventional wisdom, performance of unregularized CNNs, ResNets, and transformers is non-monotonic: improves, then gets worse, then improves again with increasing model size, data size, or training time.https://openai.com/blog/deep-double-descent/",2019-12-05T00:00:00,[],https://scontent.fcai19-7.fna.fbcdn.net/v/t1.6435-9/79932933_1270728539782422_5130827674796687360_n.png?stp=dst-png_s1080x2048&_nc_cat=105&ccb=1-7&_nc_sid=730e14&_nc_ohc=BT9xUP0tF-kAX8103BE&_nc_ht=scontent.fcai19-7.fna&oh=00_AfBaswfqTJStIgwUT1-pDyL1cU3gGUXixwFdksruNNMgHw&oe=6504F6A0,https://www.facebook.com/openai/posts/pfbid0heWDwGwrYD1c6emE1z3kPjZyoAvd1CLavPQVdq3ia21N4URJ4Ex5J5fDYSwA3mqsl?__cft__[0]=AZVNpZ-BUh5rdjI4zBgCSGvl6HQHVl5DPftcCEUbi9ZrU5LPsWWzc6fre4yY3X1sN4zft8zrs63yCsydch4oIufXTxS1Kzh4H5bRngMZdf2toSjAt9mwG2XDwkDVK7blJ06Eb3idKo343uNnBgQzmfMpx2mll2WuDaPAKX5DolWBx-z4b91P5544VkEZbl8TViVI07fMECmEcTQlkHfUbfru&__tn__=%2CO%2CP-R,373,0,positive,373
pfbid0H1VNW8bkz4EquMXwRvoheTJEB7xCdPtwKF1pVuRLFp6nWjFAYEinonbVrpbTmqsWl,OpenAI,40,215,19,0,0,0,0,0,234,9,"We're releasing Procgen Benchmark, 16 procedurally-generated environments for measuring how quickly a reinforcement learning agent learns generalizable skills.This has become the standard research platform used by the OpenAI RL team: https://openai.com/blog/procgen-benchmark/",2019-12-03T00:00:00,['blob:https://www.facebook.com/7e8cf079-ff3c-4241-b978-40b60731f30e'],https://external.fcai19-7.fna.fbcdn.net/emg1/v/t13/143141077403433689?url=https%3A%2F%2Fopenai.com%2Fcontent%2Fimages%2F2019%2F12%2Fog-image.jpg&fb_obo=1&utld=openai.com&stp=c0.5000x0.5000f_dst-jpg_flffffff_p500x261_q75&ccb=13-1&oh=06_AbGwHxGU6Qjc2h0nXcN-E3sJ7M1lIXnhuaNP0Kv_R2G1ug&oe=64DF5514&_nc_sid=dbad39 https://static.xx.fbcdn.net/rsrc.php/v3/yw/r/8iuTX4LlGZO.png,https://www.facebook.com/openai/posts/pfbid0H1VNW8bkz4EquMXwRvoheTJEB7xCdPtwKF1pVuRLFp6nWjFAYEinonbVrpbTmqsWl?__cft__[0]=AZU19V0pXLXUAk4FulcpP2VDishP4f0db1ZkSMJJJEVrsm4GiLvIb68po4QTSPU20_hQ9DM2J5n-h0wxW_n3lWgypuf8NCjWm_0Vw2L0DM0X4aqUC0Awc0nMuRcpDnjqr47KqrRaAN18ZSFKiI--YDf1hpTNGQU-6pV7inV-FiMqv0STvflsBna7Vywt1jyfgEqpGQFTSW1ahftilF-Nk7Qr&__tn__=%2CO%2CP-R,274,0,positive,274
pfbid02fXeBNpL8rVqLEecszKyAR7fQHuT65RpAv1cLEiiPXgL2E5kbCeSp2R9dYxE9x19al,OpenAI,36,191,24,0,0,0,0,0,215,8,"We're releasing Safety Gym, environments and tools to evaluate reinforcement learning with safety constraints: https://openai.com/blog/safety-gym/Aims to ultimately help agents satisfy real-world safety requirements while training (eg not driving off a cliff, not writing abusive content).",2019-11-21T00:00:00,[],https://external.fcai19-7.fna.fbcdn.net/emg1/v/t13/11810377064647312513?url=https%3A%2F%2Fopenai.com%2Fcontent%2Fimages%2F2019%2F11%2Fsafety-gym-cover-2.png&fb_obo=1&utld=openai.com&stp=c0.5000x0.5000f_dst-jpg_flffffff_p500x261_q75&ccb=13-1&oh=06_AbH5YIb64FCuwB1o8MUmdfrNiqjMzPJ-eU-a6b_iyGWqWg&oe=64DF0F77&_nc_sid=dbad39,https://www.facebook.com/openai/posts/pfbid02fXeBNpL8rVqLEecszKyAR7fQHuT65RpAv1cLEiiPXgL2E5kbCeSp2R9dYxE9x19al?__cft__[0]=AZW4LBbTAc9s7OTiwgsYEngQHRbtJRvh1uSMhJ8JzgDgHBhUXN9e1MczUxlGiSnsk0a0jhIeDDjQhXCTWCkhoxFRF2baCAj4E6v_iaOBoVmjIeI6PkdvBjUSEeuMgZqcEuKgMzVr7BmhjPPJQOFpgCgOHWnsWbckeaE307YOMZ9GCN9vIPScY7VSu3UWmRMoAUPGuXRCGREjEVOQUlw_mVv1&__tn__=%2CO%2CP-R,251,0,positive,251
pfbid02QERFULs4n5rCSWgMsLhU4dCZhpZCNpwG3UZBqxAhsQQ231AHC1LwXZuCQZyPspX1l,OpenAI,57,252,30,22,0,0,0,0,304,43,We're releasing the 1.5billion parameter GPT-2 model as part of our staged release publication strategy.- GPT-2 output detection model: https://github.com/.../gpt-2-output.../tree/master/detector- Research from partners on potential malicious uses: https://d4mucfpksywv.cloudfront.net/papers/GPT_2_Report.pdf- More details: https://openai.com/blog/gpt-2-1-5b-release/,2019-11-05T00:00:00,[],https://scontent.fcai19-7.fna.fbcdn.net/v/t1.6435-9/75543459_1244743475714262_1371225926234275840_n.jpg?_nc_cat=111&ccb=1-7&_nc_sid=730e14&_nc_ohc=jyvMs7WmlCoAX_7ZNM3&_nc_ht=scontent.fcai19-7.fna&oh=00_AfDX2SONpVeGrHjTt86c6dQSoJ38MgOeilCTMfpkIzzVDQ&oe=6504D32E,https://www.facebook.com/openai/posts/pfbid02QERFULs4n5rCSWgMsLhU4dCZhpZCNpwG3UZBqxAhsQQ231AHC1LwXZuCQZyPspX1l?__cft__[0]=AZVKwef58onP-ryB0tSv4_zWFp-N-6RHx6yghLJz8LPNfsOjWz9XdoU2AwzAgduUjVHf88XgcQvfwCq0U9Tp0XSXLE3XXnIhghz6X_carB7TZJotOWRuzthKIp96FJQ6aUzTDfI33VAp9lbY6zM6D3j24F80RrKnIhA1r1RcK9TuO6iCnMAcf4--4S7bOOdmqrtT9NgIOY38J2NyBj8ULqaH&__tn__=%2CO%2CP-R,361,0,positive,361
pfbid0vdj795MTWCXQP3x4WXnpA9HN4Pwj8QNLSJueZeCuXWe2bUX3H1nScBFvJf2z7m54l,OpenAI,31,409,56,0,0,0,0,0,465,49,"""Solving the Rubik's Cube with a Robot Hand"" took many human hands over the past 2.5 years — meet our Robotics team! (PS they're hiring: https://openai.com/jobs/!)",2019-10-16T00:00:00,[],https://scontent.fcai19-7.fna.fbcdn.net/v/t1.6435-9/72568141_1227404510781492_891891542887759872_n.jpg?stp=dst-jpg_p180x540&_nc_cat=110&ccb=1-7&_nc_sid=730e14&_nc_ohc=uGO1MofKJcUAX9rJlEr&_nc_ht=scontent.fcai19-7.fna&oh=00_AfB6Rexh8t0Fey7w22fVs4texKPZjEiXFEAtdjf6z6bqcg&oe=6504DC57,https://www.facebook.com/openai/posts/pfbid0vdj795MTWCXQP3x4WXnpA9HN4Pwj8QNLSJueZeCuXWe2bUX3H1nScBFvJf2z7m54l?__cft__[0]=AZVGgB1tw92FCZ2XHah6Ae6c3Nw8GR4Petr0bBhWHvN379LuPAL84ZFynKClRs9oRvi7gCrgjsKZnGVRZ_EliVlCeIU_lHI6ntoori28DV13IvYOTTvcUcJ7zUAgWI2c99WMudUZnLGxjvkvq4Ad15BJJEbcDeq5IzuzUbQBnKU764K5ZqRfwdpvCWJfvVeq3j-87V0jUEGGVbZnnmmuhcZi&__tn__=%2CO%2CP-R,496,0,positive,496
pfbid037jr41xEwkqYEy42Aq3A2kfze45U5GgGMbNcitRoQUDQcUvnTHPuG3j3FBUfHRTiJl,OpenAI,65,236,19,0,0,0,0,29,284,20,"We’re all used to robots that fail when their environment changes unpredictably. Our robotic system is adaptable enough to handle unexpected situations not seen during training, such as being prodded by a stuffed giraffe:",2019-10-15T00:00:00,"['blob:https://www.facebook.com/ded16042-d8d3-4124-b987-466a1df7f8f8', 'https://video.fcai19-7.fna.fbcdn.net/v/t42.4659-2/315011054_5579085332190441_1183318963740352310_n.mp4?_nc_cat=105&ccb=1-7&_nc_sid=73e57b&_nc_ohc=GgQUAvCn45AAX_YIkeT&_nc_ht=video.fcai19-7.fna&oh=00_AfB_9kaFk24Id2yYzvTgYNF8NtuE6czeypC8sesuQ3izWA&oe=64DD8FD2']",https://scontent.fcai19-7.fna.fbcdn.net/v/t15.13418-10/70874576_588448761953904_6591947588658790400_n.jpg?stp=dst-jpg_p180x540&_nc_cat=109&ccb=1-7&_nc_sid=ad6a45&_nc_ohc=0u-ispbPxXQAX8v4IKa&_nc_ht=scontent.fcai19-7.fna&oh=00_AfAgGMyk8QgtlhWRvC0sIsZRXan5t7YSjseDt4jXMYgICA&oe=64E28982 https://external.fcai19-7.fna.fbcdn.net/emg1/v/t13/17159160054534044688?url=https%3A%2F%2Fmedia1.tenor.co%2Fimages%2Fb0a12dd2d9740df9870a62c6375d210d%2Ftenor.gif%3Fver%3D1112%26c%3DVjFfZmFjZWJvb2tfd2ViY29tbWVudHM%26itemid%3D24439887&fb_obo=1&utld=tenor.co&stp=dst-jpg_flffffff_q75_s960x960&ccb=13-1&oh=06_AbE8SpZvk98n4ZlEy8Oe2IomuOOMSXMDhyg2C0y4ysJkIg&oe=64DEEB3D&_nc_sid=75c735,https://www.facebook.com/openai/posts/pfbid037jr41xEwkqYEy42Aq3A2kfze45U5GgGMbNcitRoQUDQcUvnTHPuG3j3FBUfHRTiJl?__cft__[0]=AZXjZMnYRsNIhIeAXsQBsgyu79u6Xo4roW3DnvFyLCKE5wl0l_fmpt6qHHiAaruu2dZVOazEDZ72X3B_3n5AE8b9CRQFY3ZeQTKjCR6Z6m7yLMmVuwBeBsqra0ir9LIdKjv_3wjb3v6VF9qrG2BqCqe2w885T3-HUrpb619pmwiAW7negMvLmA-IkC6LWE2hVoUAD14_qNi7CootRgW09IIkHQq1FrLNtVLhFKw5mB5sWw&__tn__=%2CO%2CP-R,349,0,positive,349
pfbid099D99PKNFn3hvisTZrAR4TmuKcH87snNQ7oCwb3oBNTpVXYsRgj1T9b8pipybToKl,OpenAI,316,473,70,88,0,0,0,0,631,33,"We've trained an AI system to solve the Rubik's Cube with a human-like robot hand.This is an unprecedented level of dexterity for a robot, and is hard even for humans to do.The system trains in an imperfect simulation and quickly adapts to reality: https://openai.com/blog/solving-rubiks-cube/",2019-10-15T00:00:00,['blob:https://www.facebook.com/400d93f7-e232-49cd-9610-ba1b59368da5'],https://scontent.fcai19-7.fna.fbcdn.net/v/t15.5256-10/69893344_2528029124150391_2791287258416676864_n.jpg?stp=dst-jpg_p180x540&_nc_cat=111&ccb=1-7&_nc_sid=ad6a45&_nc_ohc=-gJOzynR9bQAX9U7dek&_nc_ht=scontent.fcai19-7.fna&oh=00_AfDqD3MNk1LKJAO75doZOah1DIIoh_ORvHUcx50OlO11tw&oe=64E1D99F,https://www.facebook.com/openai/posts/pfbid099D99PKNFn3hvisTZrAR4TmuKcH87snNQ7oCwb3oBNTpVXYsRgj1T9b8pipybToKl?__cft__[0]=AZXq67L77KX9FZPQOLPt9jbXzj4JOCloIDRK0jH-g5-YWIGtaTgSzAZvSj9QFX6nLapJvaHNq17RtLtet9RBRN6SfJ4vl_YPNq6B9OxAkd11EgG1t7jATjZZCSmeHVas9rVwEuNhi2S59zjkkV0ooYCSZgk-Z10SRpZOjTtbDL0d1mPA8hjZmZw8mP07hJ0kfY4RZJM8LI6XksD2vFnBSXLAf0oEfs4m1OIAQ-aGzArrSQ&__tn__=%2CO%2CP-R,947,0,positive,947
pfbid02Qp4BNmKeiYyf4PuBU9jVDjq68dRNPYhaQ4cTmtJ4r1GEVwAbyr9TdXB3vmG7fUGXl,OpenAI,31,107,12,0,0,0,0,0,119,11,Now accepting applications for our 3rd class of OpenAI Scholars: a 4 month full-time program for individuals from underrepresented groups to study deep learning and produce an open-source project: https://openai.com/blog/openai-scholars-spring-2020/,2019-10-11T00:00:00,[],https://external.fcai19-7.fna.fbcdn.net/emg1/v/t13/9011803195624031144?url=https%3A%2F%2Fopenai.com%2Fcontent%2Fimages%2F2019%2F10%2FIMG_7650-2.jpg&fb_obo=1&utld=openai.com&stp=c0.95.2000.1044a_dst-jpg_flffffff_q75_s500x261&ccb=13-1&oh=06_AbGZQgD8LY8Osyojd6FOhiVwUcGYow2tkRFrxsm9EAHz3g&oe=64DEDAF8&_nc_sid=ff403b,https://www.facebook.com/openai/posts/pfbid02Qp4BNmKeiYyf4PuBU9jVDjq68dRNPYhaQ4cTmtJ4r1GEVwAbyr9TdXB3vmG7fUGXl?__cft__[0]=AZVf2aPoW0GcVHpe-VtFMVaUlsj12nkoGujIjEFS6Ufh06IF61YoPUDMbQSC_LkCJ5gZaEjXmjB49_wXyIQSRIIBJ5SU4nn_Yt3ocYMmLO3oJfGy7P2yw83nae3ric8wQFK6T9JbzkLN4faKDeZ9d7Ot7c4PDX1FiuozgO5dhFedCoaek21LWiTSGETgRsvI6zH3nAkOZHSObr6S6KG2WbZl&__tn__=%2CO%2CP-R,150,0,positive,150
pfbid0jFmbR7rHXgAHELur8WnjBiCDyR4vz5c2LNWB3TJt1FiHX6VtnpVzzGqpP4scTgY3l,OpenAI,15,85,0,0,0,0,0,0,85,2,"We've fine-tuned GPT-2 using human feedback for tasks such as summarizing articles, matching the preferences of human labelers (if not always our own). We're hoping this brings safety methods closer to machines learning values by talking with humans. https://openai.com/blog/fine-tuning-gpt-2/",2019-09-19T00:00:00,[],https://external.fcai19-7.fna.fbcdn.net/emg1/v/t13/8084641966648390132?url=https%3A%2F%2Fopenai.com%2Fcontent%2Fimages%2F2019%2F09%2Ffine-tuning-gpt-2.png&fb_obo=1&utld=openai.com&stp=c0.5000x0.5000f_dst-jpg_flffffff_p500x261_q75&ccb=13-1&oh=06_AbH4N-3fQvKMcoH7w4TS2FezuhPy10ZQLL2kcfxyECNXPQ&oe=64DF1E52&_nc_sid=dbad39,https://www.facebook.com/openai/posts/pfbid0jFmbR7rHXgAHELur8WnjBiCDyR4vz5c2LNWB3TJt1FiHX6VtnpVzzGqpP4scTgY3l?__cft__[0]=AZUbR2_X0GkJHmuNHHJmSqar8foIJ3_zA7FmnuNsUd1GJqAIbwQNTPnRyvm8r4-k9PrkI8yX0Q_6be9r2GQJeRX0J468TXKDrJiaC4tpAXt4XLOo0VOxRtmhk8DQPFZ32TNBeScnkIUVnrHC5btH0K7XpmBz5JInKEEnvzB6tQueR8kqKSN_pRQSUupMT6JECkcpx3zJfGefZ3XJQkqSbXXp&__tn__=%2CO%2CP-R,100,0,positive,100
pfbid0DezDAR4FQ883nC7HRTt3fjiHEWxpGHfbMd4AGYdfxB9qv2Bc9tp7s6K3jT51eoS4l,OpenAI,109,181,24,20,0,0,0,0,225,20,"We've observed AIs discovering complex tool use while competing in a simple game of hide-and-seek. They develop a series of six distinct strategies and counterstrategies, ultimately using tools in the environment to break our simulated physics: https://openai.com/blog/emergent-tool-use/",2019-09-17T00:00:00,[],https://scontent.xx.fbcdn.net/fb.png https://external.fcai19-7.fna.fbcdn.net/emg1/v/t13/3337143555001472154?url=https%3A%2F%2Fmedia1.tenor.co%2Fimages%2Ff252207778e6eeead072e9557b451862%2Ftenor.gif%3Fitemid%3D4570342&fb_obo=1&utld=tenor.co&stp=dst-emg0_q75_s362x200&ccb=13-1&oh=06_AbFccA19yqQDTz4SyZmqbUMBodmAz54Q49Hvk4luFUBrGQ&oe=64DEC628&_nc_sid=dbad39,https://www.facebook.com/openai/posts/pfbid0DezDAR4FQ883nC7HRTt3fjiHEWxpGHfbMd4AGYdfxB9qv2Bc9tp7s6K3jT51eoS4l?__cft__[0]=AZUMj7aAmEpd5Murp_u66QhqgAJ487X27aWVAVYUD6KrepPH1e36Fmahsw_PG_IbLPEEXzrdo6wuDs2w4y8vS2hGUjxAPzL-3uSei4nolAlmTLzdrbPpZmAlVtiVj7cm0-HRnbKJfFuGbCHmQEMKJEtBIp6tcHf7WeOF64CV__BHpHC62QdQUs3iZmilPYnUuAlGwmKSVj_fc8u0glMycJ1j&__tn__=%2CO%2CP-R,334,0,positive,334
pfbid0ioEPPsT3wCeF9oB7sjsaQPYPrn5AX4pV3jUD1kVR5Akrw5rswqpTLdVyzYavnp27l,OpenAI,8,56,8,0,0,0,0,0,64,7,"We're releasing a new method to test for model robustness against adversaries not seen during training, and open-sourcing a new metric, UAR (Unforeseen Attack Robustness), which measures how robust a model is to an unanticipated attack: https://openai.com/blog/testing-robustness/",2019-08-22T00:00:00,[],https://external.fcai19-7.fna.fbcdn.net/emg1/v/t13/14298140227007166338?url=https%3A%2F%2Fopenai.com%2Fcontent%2Fimages%2F2019%2F08%2Fespresso-2.gif&fb_obo=1&utld=openai.com&stp=c0.5000x0.5000f_dst-jpg_flffffff_p139x139_q75&ccb=13-1&oh=06_AbFxhvqRVMZ0Xwf90decdVf6k6YKHooBPJ5Kun2mkePtYA&oe=64DEEC9B&_nc_sid=dbad39,https://www.facebook.com/openai/posts/pfbid0ioEPPsT3wCeF9oB7sjsaQPYPrn5AX4pV3jUD1kVR5Akrw5rswqpTLdVyzYavnp27l?__cft__[0]=AZWN86LsxP-Ojj5OjVnun2RaEEgfUUyo96mptHDcMl2W6XptGkc5CdyBZi3QE-KIHBTDmy1fiXN98uHq7c_SdnSblYbBzB8ydBuFsYaIfmb1DE6dgwW-kNCGyiUMZiidCH63OOkzfFejwOKi52AcxLpXtHdyF48b2bp5nDZ9WLsNTBsnLHQ15k3zZEuONjw_zgv6x5tV2gXATwTJaLKrAxyS&__tn__=%2CO%2CP-R,72,0,positive,72
pfbid0VZV5iMJXLUgcmhQanBE1BsLZPtPv7ULkvKF9LeJgZoiwCi8MAyRsU3VbEhrWcmUXl,OpenAI,18,92,0,7,0,0,0,0,99,5,"GPT-2 6-month follow-up: we're releasing the 774M parameter model, an open-source legal doc organizations can use to form model-sharing partnerships, and a technical report about our experience coordinating to form new publication norms: https://openai.com/blog/gpt-2-6-month-follow-up/",2019-08-20T00:00:00,[],https://external.fcai19-7.fna.fbcdn.net/emg1/v/t13/12967374653218535997?url=https%3A%2F%2Fopenai.com%2Fcontent%2Fimages%2F2019%2F08%2Fgpt-2_update_8-15a-1.jpg&fb_obo=1&utld=openai.com&stp=c0.5000x0.5000f_dst-jpg_flffffff_p500x261_q75&ccb=13-1&oh=06_AbH3p_FuNF5yhLFTSCrNbS3sXWbxNB81LSBCr1i65pMFdQ&oe=64DF12A7&_nc_sid=dbad39 https://external.fcai19-7.fna.fbcdn.net/emg1/v/t13/5431732775585376387?url=https%3A%2F%2Fopenai.com%2Fcontent%2Fimages%2F2022%2F11%2FChatGPT.jpg&fb_obo=1&utld=openai.com&stp=c0.5000x0.5000f_dst-emg0_p98x98_q75&ccb=13-1&oh=06_AbHf_f3tz8_zKuMeEi6dNwRrpklS4hu7r5Ys49Uuy-x3sw&oe=64DF0203&_nc_sid=dbad39,https://www.facebook.com/openai/posts/pfbid0VZV5iMJXLUgcmhQanBE1BsLZPtPv7ULkvKF9LeJgZoiwCi8MAyRsU3VbEhrWcmUXl?__cft__[0]=AZUcHp2DOxqldcoGkR0F3gWlyneM1QdO9-sJNhPyBnM_UM3PnHHaTDNAYYQAlru7K8o-xw-CuOhUc0EaYa6pR67bQ7HkO8CrzNHh74OagWRMYsMNjDbl7_TCF4yb5jPpd34B55UoH-wjn7CG77GW1gh7M1bqAFhwSRM5elQ50UdP2kjD9s75McTnBDwpgj7op9ObsnCpWGIocc4XtW8TG3m0&__tn__=%2CO%2CP-R,117,0,positive,117
pfbid0QqNFSRH7HnQLk6EWVoXL4T5SJQ56kg9dWhAu7cjhFNcRDVpHkMbthUrwZSN9ZzRzl,OpenAI,9,143,14,0,0,0,0,0,157,4,Each Thursday at OpenAI is Learning Day: a day where employees have the option to self-study technical skills that will make them better at their job but which aren't being learned from daily work.Here's how it works: https://openai.com/blog/learning-day/,2019-08-01T00:00:00,[],https://external.fcai19-7.fna.fbcdn.net/emg1/v/t13/10231629015635778685?url=https%3A%2F%2Fopenai.com%2Fcontent%2Fimages%2F2019%2F08%2Flearning-day_small-1.jpg&fb_obo=1&utld=openai.com&stp=c0.5000x0.5000f_dst-jpg_flffffff_p500x261_q75&ccb=13-1&oh=06_AbF3k022-FvIuBj2IXtV5rTlbaPrU_MsroNsp8TZXX9Epg&oe=64DF515C&_nc_sid=dbad39,https://www.facebook.com/openai/posts/pfbid0QqNFSRH7HnQLk6EWVoXL4T5SJQ56kg9dWhAu7cjhFNcRDVpHkMbthUrwZSN9ZzRzl?__cft__[0]=AZXjXinp188k-l7FdKBg_G10TBsA1FkrHsiie16kepbAkRWSraGZaT5mRalUVE67m-w_JboKe_Bsuc3wYasAtBhfwxTb5BcaOti8iBHQD3WRPgOV1wXtWcSICXm4vDL-2rNTn0UETcocimYFtgxPQpYscNSy9VwwgmJAkpIvHQ6FRJKivTsZEoLIvMV_FG3GfEv8TiftgpRBOwws_VYVW_SH&__tn__=%2CO%2CP-R,166,0,positive,166
pfbid0jzud4QcN5ES6c5dwWFRVQo5QhKvkvFG9myrERJp36agtq7UKbY6Z8nYn83EZey6gl,OpenAI,39,161,10,0,0,0,0,0,171,4,"A conversation with Sam Altman and Satya Nadella about the promise of AGI, the need for massive compute power to make it real, and OpenAI/Microsoft's joint commitment to AI safety: https://www.linkedin.com/.../urn:li:activity.../",2019-07-22T00:00:00,[],https://external.fcai19-7.fna.fbcdn.net/emg1/v/t13/9569501322522741459?url=https%3A%2F%2Fdms.licdn.com%2Fvideo-thumbs%2FC5605AQE9_sIGKsrFdA%2Fb6d0083ee991464d9c17e7dc6be78a4b%2Ffeedshare-videocover_high-captions-thumbnails%2F1280x720-00001.jpg&fb_obo=1&utld=licdn.com&stp=c0.17.1280.668a_dst-jpg_flffffff_q75_s500x261&ccb=13-1&oh=06_AbESO72LoTN20dhCmVuxCIwkJ8yVYt-1hLuR5Ic9-LCqsA&oe=64DF6572&_nc_sid=ff403b,https://www.facebook.com/openai/posts/pfbid0jzud4QcN5ES6c5dwWFRVQo5QhKvkvFG9myrERJp36agtq7UKbY6Z8nYn83EZey6gl?__cft__[0]=AZWO7uyICJ6J7u07i-zc1UgH5AEzU-BltGhaKLhCSanLjZPHw5KjB1bsGDadgGml_o6YUoOiOC08LydK9wwB73F8zjSkAzqw0LlZEo5ScLeKynwNu3z1veQ2FBh9OwBhAgLtysifOc-q8PR5C0932z5MS0iNzZhafDmUOsO1SyS0TrfTJqalRyrXdPVCw3sfUcM8KI8D2evEFRxdMTSJAndX&__tn__=%2CO%2CP-R,210,0,positive,210
pfbid0poq8k2Cm8WsLHhV9jTS2vuNGRpixTcUjfTSbNYnvur6tSTgmZxb52oBRQYJXgY2Rl,OpenAI,119,404,49,60,0,0,0,0,513,27,Microsoft is investing $1 billion in and partnering with OpenAI to support us building beneficial AGI: https://openai.com/blog/microsoft/,2019-07-22T00:00:00,[],https://external.fcai19-7.fna.fbcdn.net/emg1/v/t13/10974070184528544238?url=https%3A%2F%2Fopenai.com%2Fcontent%2Fimages%2F2019%2F07%2Fopenai-msft-twitter_7-21b-1.jpg&fb_obo=1&utld=openai.com&stp=c0.5000x0.5000f_dst-jpg_flffffff_p500x261_q75&ccb=13-1&oh=06_AbEf7uHOI0_1ne8K6qyK8I639WuxKygxco2WqIeHgm8C5A&oe=64DF471E&_nc_sid=dbad39,https://www.facebook.com/openai/posts/pfbid0poq8k2Cm8WsLHhV9jTS2vuNGRpixTcUjfTSbNYnvur6tSTgmZxb52oBRQYJXgY2Rl?__cft__[0]=AZW0afL_B29sL0fJ4VwludbwuYWbMmGYiPQOkNGZhaXzvTEFH6J1NvihFOMG0EhSMsG7kCO8nbInDed-Cl4btMAx1rQbsIIzPduQQBWMu2svZR70jZBfFHhA6T95mNr4l4sL8-bccm5Nz5AaEebwIULBUD5o_xB1IOpxGIiHSUE0Lf7CJne7W_UP8FC3PVtETGkZUU5Zbv-LlgHmjNkrrPnD&__tn__=%2CO%2CP-R,632,0,positive,632
pfbid037bSLyamQ7afU7C2K8J9eTLEostKHwd8atTpBADqNPvLv5WvD8nTTcFyRZR6UsUvol,OpenAI,31,110,9,7,0,0,0,0,126,17,MuseNet is playing an experimental concert from now until 3pm PT on livestream: http://twitch.tv/openai No human curation or filtering involved — these are samples generated directly by MuseNet without any human intervention. Please enjoy!,2019-04-25T00:00:00,[],https://scontent.fcai19-7.fna.fbcdn.net/v/t1.6435-9/58570496_1027575917431020_839234633953443840_n.jpg?stp=dst-jpg_p180x540&_nc_cat=107&ccb=1-7&_nc_sid=730e14&_nc_ohc=53rjhAwvUAgAX-6E9da&_nc_ht=scontent.fcai19-7.fna&oh=00_AfDngKcImeffyZxqTzRN6NwJs5MhaUmUT9wDaomFyv_0cA&oe=6504ED0D,https://www.facebook.com/openai/posts/pfbid037bSLyamQ7afU7C2K8J9eTLEostKHwd8atTpBADqNPvLv5WvD8nTTcFyRZR6UsUvol?__cft__[0]=AZX0XaX5yQodcB6JolMRE-vVby0tMXBDhKZGm0NMouMvgoh6iRdDU_XuFPDoeKCsdLeXRqB9Cl5G1KB-On_imV1wG0pQb0APL9kCq1q6zog2wvpYIwKlZpfZFsPK6aAvttf_ez3F_Q0oN4AjwIGA1pykVHzb1J8l0IhOnFtyFqQoVHk2_PWv7tJ3rnd2m62cNBR-3EaJ9285kDPSFgO2gh9C&__tn__=%2CO%2CP-R,157,0,positive,157
pfbid0XWxH1gqG5GjSi8Td99D6sqxT5Av7mVNSmZ35im3HqAq2te9CwFbgzr5qVZ8jyrhQl,OpenAI,47,146,14,9,0,0,0,0,169,26,"We've created MuseNet, a neural network which discovered how to generate music using many different instruments and styles.Listen to MuseNet samples, and interact with a prototype co-composer tool, here: https://openai.com/blog/musenet/ MuseNet will play an experimental concert today from 12–3pmPT on livestream: http://twitch.tv/openai",2019-04-25T00:00:00,['blob:https://www.facebook.com/e0ba5d5e-9327-4a72-b886-76f0d674279b'],https://scontent.fcai19-7.fna.fbcdn.net/v/t15.13418-10/56990496_285271705728631_7403366962136350720_n.jpg?stp=dst-jpg_s960x960&_nc_cat=105&ccb=1-7&_nc_sid=ad6a45&_nc_ohc=ghsBJEFm8JUAX_ErKu0&_nc_ht=scontent.fcai19-7.fna&oh=00_AfASzAfs1IMyVPUjYf7-3Nf1T_b6XSM1359_k_oYuyf8MQ&oe=64E211A1,https://www.facebook.com/openai/posts/pfbid0XWxH1gqG5GjSi8Td99D6sqxT5Av7mVNSmZ35im3HqAq2te9CwFbgzr5qVZ8jyrhQl?__cft__[0]=AZU8UQlEVAxWylkqVfSchiU_rH04lAAF9z9K4au9fayRrlh5BK8qHWiazW2zcloLevq-voWw21ZSryhd5aN5ubIGE-OTAKNCkwvKt2N9j_HAktAXp6juGGwEe0xdYLQW4IKpOz9Gp5jxnsRC1-6-90VINChqgrLcHSe9ZhdXX8Wwt7EGG_U4J3ICatb402tdqQQpOUj2SQ_FYw10W5RLW1AHEvwn0yp0zShJe2aYYT7PPg&__tn__=%2CO%2CP-R,216,0,positive,216
pfbid0AUy5hgguFspQPaNTWWsQn8W4TfCDgvzZccVFTXvWiHhH2mrGjqp7JEGfjTgEnP53l,OpenAI,30,156,12,12,0,0,0,0,180,7,"We’ve developed the Sparse Transformer, a deep neural network which sets new records at predicting what comes next in a sequence — whether text, images, or sound. It uses an algorithmic improvement of the attention mechanism to extract patterns from sequences 30x longer than possible previously.Read more: https://openai.com/blog/sparse-transformer/",2019-04-23T00:00:00,['blob:https://www.facebook.com/bd820811-9767-4ad2-98df-e09f2cc3d2d8'],,https://www.facebook.com/openai/posts/pfbid0AUy5hgguFspQPaNTWWsQn8W4TfCDgvzZccVFTXvWiHhH2mrGjqp7JEGfjTgEnP53l?__cft__[0]=AZXyCW4nL-m2I0ui1ZKn5lq_zUz5IMro88SxumPCOtzBigOq2VR3MGKmlGNEu-H_5OYAEUxezK0nSWjpVgfp8TsErnzHdWoyUs7KhfWY0ZE2g7b601bFoB1VVEm71kmzgFWok-U-6I5QDtsFJI_yBKxiu1hi-uzbxt7HojMP8NlMpTDNMznWkZmUFzDXPbGl0phL8ebqyn0R4R4mXPVPZRaYfVwL39FNtG3o_j-Rj-0Yqg&__tn__=%2CO%2CP-R,210,0,positive,210
pfbid0QLkh9KYA49NsfNwPRfxCmfzB3E6XV3AZTotws98ZFMMA25wzucdDKYkr7i9FPr1Vl,OpenAI,35,134,14,0,0,0,0,0,148,7,"OpenAI Five is now the first AI to beat the world champions in an esports game. Here's what happened, and how we made our comeback since losing to pros in Aug 2018: https://openai.com/blog/how-to-train-your-openai-five",2019-04-15T00:00:00,['blob:https://www.facebook.com/2fcafdaf-3f8b-411c-a8bf-82c91bb03f6e'],https://scontent.fcai19-7.fna.fbcdn.net/v/t15.5256-10/56386579_2334614650115286_5883325023300616192_n.jpg?stp=dst-jpg_p180x540&_nc_cat=109&ccb=1-7&_nc_sid=ad6a45&_nc_ohc=8u5Xh4AKdiwAX_eYKel&_nc_ht=scontent.fcai19-7.fna&oh=00_AfD5DVbnhxIlbQ3l4fFB_7AEaTk2QSncrpMsKt6hOEtc5A&oe=64E19C55,https://www.facebook.com/openai/posts/pfbid0QLkh9KYA49NsfNwPRfxCmfzB3E6XV3AZTotws98ZFMMA25wzucdDKYkr7i9FPr1Vl?__cft__[0]=AZWtvo-3pIDuK6bSTWOIzgVluFI8_lQ5KTeflqnfV8rdZ3FvQ6jt8_uiAFyITPvJm9PXKYHAPnmR7hh3qUfYYEMgHWvTTnM4rAihJ9G4EZOMN3sz7JzMWNg22DQZfkAMylw4Gk3ZW3LwOETwqaq_-kX7iGK_RSg_a0xih4xoiujsAbbp4sZONsrORoJ9ldQGJ0g9-qkKd1yeRvA1Hyhc5xzkBkpnmMHgdWEzKyjSpnk6cg&__tn__=%2CO%2CP-R,183,0,positive,183
pfbid0bmDtfwQ9PE66fvcBWuGUcw1RkPocc5Tc8mSpELSTBxGtqa5a4veU3euhwYZRogeol,OpenAI,35,116,11,0,0,0,0,0,127,11,"Today's the day!!! Watch OpenAI Five Finals here, starting 11:30a PT: https://www.twitch.tv/openaiThis event will be the first time an AI has attempted to play the world champions in an esports game — and that won't be all we show today.",2019-04-13T00:00:00,[],https://external.fcai19-7.fna.fbcdn.net/emg1/v/t13/17739606816183267951?url=https%3A%2F%2Fstatic-cdn.jtvnw.net%2Fjtv_user_pictures%2F7eb0b67b-9041-4abc-b54d-67d7497c5676-profile_image-300x300.png&fb_obo=1&utld=jtvnw.net&stp=c0.5000x0.5000f_dst-jpg_flffffff_p139x139_q75&ccb=13-1&oh=06_AbFB8Vscghzfth_qSrDiygj9gi_nYm3ax869SPLYsRoV2w&oe=64DF0E85&_nc_sid=dbad39,https://www.facebook.com/openai/posts/pfbid0bmDtfwQ9PE66fvcBWuGUcw1RkPocc5Tc8mSpELSTBxGtqa5a4veU3euhwYZRogeol?__cft__[0]=AZVWLctACWl8RAtMlavnCnIFlUv5arvecKpLsfGVrwHKciOxG6zLjog7D_iqib573R_uy2tc38uWZbCSpzVk1FIjQinGEaX2kkmUWp58ZthxDu9kMN0P5dS8IV0hQPaDw05YOXb3v1I-QdX9O9kRl9T88WvBGJSbL3sq0AHAysGGtNGorXREFlwfP7llzy7G054NJLALke7x68DgwdPrAdQN&__tn__=%2CO%2CP-R,162,0,positive,162
pfbid0RiFyprz5ukTUEZASYAs7AtsoZvS3rvJ6wBeYPF7CJyGENwskcb8EChdgAqa21PYal,OpenAI,62,204,20,20,0,0,0,0,244,31,"On April 13th, we'll host OpenAI Five Finals, a live event with surprises in store. One highlight — we'll be playing against OG, the Dota 2 world champions. This will be the first time an AI has attempted to play the world champions in an esports game: https://openai.com/blog/openai-five-finals/Games will be streamed on Twitch. If you want to attend in person, request an invite here: https://docs.google.com/.../1FAIpQLSfYQD1CtdY5Qu.../viewform",2019-03-26T00:00:00,[],https://scontent.fcai19-7.fna.fbcdn.net/v/t1.6435-9/55495908_1009468975908381_6470230272779485184_n.jpg?stp=dst-jpg_p526x395&_nc_cat=102&ccb=1-7&_nc_sid=730e14&_nc_ohc=YsFdWXNraTQAX_IvQ-2&_nc_ht=scontent.fcai19-7.fna&oh=00_AfCtzGVEAJEe56pcDWidZG3zWLto5P9cTRMMGZHInUKrYA&oe=6504DA7E https://scontent.fcai19-7.fna.fbcdn.net/v/t1.6435-9/55512158_1009468625908416_4220139761588764672_n.jpg?stp=dst-jpg_s600x600&_nc_cat=107&ccb=1-7&_nc_sid=730e14&_nc_ohc=m7pwuo0Y2PQAX8EQrmX&_nc_ht=scontent.fcai19-7.fna&oh=00_AfDWc9Vkt7scEhkjG6DAD3EvEuv6hBTwkC-L77M-X9kseg&oe=6504E41A,https://www.facebook.com/openai/posts/pfbid0RiFyprz5ukTUEZASYAs7AtsoZvS3rvJ6wBeYPF7CJyGENwskcb8EChdgAqa21PYal?__cft__[0]=AZW7sDaaxZ8aZtMVdtINP_tiZMuYFCrv2IydcYLMpI1NcGPQ12mjhShaGZMPgSnapxFRENnNe8g0Lo1RFj3xB_IhLAEO4yay89cNCZTgy976hDYLjSX3tocwJIWDMvqsGrHp_1bDkk4eZaoyQbbp39wLlO2O9ZCvP3fIxesDxvu3JTgA7O7N3FbtiPZ9qihSKWaoE3RbsudSxA5ZUVMF0t01&__tn__=%2CO%2CP-R,306,0,positive,306
pfbid034wn7wCDQ4DVZbW69owRbowWmCaV5rQkhHG2eyyNfX4zEwvmeGk59Y9htZE1NCrCAl,OpenAI,3,115,10,0,0,0,0,0,125,11,"Check out the final projects from our first Fellows cohort, including work on generalization, scaling distributed neural networks, and stabilizing energy based models. Our Fellows program is a new 6-month apprenticeship in deep learning: https://blog.openai.com/openai-summer-fellows-2018/",2018-12-19T00:00:00,[],https://scontent.fcai19-7.fna.fbcdn.net/v/t1.6435-9/48427538_952810634907549_4982338599400767488_n.jpg?stp=dst-jpg_p180x540&_nc_cat=101&ccb=1-7&_nc_sid=730e14&_nc_ohc=HNjPRz0OAh0AX9shn8O&_nc_ht=scontent.fcai19-7.fna&oh=00_AfCRqSm8K_j8FfNbemXc2tgPDUy6lB1-pkg2Y4Q33tNbWw&oe=6504CD14,https://www.facebook.com/openai/posts/pfbid034wn7wCDQ4DVZbW69owRbowWmCaV5rQkhHG2eyyNfX4zEwvmeGk59Y9htZE1NCrCAl?__cft__[0]=AZWC8fIO_aoRaRVibynISFtq6hdVq7wdGF-Ss3wcdxl6bupB9fF2UkNGadF_hQSshpzlh3lxOv7Hzgkc_vBb9mQAqplz49qj3jchS6oXyHIc11J31OWNMD11mIeui7REX4uRorXH1Pgql6CU5D5oIlUGEScnrcb0clIbKs9EVWGnxzR1M0M3gp4po5VruDcDKmpsp7ve8yW2Mvax5Kw0FFf-&__tn__=%2CO%2CP-R,128,0,positive,128
pfbid02SVgwbx4AgN2H2rMsYR9kHA9xokeogr82oedtmsLYzFvN2zWXKiYHAqzjpRcKSQvel,OpenAI,12,99,0,0,0,0,0,0,99,4,"Announcing the first finding from our ""Science of AI"" effort: a simple statistical metric that lets us predict the parallelizability of neural network training on a wide range of tasks: https://blog.openai.com/science-of-ai/",2018-12-14T00:00:00,[],https://scontent.fcai19-7.fna.fbcdn.net/v/t1.6435-9/48363911_949974048524541_2556369903288320000_n.png?stp=dst-png_s600x600&_nc_cat=106&ccb=1-7&_nc_sid=730e14&_nc_ohc=m9jIh4avXsEAX8d1aza&_nc_ht=scontent.fcai19-7.fna&oh=00_AfB5vHLyO6mqahQBVXQjtvVzQzBvAFwYioTNzy7RSbj0EQ&oe=6504C718 https://scontent.fcai19-7.fna.fbcdn.net/v/t39.1997-6/10935978_685209731588330_1606099497_n.png?stp=cp0_dst-png_s110x80&_nc_cat=1&ccb=1-7&_nc_sid=ac3552&_nc_ohc=OJUX2pYdgcIAX_Tsi7L&_nc_ht=scontent.fcai19-7.fna&oh=00_AfD7r271u6dpxvXE1X7TP6OUcZ2Qhcragouy6MalwYiKKQ&oe=64E2ACE6,https://www.facebook.com/openai/posts/pfbid02SVgwbx4AgN2H2rMsYR9kHA9xokeogr82oedtmsLYzFvN2zWXKiYHAqzjpRcKSQvel?__cft__[0]=AZVu9qQTwYflRc9_eGVSSK2r86HRkquPFAdJhXPy2KtejlHrphkoe8m4KM6RPfMw2ezR8VkwrFN4WxFtAuHdeyuNVcLyp2zy3-hpYsBaZ4nSKZ6ngvNh4NYgTEBpxPOmBCmG-yUyUYXtotBCovjcitrXSzP7SPDhTWmyGyhGKT3onLwEYcSEUTXQLrpb0SDiXufduhctrnviRcWzth63KB19&__tn__=%2CO%2CP-R,111,0,positive,111
pfbid0Kh1FcjLpz5RT8U824bFSufbHkXXfkES5Hhw7d44b36Min6GaKVq8t2FEzN3uPRaJl,OpenAI,11,96,0,0,0,0,0,0,96,3,"We’re releasing CoinRun, an environment generator that provides a metric for an agent’s ability to generalize across new environments - https://blog.openai.com/quantifying-generalization-in.../",2018-12-06T00:00:00,[],https://scontent.fcai19-7.fna.fbcdn.net/v/t1.6435-9/47579280_944711155717497_3659726385787699200_n.png?stp=dst-png_p843x403&_nc_cat=107&ccb=1-7&_nc_sid=730e14&_nc_ohc=2SzyEAr6coMAX9IgSDa&_nc_ht=scontent.fcai19-7.fna&oh=00_AfATbIPoK5DKGEJxuJlTmJybfihxHtpdFdT_RL5VwqxFQw&oe=6504EA9A,https://www.facebook.com/openai/posts/pfbid0Kh1FcjLpz5RT8U824bFSufbHkXXfkES5Hhw7d44b36Min6GaKVq8t2FEzN3uPRaJl?__cft__[0]=AZU80m3OSk7xBpnhGedF9P0xdiC-miKn6Y0WnaMjRJf_teI5AMw6Kw7JT_EtJS0TiX9uXQ0FcJAzlqERTmhykSUT7SSvSdcWJSsNfDtlOcHqhevgwek5C-tWlll87xthoIHGXPI7neDMOY3ibpjMPraw7f_MgDtUyenz8upFxbKVWRqm2rKpbMQ1svtwDM119M7ZRaYbYFeNcntO6KWbF1N6&__tn__=%2CO%2CP-R,107,0,positive,107
pfbid02v2ESFzAYMXMwygWLmAGzbFm4ECratx7K2z3inHcwWjjVMhM39oAAhtuZ5sZYdt8Fl,OpenAI,48,143,23,0,0,0,0,0,166,7,"We’re releasing Spinning Up in Deep RL, an educational resource designed to let anyone learn to become a skilled practitioner in deep reinforcement learning. Spinning Up consists of crystal-clear examples of RL code, educational exercises, documentation, and tutorials.Details: https://blog.openai.com/spinning-up-in-deep-rl/",2018-11-08T00:00:00,[],https://external.fcai19-7.fna.fbcdn.net/emg1/v/t13/11592251509111946445?url=https%3A%2F%2Fblog.openai.com%2Fcontent%2Fimages%2F2018%2F11%2Fspinningup-2.jpg&fb_obo=1&utld=openai.com&stp=c0.5000x0.5000f_dst-jpg_flffffff_p500x261_q75&ccb=13-1&oh=06_AbFKpiqqZhXemzkGrc6nhlLWNE2sRXKPK6KtW9K9Af1fMA&oe=64DEC44B&_nc_sid=dbad39,https://www.facebook.com/openai/posts/pfbid02v2ESFzAYMXMwygWLmAGzbFm4ECratx7K2z3inHcwWjjVMhM39oAAhtuZ5sZYdt8Fl?__cft__[0]=AZX9H1GkJDtp-B6cIVWvNrDprwvA0gfSgf2MM5uKERHKKKshYgQT14cevz_Q3yLnuneXXLJhKDkOwc9x-_PVrnv-OrmJ0wdjQKC5lKClp4FEAIci7Pv8j0ogjO_J0AdjpHVCWouz7mofuo0GOkKJZnVFrUxEXxaUqaUa_aO5rrGZjNH7NCbOCl_SB_Wnzu7bBqu6rIr49g9t2PusDcPDA64j&__tn__=%2CO%2CP-R,214,0,positive,214
pfbid05uG1LbREXvG7Te78msZnVBmFpsAVoMb78jFVAh96YtZNSBQuYMro1nWCe6T2gY5hl,OpenAI,17,120,9,0,0,0,0,0,129,2,"We’ve built an energy-based model that can quickly recognize, generate, and transfer simple concepts after only 5 training demos: https://blog.openai.com/learning-concepts-with-energy.../",2018-11-07T00:00:00,['blob:https://www.facebook.com/6ae5ddfa-c700-43cf-910d-6fe3360030e4'],,https://www.facebook.com/openai/posts/pfbid05uG1LbREXvG7Te78msZnVBmFpsAVoMb78jFVAh96YtZNSBQuYMro1nWCe6T2gY5hl?__cft__[0]=AZUdP-HjeFpFFClPY_am3AyekdHT6TAdudr796DRXxChEPp8Bdkj5KQgvffysKwvbMS2Dls62ZwVAMTnlG6sJ0VuK_O1SdYjPqaD6Gmq6qH5V0AIO1fum2xwnT4TYKGtU2z8Kqe89Q0eV0jx2spBTGPSxOE4lAoUiZiGmDsuacgE5qhs-qNVHeZOBc3qkoJfaDnpkrDJdOF6VCfOfJhZzETGFxU8J8LQ9Ilw-3FNZeR1fQ&__tn__=%2CO%2CP-R,146,0,positive,146
pfbid0LUKxv5CQ6XnjekgZryxgJaQBm3WqEruGHavQXaLAfJve375LaLaF3k6mKf1pnSstl,OpenAI,22,99,6,6,0,0,0,0,111,1,Random Network Distillation: A prediction-based method that achieves state-of-the-art performance on Montezuma’s Revenge: https://blog.openai.com/reinforcement-learning-with.../,2018-10-31T00:00:00,[],https://scontent.fcai19-7.fna.fbcdn.net/v/t1.6435-9/45063130_923751781146768_4587169619252346880_n.jpg?stp=dst-jpg_s960x960&_nc_cat=100&ccb=1-7&_nc_sid=730e14&_nc_ohc=j1PB_x-gcs4AX9ZwZXE&_nc_ht=scontent.fcai19-7.fna&oh=00_AfCZIktvqqbXgVOTN3IVmhxajaAbDY0s1hvjHAQJ4-4N_A&oe=6504CAC9,https://www.facebook.com/openai/posts/pfbid0LUKxv5CQ6XnjekgZryxgJaQBm3WqEruGHavQXaLAfJve375LaLaF3k6mKf1pnSstl?__cft__[0]=AZXTyxsJP9uw-OGCIxVz0Sdzl9Jc6FFEjZ_YuFLztV8MSQgDJ65byCDUrLkHzRkRQ8fH2BJpb4scrr5uHJiTuOOEnWwUWW4Z9jfCdbiXIaOf5jGNb4lgzDcv-vpOo1SzxZ063xLkt6maJckCxR73I0VFpPewYt8sVjU4f9p_GPGAaAsBdBvkSAjqQbHsJ3DlcM0YTJU_Ojf6qkNmahywNxNP&__tn__=%2CO%2CP-R,133,0,positive,133
pfbid02q8PtMFcHX6FUxH9ee6vU5nNQ77LoyKLPLZF8uLyjvabMJzRkyhajFxjarHoZnGNql,OpenAI,29,150,11,0,0,0,0,0,161,7,"We’re proposing an AI safety technique called iterated amplification that lets us specify complicated behaviors and goals that are beyond human scale, by demonstrating how to decompose a task into simpler sub-tasks, rather than by providing labeled data or a reward function.Details: https://blog.openai.com/amplifying-ai-training/",2018-10-22T00:00:00,[],https://external.fcai19-7.fna.fbcdn.net/emg1/v/t13/1545026211747430384?url=https%3A%2F%2Fblog.openai.com%2Fcontent%2Fimages%2F2018%2F10%2Famplification_cover-1.jpg&fb_obo=1&utld=openai.com&stp=c0.5000x0.5000f_dst-jpg_flffffff_p500x261_q75&ccb=13-1&oh=06_AbG6MQ-GUuYrHtXyNImCnje_morkvwD3w02AUgf09Q4Vsw&oe=64DF4321&_nc_sid=dbad39,https://www.facebook.com/openai/posts/pfbid02q8PtMFcHX6FUxH9ee6vU5nNQ77LoyKLPLZF8uLyjvabMJzRkyhajFxjarHoZnGNql?__cft__[0]=AZXEcx-qUEKleUILeHfuRHqFWEbjOB63Fr8QVqONMGIWnS2Jyc9nRMgYVRcuHMe4VfRyEUqGVTpKEmDCJ-S2bt3uA8Hcq40dA9WvO4KG-zPqTmPVvjeIWl5jwd-DU7aNLeViYlkZ4DsXzyfI2iShWSODlpB9MFf8CmxEWS-_Qh2EYLREwyb0XGl-DbxWfJRfwhnI7kWXVI-iNR6j8H_90KLL&__tn__=%2CO%2CP-R,190,0,positive,190
pfbid02DwNFgMjBP68mWe9Tipm4uFMhdVU3ZiyZhaRGdKHjXfg7a4dMuoQLzN4kFuUT3Powl,OpenAI,8,42,4,0,0,0,0,0,46,2,"Apply for our Winter 2019 OpenAI Scholars Program, open to individuals from underrepresented groups in STEM interested in becoming deep learning practitioners https://blog.openai.com/openai-scholars-2019/",2018-10-11T00:00:00,[],https://external.fcai19-7.fna.fbcdn.net/emg1/v/t13/2348593341852676635?url=https%3A%2F%2Fblog.openai.com%2Fcontent%2Fimages%2F2018%2F10%2FIMG_8120-1.jpg&fb_obo=1&utld=openai.com&stp=c0.5000x0.5000f_dst-jpg_flffffff_p500x261_q75&ccb=13-1&oh=06_AbEkvmwU_D9kOrHDcgJ1RVFx4hhYj4qDmIifYy2ww1LihQ&oe=64DEFE45&_nc_sid=dbad39,https://www.facebook.com/openai/posts/pfbid02DwNFgMjBP68mWe9Tipm4uFMhdVU3ZiyZhaRGdKHjXfg7a4dMuoQLzN4kFuUT3Powl?__cft__[0]=AZVErxNCeCFysZbdGcSnLRd2N2dAhx0EuhKDyE-gclcX_shJPUsSVhhl5Dy9QZG2dwp0Vn9CUKjK_hQoX2ZJFOmMr13GZkziSTdgsZx1F3dCZzFL_fPXBV6W8ZJDBPOJ_dWNNdWPzpEwmqMDVjhOt4SHkPvR20Gotdw7j-x2YD3_26v-YDp9stEtuG6nMFj7yOrfT4kCYC13Er60vdaYmhKK&__tn__=%2CO%2CP-R,54,0,positive,54
pfbid0QMC2g8ZFmeB1oRRggFZ7rwiZPeydq9mEYU9XcKQ3aMyp3WDnFawyyubwm4XNP7Erl,OpenAI,13,81,7,0,0,0,0,0,88,6,Come join the OpenAI team as a Fellow or Intern in 2019 — applications now open: https://blog.openai.com/openai-fellows-interns-2019/,2018-10-09T00:00:00,[],https://external.fcai19-7.fna.fbcdn.net/emg1/v/t13/1903602800208380603?url=https%3A%2F%2Fblog.openai.com%2Fcontent%2Fimages%2F2018%2F10%2FImage-from-iOS-2.jpg&fb_obo=1&utld=openai.com&stp=c0.5000x0.5000f_dst-jpg_flffffff_p500x261_q75&ccb=13-1&oh=06_AbEUYzotG7lno58QYElUtvOWmT9rxKbKQnH1RK_PgVsd7w&oe=64DF2AA3&_nc_sid=dbad39,https://www.facebook.com/openai/posts/pfbid0QMC2g8ZFmeB1oRRggFZ7rwiZPeydq9mEYU9XcKQ3aMyp3WDnFawyyubwm4XNP7Erl?__cft__[0]=AZUI4yZDjg2tGvcYHw3wqv4JP8O78ClsDeQfczzpoUWnMdqkdaKSJVsg40au-Z8VY0cppf2HGyZ-J-ngca4kd_oG4XAR90Z6l4GfSm0EieZpTInbmEv2ancYIme-duMbVfpthHElIVhOpV1XMYqeNZ1PQxrs3uhaEeh0iAuKJiHXZXEPZUWYEYwIMDMcVlFHAiwNNSlrnVNBzow1fL2SMC7Z&__tn__=%2CO%2CP-R,101,0,positive,101
pfbid02J2TmkMFtsgQMP3YamkXdDZsPRoYVwRus6FdAMpfa4sQsoGVGeUvPJj7UUFgR8TxDl,OpenAI,8,91,0,0,0,0,0,0,91,3,Details on the final projects of our first class of OpenAI Scholars: https://blog.openai.com/openai-scholars-2018-final-projects/,2018-09-10T00:00:00,[],,https://www.facebook.com/openai/posts/pfbid02J2TmkMFtsgQMP3YamkXdDZsPRoYVwRus6FdAMpfa4sQsoGVGeUvPJj7UUFgR8TxDl?__cft__[0]=AZWuewudV4cW53xs0cJjbPF6TLjCOWRFwg40UdjmnOhVj0EfgIXFyGMM1weXcMa1ryO3-FCL8A2yQnEBO1Ba6Yt0xbSbHNH7aVw2M3YFVauHbzbYNG2-9yJn760ezNFCGylQyau2qbQKC3OG_ve4tmXplGxt599DgvmKFomVG0T_aF8B8NbucCTR-CdQe0PtzjINXqQCKSCMt38Ln3xyS5ro&__tn__=%2CO%2CP-R,99,0,positive,99
pfbid02WWJkyde87BPvwQ6BMoWYxh8DtYHQZneN1nx9Y8WVGFPo2o22UyubAWhzEMuPDqATl,OpenAI,10,71,0,0,0,0,0,0,71,13,OpenAI Five match starting now: https://www.twitch.tv/dota2ti!!https://twitter.com/OpenAI/status/1032347087701082112,2018-08-23T00:00:00,[],https://external.fcai19-7.fna.fbcdn.net/emg1/v/t13/15117684417020091009?url=https%3A%2F%2Fstatic-cdn.jtvnw.net%2Fjtv_user_pictures%2F9b1993ab-8ae9-4136-9af8-6ddb59e87af1-profile_image-300x300.png&fb_obo=1&utld=jtvnw.net&stp=c0.5000x0.5000f_dst-jpg_flffffff_p139x139_q75&ccb=13-1&oh=06_AbH48Heq4jWHgi73z_1Z5UC1E-ey3d4sFAfYJrFx237rng&oe=64DF3A77&_nc_sid=dbad39,https://www.facebook.com/openai/posts/pfbid02WWJkyde87BPvwQ6BMoWYxh8DtYHQZneN1nx9Y8WVGFPo2o22UyubAWhzEMuPDqATl?__cft__[0]=AZX4dBsFnHnP21urimVL0nWJZq4cLY9ZaHXYB-7ONi6561_pJo0U8x1vzQFEX63dBx9YoLB-lyJDNHkWPjNrtjSA6i95od3DJgIppFZ1uIAiiRt_Z3Mxl0LOglrMeM5Yo4g1wyGJ9VACVDWlRJ6wcBLOWWpGynmqahXZcnzrIPR0tvLNYBQzR_HbbP7VYmGe1YbSe3AqkywqWFkED5B9oImH&__tn__=%2CO%2CP-R,81,0,positive,81
pfbid02529YiXJYd3junB7JbMTRY5y34kJtc4Z7FAAHP9GJ8abM1ZUysdNkmcasmTuYB6NQl,OpenAI,8,66,0,5,0,0,0,0,71,2,"Post-game analysis of the OpenAI Five Benchmark games, with Dota analysts William ""Blitz"" Lee and Kyle ""melonzz"" Freedman: https://www.youtube.com/watch?v=80pm62J9kto",2018-08-20T00:00:00,[],https://external.fcai19-7.fna.fbcdn.net/emg1/v/t13/6574230782340504116?url=https%3A%2F%2Fi.ytimg.com%2Fvi%2F80pm62J9kto%2Fmaxresdefault.jpg&fb_obo=1&utld=ytimg.com&stp=c0.17.1280.668a_dst-jpg_flffffff_q75_s500x261&ccb=13-1&oh=06_AbH9APo-d7y4RvW1Hu0qcRxQNEBGcRwKhFUinFmDRrUpdw&oe=64DEFB3A&_nc_sid=ff403b,https://www.facebook.com/openai/posts/pfbid02529YiXJYd3junB7JbMTRY5y34kJtc4Z7FAAHP9GJ8abM1ZUysdNkmcasmTuYB6NQl?__cft__[0]=AZVD1tiQ70SOyY9CIBl7ximdoV4Hbs9QUhh10uzxkv0ro1mRyWaDlX8rxRXkY-5CFAfwP3GXUbkcvMgdCegBYurYpXJ_JNUhd3G3ZKZcWZCUUT-s0nONVgGHs_7pj0djMRmGNU0DmaMKaoeyO93lKGc05iToEELMh33t9WccKiOXt6SeRbg5S0h0UhkDXlfyuftL_O5AEL2a2iXSWbmc-v37&__tn__=%2CO%2CP-R,79,0,positive,79
pfbid02EW2CaC2toXMMVqcTc61znTe1hEULpYCQEngxAQJ1vwxrwcFtDbDi4k4npuHJYEGTl,OpenAI,49,252,22,21,0,0,0,0,295,29,"OpenAI Five will be playing against five of the world's top Dota 2 professionals in front of nearly 20,000 audience members at The International on Wednesday, Thursday, and Friday: https://openai.com/five/",2018-08-20T00:00:00,[],https://external.fcai19-7.fna.fbcdn.net/emg1/v/t13/16038220233170292576?url=https%3A%2F%2Fopenai.com%2Fassets%2Fimages%2Ffive%2Fti-e53c9d7b0e.jpg&fb_obo=1&utld=openai.com&stp=c0.5000x0.5000f_dst-jpg_flffffff_p500x261_q75&ccb=13-1&oh=06_AbFJcaYCMONdMqXYzBV_Z5WArqgEj99Iqf7tIpCJLhMKAw&oe=64DF06CA&_nc_sid=dbad39,https://www.facebook.com/openai/posts/pfbid02EW2CaC2toXMMVqcTc61znTe1hEULpYCQEngxAQJ1vwxrwcFtDbDi4k4npuHJYEGTl?__cft__[0]=AZWVMvyO0WR0_ZUVY62WG7vdDW-PKBOkIn1MAZVjdIFoRHfhHm4DaQN6KcvSNJ85jkdA4hAbLKJoAuIpEX9Y5Bu7JD8R71jZwvC0qMB6-O19-OsgvM5p5Yym1xjgVFdf1Q8HjXPPQFriJx77DrsTZuIkFh46mgpf5Dpp2ZHvK4qNevec6_d9XZhIgfrDf9YMxy05kBLwWDGWpJYgbVwSEPY0&__tn__=%2CO%2CP-R,344,0,positive,344
pfbid02zB9dHqUGVpSq2gD2b2wnPSCPvUDPQAP5ZJ4vhdcnhHohkQceQ39CgTMSXZnkoF83l,OpenAI,32,145,12,0,0,0,0,0,157,10,"Results from yesterday's Benchmark versus 99.95th percentile Dota players: https://blog.openai.com/openai-five-benchmark-results/.Great play by the human teams, giving us great insight into OpenAI Five's progress.",2018-08-06T00:00:00,[],https://external.fcai19-7.fna.fbcdn.net/emg1/v/t13/16331596921203992840?url=https%3A%2F%2Fblog.openai.com%2Fcontent%2Fimages%2F2018%2F08%2Fmain.jpg&fb_obo=1&utld=openai.com&stp=c0.143.3000.1566a_dst-jpg_flffffff_q75_s500x261&ccb=13-1&oh=06_AbE8OykCOv9MgUYxv9o1pjhoQjxhd5IHcO6wlM51vnqAsA&oe=64DF498C&_nc_sid=ff403b,https://www.facebook.com/openai/posts/pfbid02zB9dHqUGVpSq2gD2b2wnPSCPvUDPQAP5ZJ4vhdcnhHohkQceQ39CgTMSXZnkoF83l?__cft__[0]=AZXlopRC__4HVoTiXKZyrUbqeq4nPGjVPJsJhKUWFUsSStvfxVcq4QAzlxGJ6jw1ws5ZMw2yIOk7pwIqEfBQ-VqtmbPYscJyLprkW4OSQRbrlZt-UFXXyxuMqd2H_Q1oE2vxJTiS4gBEm9XkMtV96PpjIDR7plxOTD0kAj7uxQuIxB3aDIwj-R_VJTgwiS0Xaqu5MumZT_M-h-wI5_m0Cx2J&__tn__=%2CO%2CP-R,189,0,positive,189
860882887433658,OpenAI,236,396,56,45,0,0,0,0,497,25,"We've trained a human-like robot hand to manipulate physical objects with unprecedented dexterity. Our system, called Dactyl, is trained entirely in simulation and transfers its knowledge to reality, adapting to real-world physics using techniques we've been working on for the past year. This system is trained using the learning algorithm and code created for OpenAI Five: https://blog.openai.com/learning-dexterity/",2018-07-30T00:00:00,['blob:https://www.facebook.com/0fc15b40-dcf4-4172-ab28-dc264e2282a7'],https://scontent.fcai19-7.fna.fbcdn.net/v/t15.5256-10/36168813_860911347430812_6354903773747347456_n.jpg?stp=dst-jpg_p180x540&_nc_cat=107&ccb=1-7&_nc_sid=ad6a45&_nc_ohc=jAwxvUZDM9kAX_iVQ3c&_nc_ht=scontent.fcai19-7.fna&oh=00_AfACH5AQd4qUwsW64cIBWSrX3Tun6pjrUGmLNlg_jiHIIg&oe=64E1826C,https://www.facebook.com/openai/videos/860882887433658/?__cft__[0]=AZX05m9DxNsWg8mCD5R98HiRUdewbVk-H0zdyxO_9e0Aoiwe6Otng4tQdP9-hg6zimUJaNVHXFWAOUQfxJN8kVrEnQiKrddgJnXit7FU4bHgtNJFIBAB2P9PNzgL9qyqx_Hz1ZOr7syi9MkfFyfF1q0aN7S0MC09MYyKHdEWeP9mo0a18ot5DqQ2q7favH0P2ffu5NJvtjPP8h1DkkJCCgeI&__tn__=%2CO%2CP-R,733,0,positive,733
pfbid02TeXTsyxEqrraDTBHad6oF8ryuqUUC8BfDLPBJDJ3g1iaJaKENcnr4XRVmoutZSdtl,OpenAI,15,122,0,0,0,0,0,0,122,5,"Our first class of OpenAI Scholars is underway, and you can now follow along as this group of experienced software developers becomes machine learning practitioners. We had over 700 applicants for the 8 OpenAI Scholars slots and reviewed each application on a standardized list of criteria for maximal fairness. We hope this group inspires many other developers to make the transition to machine learning too: https://blog.openai.com/openai-scholars-class-2018/",2018-07-25T00:00:00,[],,https://www.facebook.com/openai/posts/pfbid02TeXTsyxEqrraDTBHad6oF8ryuqUUC8BfDLPBJDJ3g1iaJaKENcnr4XRVmoutZSdtl?__cft__[0]=AZU1-WzQBYBrs33rCAqVJKk54WvF3ur51Bb20F8qstTtxy_PXvQDaLpYvzIAJBXsFpuExWfayHTin51ruENGxki8-ZvK87gDdGk1dBSKv0grMTTJT5T-uumlYQlmzd_c6gwhSSQSIJ44aTPnKHnvV36OcPrNnaI65lDlx_XkJH8QBV8ZPwabo7J_Y2fY6n-rumr45THvnePv4FS1eaz1Txfb&__tn__=%2CO%2CP-R,137,0,positive,137
pfbid02QPvKmyXTYd7PS388upfagFpYYAGymtYKW7EoYbKUg2XZnFqSdFUR3j3Pe7SzYjeFl,OpenAI,42,210,17,15,0,0,0,0,242,24,"We’ve removed the most significant restrictions on OpenAI Five’s gameplay — wards, Roshan, mirror match. We'll play 99.95th-percentile players on August 5th to see if we have any hope of beating top professionals by The International at end of August: https://blog.openai.com/openai-five-benchmark/Request an invite to attend in person: https://docs.google.com/.../1FAIpQLScD7voLwWw0ma.../viewform",2018-07-18T00:00:00,[],https://external.fcai19-7.fna.fbcdn.net/emg1/v/t13/13207241381658221720?url=https%3A%2F%2Fblog.openai.com%2Fcontent%2Fimages%2F2018%2F07%2Fbenchmark-2.jpg&fb_obo=1&utld=openai.com&stp=c17.0.766.400a_dst-jpg_flffffff_q75_s500x261&ccb=13-1&oh=06_AbE6ogD9tC1KMLrERnMRcIskf5nPiiZOVBEmh1EkVNkFXg&oe=64DF1DDA&_nc_sid=ff403b https://external.fcai19-7.fna.fbcdn.net/emg1/v/t13/18298997520789307537?url=https%3A%2F%2Fdev.dota2.com%2Fimages%2Fmisc%2Fvbulletin4_logo.png&fb_obo=1&utld=dota2.com&stp=c0.5000x0.5000f_dst-emg0_p45x45_q75&ccb=13-1&oh=06_AbExSn85AY0GLXIU8s_qnCckxQPwKe09QSUlSFsDUcHqdQ&oe=64DF2A04&_nc_sid=dbad39,https://www.facebook.com/openai/posts/pfbid02QPvKmyXTYd7PS388upfagFpYYAGymtYKW7EoYbKUg2XZnFqSdFUR3j3Pe7SzYjeFl?__cft__[0]=AZU_ArkV5mdabkykb7u4QgowNdtlUIqV2ZNTQo_BI6di0-kQgvh6nUrywWVBUfgKQous-ml9HITux-cehkuigw1r2JJWrDNuquRLYJoRlZewbefbX60863UqU4HHY3YOtNYMwyMJ8FvLpmKpVeaFtj5518vtoqKdt_CwBQMF9sjggdoQrzaqmoynCIXp9g0c_yrYi1FZLvzcLA2Hg_tBaVfy&__tn__=%2CO%2CP-R,284,0,positive,284
pfbid0uUtZRopHWAiLRo6xJDBo82zYE1XJApXTECwDaPFVAVvxSKcfLFgtJ7pdA8J4uSe1l,OpenAI,35,127,0,8,0,0,0,0,135,11,"Synthesizing realistic high-resolution images with Glow, a new reversible generative model: http://blog.openai.com/glow/",2018-07-09T00:00:00,[],https://external.fcai19-7.fna.fbcdn.net/emg1/v/t13/17504876426706911491?url=https%3A%2F%2Fblog.openai.com%2Fcontent%2Fimages%2F2018%2F07%2Ftransforms2.png&fb_obo=1&utld=openai.com&stp=c0.0.1024.535a_dst-jpg_flffffff_q75_s500x261&ccb=13-1&oh=06_AbGitfsUkjhPm9vW1k5vF3xG-x8-QuAevEdLR1Qxzjd9PA&oe=64DEFFE8&_nc_sid=ff403b,https://www.facebook.com/openai/posts/pfbid0uUtZRopHWAiLRo6xJDBo82zYE1XJApXTECwDaPFVAVvxSKcfLFgtJ7pdA8J4uSe1l?__cft__[0]=AZX98np1zbHfosTjClQ5Ba3fuWuIwUwCzfLx0HSK8Tdrpc6YS5N9U4DbEL5YWS7xWJVB1YCiLhvT1ioeMYbhPOroeCcA4TjGfNJFluVXPWQQYh2WjxLvToTmf3o-bFX3SJ44iF1yMniiu3WDfmFNc3pfFCmfrfyOTq6aQwrSOH-pf3fA3WCsL8CkxQ7Lxqo5Lrhi0HrpCmj-aG9sPBSwhMzl&__tn__=%2CO%2CP-R,170,0,positive,170
835717133283567,OpenAI,19,116,12,10,0,0,0,0,138,5,New high score on Montezuma's Revenge using only a single demonstration: https://blog.openai.com/learning-montezumas-revenge-from.../,2018-07-04T00:00:00,['blob:https://www.facebook.com/6e863283-9ac9-448e-aa00-388dcd7acdb5'],https://scontent.fcai19-7.fna.fbcdn.net/v/t15.5256-10/34648941_835718836616730_2216774174997741568_n.jpg?_nc_cat=109&ccb=1-7&_nc_sid=ad6a45&_nc_ohc=NA6fe0zuDnUAX_uJUhC&_nc_ht=scontent.fcai19-7.fna&oh=00_AfD9zDt_pMzkmkSUX0SE3iCOmWzLQhseQMEWAeycR45onA&oe=64E26705,https://www.facebook.com/openai/videos/835717133283567/?__cft__[0]=AZXC93kXDV-c6y5do0O1JdZsJ8Ot2icPwg_EekJtoB-Hxu5H6BxwbHpACPAvBHpTk4LurWiK52xVHveMTy9y0WvYlSrzwDpcuzvnu791Ac6BBZNDPzVcpuLmyP8xFq9HK594W4RISsjUyKixjUI2WFhYTxHusyVGtJgUNfc0wkGoapbsYET80RYYohF_9RpsyWTjWajTivSDu5Q4BD-8Dyih&__tn__=%2CO%2CP-R,157,0,positive,157
826535460868401,OpenAI,292,405,51,44,0,0,0,0,500,70,"Our team of five neural networks, OpenAI Five, has started to defeat amateur human teams at Dota 2. Here we describe our progress to date, how our system works, and how you can follow along as we gear up to play a team of top professionals at the Dota world championships, The International, in August: https://blog.openai.com/openai-five",2018-06-25T00:00:00,['blob:https://www.facebook.com/363905a5-eb4c-46f0-85a9-58b031ae23e3'],,https://www.facebook.com/openai/videos/826535460868401/?__cft__[0]=AZWWkXruS08zJ51lKn49_5TyZLRSAYu6iBFkY1CL52aLUIQiR6ghpemYpTLi5rB8wTcwpeEq8r-5dG0i7Oc--Ya5-DlZe-YcZ1Dne80s_muLPdxO7S6CzTvf1zsVovecCozDp7HHAA4SueCyG1CjLTO56yGIK_Ypu_QNtpv1Ht1H4CIL4luss5sDBxw-H4LfkSuoDUmGJ7rfMGd6-KYFgtEE&__tn__=%2CO%2CP-R,792,0,positive,792
pfbid023B83ZufQpeYSrx9Siea1YYb7wuKM1GT7bcQYehmB5DtdZuSVF8x7taRFnP9R64L8l,OpenAI,33,99,0,0,0,0,0,0,99,1,Fine-tuning an unsupervised pretrained transformer to set new state-of-the-art on diverse language tasks: https://blog.openai.com/language-unsupervised/,2018-06-11T00:00:00,[],https://external.fcai19-7.fna.fbcdn.net/emg1/v/t13/9709556438508701750?url=https%3A%2F%2Fblog.openai.com%2Fcontent%2Fimages%2F2018%2F06%2Flanguage-twitter-card.png&fb_obo=1&utld=openai.com&stp=c0.5000x0.5000f_dst-jpg_flffffff_p500x261_q75&ccb=13-1&oh=06_AbG79DPq47hbmqNtNO4K8hMgDzKpgwQGSaIRmnywhaBXpQ&oe=64DF03C8&_nc_sid=dbad39,https://www.facebook.com/openai/posts/pfbid023B83ZufQpeYSrx9Siea1YYb7wuKM1GT7bcQYehmB5DtdZuSVF8x7taRFnP9R64L8l?__cft__[0]=AZWRurWFhNkN9qKo8u_51K-U3sNR_iN6uQQjNabkgJSlcIYjGw9Ym5eIZV_vZbBco9LzXOrzeAlQIh95CqT3JsMWSxyQH50kyLFlgyinYIlG3u8Q0LksMvD2J4F4s7V9Af6A5KMB9CinCG-FaJcxikN_MwgRtB2mQS70PXGJI7C1owJXsUwH-pA4x6o0qNah-gJHPlQiuAy_HywzrbrxeW3X&__tn__=%2CO%2CP-R,132,0,positive,132
pfbid03dfK4Nxor6YFAKksEaoxS8z6waP4GFaGEznrc3dGQK4tHr2icdY4tXBoZ1mgGkdgl,OpenAI,177,117,9,0,0,0,0,0,126,5,OpenAI Fellows - an apprenticeship program for people that want to transition into AI research: https://blog.openai.com/openai-fellows/,2018-05-30T00:00:00,[],https://external.fcai19-7.fna.fbcdn.net/emg1/v/t13/13205123854688193397?url=https%3A%2F%2Fblog.openai.com%2Fcontent%2Fimages%2F2018%2F05%2Fopenai-fellows-twitter%402x.png&fb_obo=1&utld=openai.com&stp=c0.5000x0.5000f_dst-jpg_flffffff_p500x261_q75&ccb=13-1&oh=06_AbH-sHs10MpIrESlNTz1zyXn6ZssNfTye1zhAyswGbHN0w&oe=64DF07E3&_nc_sid=dbad39,https://www.facebook.com/openai/posts/pfbid03dfK4Nxor6YFAKksEaoxS8z6waP4GFaGEznrc3dGQK4tHr2icdY4tXBoZ1mgGkdgl?__cft__[0]=AZVYeklPyIOaEvsNrsiKxYKfqtesXyJ0QbEN5lD7G9yIbt_Nd-FLa210v_wduHBhM8D211C4Dr18-d_2DqiAg_iUEeJLp_p7fthW23Io1eeozTLXp6So9-0K8yz4utpgpZ5H5dFBkuoQP7qkd9YxZzyi-qQvaBPLrEzkRiIn1TeuhNqZE00RP7JdqHxq-QpslPGk8cXkUDWl5WXnfXE30fUQ&__tn__=%2CO%2CP-R,303,0,positive,303
pfbid02DVp5YAm1z2pH4GbFipvGUzqSpuXbLJ2dZ8PDTybSRuQcVC4vix4CX6ihmR4SzmCml,OpenAI,0,106,0,13,0,0,0,0,119,31,"We've just released an analysis showing that the amount of compute used in the largest AI training runs has been increasing exponentially with a doubling period of 3.5 months since 2012 (net increase of 300,000x): https://blog.openai.com/ai-and-compute/",2018-05-16T00:00:00,[],https://external.fcai19-7.fna.fbcdn.net/emg1/v/t13/4496888800888123355?url=https%3A%2F%2Fblog.openai.com%2Fcontent%2Fimages%2F2018%2F05%2Fcompute_diagram%402x-1.png&fb_obo=1&utld=openai.com&stp=c0.5000x0.5000f_dst-jpg_flffffff_p500x261_q75&ccb=13-1&oh=06_AbFyIYq3Z08RiI8ljiaz2zxr30R8eGrscllMurs34V8prQ&oe=64DF5A6A&_nc_sid=dbad39,https://www.facebook.com/openai/posts/pfbid02DVp5YAm1z2pH4GbFipvGUzqSpuXbLJ2dZ8PDTybSRuQcVC4vix4CX6ihmR4SzmCml?__cft__[0]=AZUB4IyEK9dv13wpD48QTFORR0htNAa_IkYdzuexslXerTfgEvZtoDXrrQ5AP-dRqCSq7C-GQrd-HcbP2t_wmYrdQd81MjsDvgodQAG-n1c48Os-2WL7vNYuC-NGIydE7I_THysoQgbYMKiKDvQ4UGJvTk-Yc0H7bnC9pQxTDrzlq2fr7RRFIOm96nCBTwdWih-yX1YjbKiiiyWCNgBG_-rg&__tn__=%2CO%2CP-R,119,0,positive,119
pfbid0W46caDQNjJMiPgw1sYVCTAPPmPduTce9YYPBgb84RcQPsp2rnf8VQYFPUnaMb2nxl,OpenAI,17,61,0,0,0,0,0,0,61,4,Evolved Policy Gradients: https://blog.openai.com/evolved-policy-gradients/,2018-04-18T00:00:00,[],https://scontent.fcai19-7.fna.fbcdn.net/v/t45.1600-4/30431342_6096981947792_6716301786824572928_n.png?stp=c44.0.1112.580a_cp0_dst-jpg_q90_s526x296_spS444&_nc_cat=104&ccb=1-7&_nc_sid=67cdda&_nc_ohc=W3QkcOfxVZkAX-kBSI3&_nc_ht=scontent.fcai19-7.fna&oh=00_AfAF-8ZVdh8PlpVS4s-g59q0_9WdxY1nErKiwZqNk5ma9Q&oe=64E1E146,https://www.facebook.com/openai/posts/pfbid0W46caDQNjJMiPgw1sYVCTAPPmPduTce9YYPBgb84RcQPsp2rnf8VQYFPUnaMb2nxl?__cft__[0]=AZW_iNuJdWUT4TaCrQNmf68Z3ScXNNieY3W4bkFXuCyjVKj1oZJggVAtDZjfkojy5flqMkOkgy5nsmtiHQFMUs9Z0SPZOlpMkJRYJZCX0F7O0NKzgPl898jE_X26WN6r4fZNm6vNvuxDzUwQkgGCEENDpS8LNhhln56oCcI0rc3Opucsmwvi3Oz3Y3kXqonyZhCgU3NvIJG4RS7YPgCJHSGG&__tn__=%2CO%2CP-R,78,0,positive,78
pfbid02GN927bag3vNLPhZJosJSr69cm3dWbcLCbAeYP1cJZYytFjHow61xFqpq84bP2x5Al,OpenAI,12,86,13,0,0,0,0,0,99,2,OpenAI Charter: https://blog.openai.com/openai-charter/,2018-04-09T00:00:00,[],https://scontent.fcai19-7.fna.fbcdn.net/v/t45.1600-4/29964443_6097077910792_3224460333993164800_n.png?stp=c12.0.144.223a_cp0_dst-jpg_p168x128_q90_spS444&_nc_cat=107&ccb=1-7&_nc_sid=67cdda&_nc_ohc=XSwLg7e6JccAX9ZDVOF&_nc_ht=scontent.fcai19-7.fna&oh=00_AfAeKjpYEppvZg1zo9nXHzousVsfTl86HIX8Pthydb-9ng&oe=64E197BA,https://www.facebook.com/openai/posts/pfbid02GN927bag3vNLPhZJosJSr69cm3dWbcLCbAeYP1cJZYytFjHow61xFqpq84bP2x5Al?__cft__[0]=AZX8tMFYgOSH3Gk6Cif6tS_39WQwH2yDeZAtk5BrTsGGEdGAOU6pZ7dxGKxy3t2K7LWEKU26glyxoYqwSfVHYtWEdVZGK2Dxq5ydmlMxs_wOrAI2ZSG8liacXMFQz64HvNbMsJtk953PSqgaxBVlX0Cw3qhrDKpzaduN8npoU4DiZnxsorUoA9uJTxACI0MZcPF0WxWQBIMG2nUfsfoqJyj4DEnHetVmqVAjR6F7Vk1eJg&__tn__=%2CO%2CP-R,111,0,positive,111
pfbid02GNh9F2RrPwQf98aK3ktcan9NVPj4NGRWBBGpUaZrsGe9jnzxdgSUKesdvMJ1Dtal,OpenAI,12,64,9,0,0,0,0,0,73,1,A new reinforcement learning competition to aid research into transfer learning. More details: https://blog.openai.com/retro-contest/,2018-04-06T00:00:00,[],https://scontent.fcai19-7.fna.fbcdn.net/v/t45.1600-4/31343536_6097817654007_5500713569747992576_n.jpg?stp=c12.0.144.223a_cp0_dst-jpg_p168x128_q75_spS444&_nc_cat=106&ccb=1-7&_nc_sid=67cdda&_nc_ohc=ILei-corkvAAX_BUivV&_nc_ht=scontent.fcai19-7.fna&oh=00_AfC1CMHfaHzcWQBh2KKnjWaqBIO6gw49Ikcc5y3EpybqYg&oe=64E1AC87,https://www.facebook.com/openai/posts/pfbid02GNh9F2RrPwQf98aK3ktcan9NVPj4NGRWBBGpUaZrsGe9jnzxdgSUKesdvMJ1Dtal?__cft__[0]=AZWT04dLZqB16ug0y8DJdlrBhDPpHB4awUuDlQ_m3FO4y69wf7IljPqH3RULcNfUc50OLa398RkGw4Vp4gpVExMsTuJ4XZ01Jv67gkPop1yhP7027zehAO8n-SK0MfNYZ3TKaE9S1mdhJ16c7TJUoQAOtaE9Zzy30iBUjdIOHSkvPOtC9q2bbKbD2febzBE16gUqnPkI-vu0FeP7ih43zreXMJO4JWUeaR3wKHXPJZwFnQ&__tn__=%2CO%2CP-R,85,0,positive,85
pfbid02bSDfADY6aPgehNJcpeRz7D4o7NvHn1RTcDurj3wdrgTgUnhgEAnf4ASuZcUaRib6l,OpenAI,36,175,14,0,0,0,0,0,189,16,Now accepting applications for OpenAI Scholars: mentorship and financial support for people from underrepresented groups to get into AI.Details: https://blog.openai.com/openai-scholars/,2018-03-06T00:00:00,[],https://scontent.fcai19-7.fna.fbcdn.net/v/t45.1600-4/30540624_6097078189792_6994388103058161664_n.png?stp=cp0_dst-jpg_q90_s526x296_spS444&_nc_cat=106&ccb=1-7&_nc_sid=67cdda&_nc_ohc=uhmaI_9UZIMAX9W7jJO&_nc_ht=scontent.fcai19-7.fna&oh=00_AfC_GcYUbcP3rVsXAIvc2G3v62cQscNZJqGcmEE8oncg6w&oe=64E3347B,https://www.facebook.com/openai/posts/pfbid02bSDfADY6aPgehNJcpeRz7D4o7NvHn1RTcDurj3wdrgTgUnhgEAnf4ASuZcUaRib6l?__cft__[0]=AZWCtg-cDmaaYl1HuoO5kRICxr7nFAX_nzBU8NUJAxSgjLEJ_xCXZnnCfUxSwkIeKrNy4-a8pQXr_tJJg4pQSCmWrW4fagNNcPUiLgYoRtLE1Pa-yHDKHCaemIymVCdzX0j1Lfxbz_6goUQQFi33CEMFK_psXpgATWz5MpKWr2jWD8ktK8AvOXfxfPuGrxD75ucJZYyjpFT2tBsJ9vj3Sk-H&__tn__=%2CO%2CP-R,225,0,positive,225
767139913474623,OpenAI,58,186,21,0,0,0,0,0,207,7,"We're releasing eight simulated robotics environments and a Baselines implementation of Hindsight Experience Replay, all developed for our research over the past year. We've used these environments to train models which work on physical robots. We're also releasing a set of requests for robotics research. Check out the blog post for more details:  https://blog.openai.com/ingredients-for-robotics-research/",2018-02-26T00:00:00,['blob:https://www.facebook.com/b612c883-6701-4123-9c5d-bebf193693b9'],,https://www.facebook.com/openai/videos/767139913474623/?__cft__[0]=AZU306_7Sv473fdxR7_vxFEZZo-226XikBKPjm7H7NFaYEaVDggnMVGYMg-MzcOSFem-MEG6zc4Aou0AuCDZgZjCE86V2CyRllGdJdm1cztB6_JqxLiMdQSQY1wf3kJ_mN4OUi_f-ZXXywM5RmoaOY03-YzAdwmRdpt8ZOR-biL_vFy2bOdLt0862Tqrf-KL_ofZsNBDiaUBx2MM_x-_-hq1&__tn__=%2CO%2CP-R,265,0,positive,265
pfbid024mqmZyS51MXVV1fq6gJUq5z3QhSpMU2UZyxRC5Yj2YY5yaCJ9FYa7L5U9NZzX73Gl,OpenAI,18,97,6,0,0,0,0,0,103,2,"A system for automatic disambiguation of which object is meant by a word in a sentence (so, whether a particular sentence refers to Jaguar the car or jaguar the animal): https://blog.openai.com/discovering-types-for-entity.../",2018-02-07T00:00:00,[],https://scontent.fcai19-7.fna.fbcdn.net/v/t45.1600-4/31263353_6097899758192_8831983010178924544_n.png?stp=c0.66.519.271a_cp0_dst-jpg_p403x403_q90_spS444&_nc_cat=101&ccb=1-7&_nc_sid=67cdda&_nc_ohc=zRtxntS2gMsAX_FeFEk&_nc_ht=scontent.fcai19-7.fna&oh=00_AfCNg-xB-QMZ4q0PiA9-qGUZC388-i3f8Mj8KIacobMjUg&oe=64E2316A,https://www.facebook.com/openai/posts/pfbid024mqmZyS51MXVV1fq6gJUq5z3QhSpMU2UZyxRC5Yj2YY5yaCJ9FYa7L5U9NZzX73Gl?__cft__[0]=AZWE-K1tjgGu1RxiXH6LndlIKY6izQMBUnQD-VdoYZ5_7aS-O4Mhk7lOwjFu-AtxA44opjCvlOqqa7Rh8F_NUWVyc2PCgYlDIGAuWhx2cYMxc-k5fFgfxdgEcnZizz5vE00HTJXSjJUDz1-CLXH6g7AW6-P7kwxCQod_Jqw4Eq9w-XnCQlI_UPzNkGF7sNyL8WZ6cfY90N5-Xawg30xYA4_1&__tn__=%2CO%2CP-R,121,0,positive,121
pfbid0uAS5jZGNcLb11sGCK6CqrAvMbihL8xLiZ2GQJJZ1KZmWbHX1U9J58bvD9FFhxPzcl,OpenAI,22,124,9,0,0,0,0,0,133,7,"Announcing Requests for Research 2.0, a new set of unsolved problems which have come up in the course of our research at OpenAI: https://blog.openai.com/requests-for-research-2/. Intended for newcomers and practitioners alike!",2018-01-31T00:00:00,[],https://scontent.fcai19-7.fna.fbcdn.net/v/t45.1600-4/30553868_6097077910992_1278854872053055488_n.png?stp=c0.126.526.274a_cp0_dst-jpg_p526x296_q90_spS444&_nc_cat=106&ccb=1-7&_nc_sid=67cdda&_nc_ohc=_QUMPOJnjvEAX_6Ew1j&_nc_ht=scontent.fcai19-7.fna&oh=00_AfCATvXYSjPnO4LB-4QWx3s0_3mhQIUHaR1xztyt1Mijjg&oe=64E310E4,https://www.facebook.com/openai/posts/pfbid0uAS5jZGNcLb11sGCK6CqrAvMbihL8xLiZ2GQJJZ1KZmWbHX1U9J58bvD9FFhxPzcl?__cft__[0]=AZVR92gxjMZvWT9O7_ECfUoll13y1-bWOtvJRtjyUX7p7Gym-Bz_6V49LqPa3g-R0u2rr8I4QPUxIkdSev6E3eEF_jk-4GSu-_EsWzp7K2R7jeDCxzh3Ta-4ntf4WCStal7ul2XRvPywVJq3G2rfcPN6OGI9mh3em3keh2fXdq3kIO3pAUObGX20VxwDc4Byo6Q3v9An4rzuKXHNSaPGaDfF&__tn__=%2CO%2CP-R,155,0,positive,155
pfbid02oHG3pSDNnorsaR79FZAMngauCNc7XsYzrvK7S6Wxm9NyqYJLUKR3uegiLPyh4Gs7l,OpenAI,5,62,0,0,0,0,0,0,62,4,"We’ve been running Kubernetes for deep learning research for over two years. While our largest-scale workloads manage bare cloud VMs directly, Kubernetes provides a fast iteration cycle, reasonable scalability, and a lack of boilerplate which makes it ideal for most of our experiments. We now operate several Kubernetes clusters (some in the cloud and some on physical hardware), the largest of which we’ve pushed to over 2,500 nodes. This cluster runs in Azure on a combination of D15v2 and NC24 VMs.Details: https://blog.openai.com/scaling-kubernetes-to-2500-nodes/",2018-01-18T00:00:00,[],https://scontent.fcai19-7.fna.fbcdn.net/v/t45.1600-4/30277230_6097255841792_7873350935391502336_n.png?stp=c130.0.1443.753a_cp0_dst-jpg_q90_s526x296_spS444&_nc_cat=106&ccb=1-7&_nc_sid=67cdda&_nc_ohc=t68STgXn638AX_QuwBm&_nc_ht=scontent.fcai19-7.fna&oh=00_AfDY25iMPYrwceItns-Dez0eofQqDJPd-9ap0bPKZKw7Mw&oe=64E18DA5,https://www.facebook.com/openai/posts/pfbid02oHG3pSDNnorsaR79FZAMngauCNc7XsYzrvK7S6Wxm9NyqYJLUKR3uegiLPyh4Gs7l?__cft__[0]=AZVbPTLyu6BnKNBBlgMtjOCJWpj7CI40hu3cKRNCq87zMz5A1rRh4kgMh9dl2FPTC4d4ECXIpSpm2BM4vuixa5k1RzzdmPzKiBuY8BvI_qo5Q8JXytNKJyPceNBJnWrhx-A4eSx2cngxl0-Xj094b3haVTulrEKCTA8zxike_mXO9lPGOGMCMUxVei5VGxssXGMxUkTzKAIFcBvBFCoqt1B-&__tn__=%2CO%2CP-R,67,0,positive,67
711728979015717,OpenAI,31,226,0,0,0,0,0,0,226,21,"We’ve developed a hierarchical reinforcement learning algorithm that learns high-level actions useful for solving a range of tasks, allowing fast solving of tasks requiring thousands of timesteps. Our algorithm, when applied to a set of navigation problems, discovers a set of high-level actions for walking and crawling in different directions, which enables the agent to master new navigation tasks quickly.Details: https://blog.openai.com/learning-a-hierarchy/Code: https://github.com/openai/mlsh",2017-10-26T00:00:00,['blob:https://www.facebook.com/9cce9026-0294-478a-8d17-708da94e256c'],https://scontent.fcai19-7.fna.fbcdn.net/v/t15.5256-10/22743322_711729469015668_2889745586926387200_n.jpg?stp=dst-jpg_p480x480&_nc_cat=103&ccb=1-7&_nc_sid=ad6a45&_nc_ohc=i0I2Cy4aupgAX81_L1-&_nc_ht=scontent.fcai19-7.fna&oh=00_AfDkTbkSO5uxJRfh7IatCBo6QraQw0-4VLiplwgJ6Uluaw&oe=64E2EFD1,https://www.facebook.com/openai/videos/711728979015717/?__cft__[0]=AZU0mD7vNm-7SqQXogUGXkeF6EZQntFm2zRUu6oOq5K-abXOgG5dMS66GMocGr6zgrkzaBqd4WSf84foyg0QCKKDnA76AkPPtOZM3aKtdjctsAvxFFwiC_MePBNuq1gLFj_1Dqe3x72FGsM8gESIZLnOGzSO5XnjdnbkkIJ1v6w5S4e5wug2Pa9kpMIAF7D5MR9RanumNMpE5CSK2TKATtnr&__tn__=%2CO%2CP-R,257,0,positive,257
708882182633730,OpenAI,26,168,21,0,0,0,0,0,189,13,"Our latest robotics techniques allow robot controllers, trained entirely in simulation and deployed on physical robots, to react to unplanned changes in the environment as they solve simple tasks. That is, we’ve used these techniques to build closed-loop systems rather than open-loop ones as before. The simulator need not match the real-world in appearance or dynamics; instead, we randomize relevant aspects of the environment, from friction to action delays to sensor noise. Our new results provide more evidence that general-purpose robots can be built by training entirely in simulation, followed by a small amount of self-calibration in the real world: https://blog.openai.com/.../3027275a-fd2c-4681-9433.../",2017-10-19T00:00:00,['blob:https://www.facebook.com/f5a4275b-2d2a-4732-8da4-03757019b6a0'],https://scontent.fcai19-7.fna.fbcdn.net/v/t15.5256-10/22691390_708883465966935_7818220687935406080_n.jpg?_nc_cat=111&ccb=1-7&_nc_sid=ad6a45&_nc_ohc=f10gQrNWKNcAX_uWNFw&_nc_ht=scontent.fcai19-7.fna&oh=00_AfDiUO3oXmRlNcet1VfMQN_xOl68DG3iymHO3z5E_O6L0A&oe=64E20FD8,https://www.facebook.com/openai/videos/708882182633730/?__cft__[0]=AZUeSjIfNcbOX1d_j7eQMvLsvQbMFFV7dCRhncdQ2bjh-2OC8Ux11kA8CSTr0k_2jrNg5eut0HSIxf9ExBFch2u5xeIDm61sABo_6n91slwmZ6HonwdbxlO1w9ila3UvXhPfKKO1gzI-6wc6dzVMy_PRL2C_itfT2Wzsj0K74vChrMI8Tu3fxlpqjVndKgn8UollOnPfzJj-TM4GbkJBwcQW&__tn__=%2CO%2CP-R,215,0,positive,215
pfbid02HgocqsQTmJrG7fcuxpMQusvGaoX9gazEhue6ptksBvnp7cCeULwtH34wNtd8s41zl,OpenAI,10,119,10,8,0,0,0,0,137,6,"Beating stronger opponents by adapting to their strategies, via meta-learning: https://blog.openai.com/meta-learning-for-wrestling/",2017-10-11T00:00:00,[],https://scontent.fcai19-7.fna.fbcdn.net/v/t45.1600-4/30788127_6097025444607_1144406186481680384_n.png?stp=c0.11.526.274a_cp0_dst-jpg_p526x296_q90_spS444&_nc_cat=111&ccb=1-7&_nc_sid=67cdda&_nc_ohc=z3YbZKTWrH8AX_HBr6r&_nc_ht=scontent.fcai19-7.fna&oh=00_AfCJYl_FsxpgHjSaniG5dS6Q4jWL5S7-t2rTmalMIeVsZw&oe=64E2787B,https://www.facebook.com/openai/posts/pfbid02HgocqsQTmJrG7fcuxpMQusvGaoX9gazEhue6ptksBvnp7cCeULwtH34wNtd8s41zl?__cft__[0]=AZXMohAHD_cNxshVCRRCcjE6Si59NmhHYgdb8evaCihSBcM6fNrSfVbrO_z-dKrXv8A3LgfJDEUv1vZbWmv6pH9tFY6LATnlpD46Fb3fvqSlb5Aq6tquI3X1cWadIsGGXZrIfajUbinDF__MGo3JwfyuaVR1Mldb-gR4YTMLFkIzKhkx9uV69-TGztinU_o6sSTQVNQHYM94sUL_EA36Gat4&__tn__=%2CO%2CP-R,147,0,positive,147
705623112959637,OpenAI,109,366,31,43,0,0,0,0,440,28,"We’ve found that self-play allows simulated AIs to discover physical skills like tackling, ducking, faking, kicking, catching, and diving for the ball, without explicitly designing an environment with these skills in mind. Learn more: https://blog.openai.com/competitive-self-play/",2017-10-11T00:00:00,['blob:https://www.facebook.com/ce02f33b-28cf-47d3-9368-b1759a868cfa'],https://scontent.fcai19-7.fna.fbcdn.net/v/t15.5256-10/22469326_705636856291596_1696687037412802560_n.jpg?stp=dst-jpg_p180x540&_nc_cat=107&ccb=1-7&_nc_sid=ad6a45&_nc_ohc=VKjAhUnou2MAX_rtSyL&_nc_ht=scontent.fcai19-7.fna&oh=00_AfAsV2fZcm5yRn2D8kaIEmp6wrr73nAuALvbYnfOyc0UFw&oe=64E195AD,https://www.facebook.com/openai/videos/705623112959637/?__cft__[0]=AZXzEsRlCo7Xt_equprNo0aRQTOAkSurANHlxCWLrc9emonraeJg-SCxnZvLTFRY3RCb_6CWVSghK3v9dT4KKwTzxcvAF4sK01zLDwXncxnnloTMBUZINO_YdELKl08VpeBphnWgQwvptG-e89wthdX8zCuLx3A3YtLB2UQT_nN_ym_Uq0eVJWWQpfK9E7-17W84Qe6HagIJiP93r_YuaeVo&__tn__=%2CO%2CP-R,549,0,positive,549
681674202021195,OpenAI,355,676,68,77,0,0,0,0,821,136,"We’ve created a bot which beats the world’s top professionals at 1v1 matches of Dota 2 under standard tournament rules. The bot learned the game from scratch by self-play, and does not use imitation learning or tree search. This is a step towards building AI systems that can accomplish specified goals in complicated situations involving real humans. Learn more: https://blog.openai.com/dota-2",2017-08-12T00:00:00,['blob:https://www.facebook.com/8e55fc98-acb2-4e9b-b6f9-d5d48db36c93'],https://scontent.fcai19-7.fna.fbcdn.net/v/t15.5256-10/20820622_681700032018612_7244162381423575040_n.jpg?stp=dst-jpg_p180x540&_nc_cat=107&ccb=1-7&_nc_sid=ad6a45&_nc_ohc=s90In4QE6DYAX__T01c&_nc_ht=scontent.fcai19-7.fna&oh=00_AfCQEOsiz2pL-jlF_7LBgNanwqAf0Wv4CxyWXKfszSu_Ig&oe=64E29281,https://www.facebook.com/openai/videos/681674202021195/?__cft__[0]=AZVOLczmzY0zf43CG2aY0gY4Ly1_IVJzeg9BnpyHBppBDgf_Z2k9idpYQo1juZvQRCQjXDTgTxeIKUb0XPgqsR03TPsENmILem0qct_l0b2SqGzHUjgM7F0vKPtfHYHpeI6k3tSuPsFRaxIPwCg1lWhn9bNYooBB1kpgyPBqiebVCw1xnESThu0ezJ-UD7BV_EnpaNNmn1rq4Jm1AcV8vXJz&__tn__=%2CO%2CP-R,1176,0,positive,1176
678477012340914,OpenAI,25,109,11,0,0,0,0,0,120,14,"Releasing RL-Teacher - an open-source implementation of our interface to train AIs via occasional human feedback rather than hand-crafted reward functions. The underlying technique was developed as a step towards safe AI systems, but also applies to reinforcement learning problems with rewards that are hard to specify.Details: https://blog.openai.com/gathering_human_feedback/",2017-08-03T00:00:00,['blob:https://www.facebook.com/bbde7de3-b854-4963-b931-893f9825dedf'],https://scontent.fcai19-7.fna.fbcdn.net/v/t15.5256-10/20642643_678477385674210_6678732071503921152_n.jpg?_nc_cat=103&ccb=1-7&_nc_sid=ad6a45&_nc_ohc=9qQ1t-k2Q5EAX9OdDUH&_nc_ht=scontent.fcai19-7.fna&oh=00_AfCLzhkSD8L9KWvWRBQqA7SMRX3y9KoYso9HrrTwV1AnKg&oe=64E1D977,https://www.facebook.com/openai/videos/678477012340914/?__cft__[0]=AZWIrqJjB2ldYM25nkQSS-XM1dHj-bujbv-JV_BAG_e6LeX4kCiIu0p6hvBhPwzqFF9RqQvtiBEf3jmbvttm7Y2UJis6liamGNXUbXdvHWX6dzNTK87iBmdO_j20D2pjgK9e36HbDy1gDPQgmli0kG9c7_eXWDe5oJs0vF0AwZcfRq7ZJL6sCApxmTU4AeCI2gwLxYyfRrcG8-YmaYJLYtdh&__tn__=%2CO%2CP-R,145,0,positive,145
671188546403094,OpenAI,61,187,0,18,0,0,0,0,205,19,"We’ve created images that reliably fool neural network classifiers when viewed from varied scales and perspectives. This challenges a claim from last week that self-driving cars would be hard to trick maliciously since they capture images from multiple scales, angles, perspectives, and the like.Details: https://blog.openai.com/robust-adversarial-inputs/",2017-07-17T00:00:00,['blob:https://www.facebook.com/8b9422ef-c344-4d4e-b161-a5c22aa5a287'],https://scontent.fcai19-7.fna.fbcdn.net/v/t15.5256-10/20172697_671188753069740_8671296309266743296_n.jpg?_nc_cat=110&ccb=1-7&_nc_sid=ad6a45&_nc_ohc=l3xP8G_FmCEAX-IEZrM&_nc_ht=scontent.fcai19-7.fna&oh=00_AfAUAbEd27oeW3joqNpdtDFqcu2U3QDs7d3RS_iwAPJGFQ&oe=64E18173,https://www.facebook.com/openai/videos/671188546403094/?__cft__[0]=AZV6GBCf09ywdcN7yoUuakTB4731E56jKA7jRGmH4CenBpamPkmEpIN7kyz1sjnBMqpED8yPkWBCEqoCVAhYATueYWuAvKvM--gVpUOqJvBppdqzP7F3oE-T1HJGXifnr5uxa_Jxr_q-ocBUQEEbPXJFze7t7GLMuFrxzi-HqB8ihc81Jsedq8WuvAYkuNB5HJUa9YgWsvDzSdHwqkYY2Elf&__tn__=%2CO%2CP-R,266,0,positive,266
pfbid0zR29p2rufu5tc7RQLA69G3qkei1gpcDnbtaZakTQdwbbenZktoteCQz8TW6Hw5Ckl,OpenAI,9,163,0,0,0,0,0,0,163,7,"We’re open-sourcing a high-performance Python library for robotic simulation using the MuJoCo engine, developed over our past year of robotics research.Details: https://blog.openai.com/faster-robot-simulation-in-python/",2017-06-28T00:00:00,[],,https://www.facebook.com/openai/posts/pfbid0zR29p2rufu5tc7RQLA69G3qkei1gpcDnbtaZakTQdwbbenZktoteCQz8TW6Hw5Ckl?__cft__[0]=AZUPIBkX0BoTIeKL0nJzvZRjTo-BsZ7jMnlBrDQXxfKJ_rlsFz8hy--ZeR0c15W4DBQYZ0khmxhDeu7IfvXY8yAvRYV204Tf7tnujgFG9aHqnQ5eLNnIPWZGnHpfQgzOhprbgJjXrbaCoqkSRmeIyHjJPch07qqsRLHKwIl5jTPEMUGJdvqzuksT1BdkNFLdkdgjjJObqRm12Sk571Jk24o_&__tn__=%2CO%2CP-R,172,0,positive,172
654736041381678,OpenAI,25,106,10,0,0,0,0,0,116,7,"One step towards building safe AI systems is to remove the need for humans to write goal functions, since using a simple proxy for a complex goal, or getting the complex goal a bit wrong, can lead to undesirable and even dangerous behavior. In collaboration with DeepMind’s safety team, we’ve developed an algorithm which can infer what humans want by being told which of two proposed behaviors is better.Details: https://blog.openai.com/deep-reinforcement-learning-from.../",2017-06-13T00:00:00,[],https://scontent.fcai19-7.fna.fbcdn.net/v/t45.1600-4/19945342_6075501505767_9195105937956798464_n.png?stp=cp0_dst-jpg_q90_s526x296_spS444&_nc_cat=102&ccb=1-7&_nc_sid=67cdda&_nc_ohc=ycsv8KLKjuUAX_nNsNw&_nc_ht=scontent.fcai19-7.fna&oh=00_AfB8S1ewLTa_gVaCKSuKWOcjKRjnOUGJ_l0gxTfVhF28KA&oe=64E17646 https://external.fcai19-7.fna.fbcdn.net/emg1/v/t13/5806082703484528055?url=https%3A%2F%2Fibin.co%2F3TRtpV2GF0de.png&fb_obo=1&utld=ibin.co&stp=c0.5000x0.5000f_dst-emg0_p98x98_q75&ccb=13-1&oh=06_AbHxI_N1CaUvdKYeqqNgDC6W98s4mS5Xq5VDiKKq0S6IFQ&oe=64DF2C9C&_nc_sid=dbad39,https://www.facebook.com/openai/posts/654736041381678?__cft__[0]=AZUqY4_EzybPmkkSAp_VhQeaPOdSFtWkfDxCsZuQnCPoRxNH-P-cZzG61Wd7dFHpl7DF6J7ERfU5fiUNt3X3RxZRIW4pnSo8MKrPuOeoLwSQfFfR-zG3WS7vTevDR6rUi1BA4fossipVkEgZ261-r9KhYHid70ZUs_U05_80Rqe5VdmB0KYYOoPoNuM3bNZSDgzJ_Frb6rOm8a4tx97nnkg4&__tn__=%2CO%2CP-R,141,0,positive,141
652694368252512,OpenAI,13,94,8,0,0,0,0,0,102,2,"Multiagent environments where agents compete for resources are stepping stones on the path to AGI. Multiagent environments have two useful properties: first, there is a natural curriculum — the difficulty of the environment is determined by the skill of your competitors (and if you’re competing against clones of yourself, the environment exactly matches your skill level). Second, a multiagent environment has no stable equilibrium: no matter how smart an agent is, there’s always pressure to get smarter. These environments have a very different feel from traditional environments, and it’ll take a lot more research before we become good at them.Details: https://blog.openai.com/learning-to-cooperate-compete.../",2017-06-08T00:00:00,[],https://scontent.fcai19-7.fna.fbcdn.net/v/t45.1600-4/19677982_6075501506367_8887743733064269824_n.png?stp=c0.113.480.251a_cp0_dst-jpg_q90_spS444&_nc_cat=111&ccb=1-7&_nc_sid=67cdda&_nc_ohc=HGC4NWY_mjgAX8aSrma&_nc_ht=scontent.fcai19-7.fna&oh=00_AfDErZqmjScBbqNI-aAyPgZA45fT96LEStjBVw5jWXvMyg&oe=64E24C27,https://www.facebook.com/openai/posts/652694368252512?__cft__[0]=AZV6SHLdGEME7tm3-dkc1rjSS1epIAbiCYbG-VoZstWApG-Pph47zD06ANWOAJB0GtXAbRFT3xwO_6Z7tYsO3hyB-nJzLiSdFBCl0HFnX5zfNXNSmFB-W1shTTu7tfN6ooMMNKIBpr4PJA_ZDqD-6RzyhwKzVFo_iVHq9Iq3rCGn6zxT2NOL-MVaPYGy5kLeh8RSqldFtqQhiYISH7S6ZXkO&__tn__=%2CO%2CP-R,115,0,positive,115
646410832214199,OpenAI,28,126,11,0,0,0,0,0,137,4,"We’re open-sourcing OpenAI Baselines, our internal effort to reproduce reinforcement learning algorithms with performance on par with published results. We’ll release the algorithms over upcoming months; today’s release includes DQN and three of its variants.Details: https://blog.openai.com/openai-baselines-dqn/",2017-05-24T00:00:00,[],https://scontent.fcai19-7.fna.fbcdn.net/v/t45.1600-4/19886465_6075803211567_2367123533873545216_n.jpg?stp=c12.0.144.223a_cp0_dst-jpg_p168x128_q75_spS444&_nc_cat=111&ccb=1-7&_nc_sid=67cdda&_nc_ohc=_k_OJ-MtNE0AX-_VfWi&_nc_ht=scontent.fcai19-7.fna&oh=00_AfAYx3b-VXsPaExsUgrSzc9bLH5nc3iloR2MCYy3WbDMyQ&oe=64E22FD5,https://www.facebook.com/openai/posts/646410832214199?__cft__[0]=AZX8Jp2DCv3nkaBRLh7YImb5TjUO_9EHWf0XVPpOQ_GGD_kmuqbshPR2Kl9bJhGlI1J02Evu9uZ3YaVyq_JA-xa0BL5QwUau2bNjpz-_5aprjI4p95CS3_GVAgJ4Vdu75z16AKzvWEeGoRAhS4mIvVWjHYnWemJS0S2FpzPPRaDnl7IFEZlFCcKQvdLobRJTHUxmcOSBjtvESuMLa3s2epaSL02A2HDp9J2CIqMZjMTTNw&__tn__=%2CO%2CP-R,165,0,positive,165
642411485947467,OpenAI,219,263,21,31,0,0,0,0,315,19,"We’ve created a robotics system, trained entirely in simulation and deployed on a physical robot, which can learn a new task after seeing a human do it in VR once.Details: https://blog.openai.com/robots-that-learn/",2017-05-16T00:00:00,['blob:https://www.facebook.com/c6468603-7cc6-4e0a-be26-745d5ab8e84c'],https://scontent.fcai19-7.fna.fbcdn.net/v/t15.5256-10/18555451_642415089280440_9104049079343644672_n.jpg?stp=dst-jpg_p180x540&_nc_cat=110&ccb=1-7&_nc_sid=ad6a45&_nc_ohc=THc-mlrA1UkAX-bMvYX&_nc_ht=scontent.fcai19-7.fna&oh=00_AfDAgAgvSveLHzWuThmUkJgMm35vQicPIMsXhzRP_aRy3A&oe=64E2DE39,https://www.facebook.com/openai/videos/642411485947467/?__cft__[0]=AZXxW68No8jFxnehCusb78UvyNblNHFHXAcIoaJijRppfxLR2R6T6OGD6j7nVucqecuE1GXspLG2H0gSFIpSZo38DDnad7h5R-HOG4xegXCfGk6wfJo3DrecppNGDAEYRJJbUZ1GR8724ncKQO7OXAPcfZFX94u8q8xRIyE5T63VV6UClQgyOFQVUctBEr5x3DvsgZudd6HXKak5zskUHalk&__tn__=%2CO%2CP-R,534,0,positive,534
434615506727067,OpenAI,7,44,8,0,0,0,0,0,52,11,Introducing OpenAIhttps://openai.com/blog/introducing-openai/,2015-12-12T00:00:00,[],https://scontent.fcai19-7.fna.fbcdn.net/v/t45.1600-4/17508671_6073104724807_906883710350000128_n.png?stp=c30.0.1340.700a_cp0_dst-jpg_q90_s526x296_spS444&_nc_cat=109&ccb=1-7&_nc_sid=67cdda&_nc_ohc=lm5XVMKQEZQAX-MyjKU&_nc_ht=scontent.fcai19-7.fna&oh=00_AfAZHYnA-mGzMF2al8ZsvYWNss612IiWxGy7g5RPz_0utA&oe=64E2F163,https://www.facebook.com/openai/posts/434615506727067?__cft__[0]=AZW2DeCmqY68U9XFmLXTojYZc9wO919j5yFMx-tRZeiK8j67PhHR9XZU5oOdXkmZVJ3MsVHRdTXGLAMjV0e9bACew40vfpa2G5CelBEdMB0JQN9TF6r9DyBMi1sP7dghK-D3ExSwV6WSIJEwtq62JfOBjVASfYTMFpjDC7dirfY0HMoAiR1RqPA9crqgb2sKuWpkV6TgnhnhISX2LmS3BufQ&__tn__=%2CO%2CP-R,59,0,positive,59
