id,name,shares,likes,loves,wow,cares,sad,angry,haha,reactions_count,comments,Summary,posted_on,video_url,image_url,url,positive_reactions,negative_reactions,Sentiment Analysis
pfbid0xQhhZ1ziVDRPHkwsjiAL2y85wyhngKAoTHZk1ZdALba1yg2s5dcRSkekhaCMuW86l,OpenAI,284,1300,133,109,0,0,0,0,1542,677,"We're releasing an API for accessing new AI models developed by OpenAI. You can ""program"" the API in natural language with just a few examples of your task. See how companies are using the API today, or join our waitlist: https://beta.openai.com",2020-06-11T00:00:00,['blob:https://www.facebook.com/ff5bbd02-01b8-4487-9950-d90fe796d2e2'],https://scontent.fcai19-7.fna.fbcdn.net/v/t15.13418-10/103479749_631282460792212_6062680365921539734_n.jpg?stp=dst-jpg_p180x540&_nc_cat=110&ccb=1-7&_nc_sid=ad6a45&_nc_ohc=JQt7smEbqr8AX_KclUO&_nc_ht=scontent.fcai19-7.fna&oh=00_AfB2FPjUVnLwOlHr0wcc6XLHDllfNSTLtmZpJB5Yh3QY3A&oe=64CDC484,https://www.facebook.com/openai.research/posts/pfbid0xQhhZ1ziVDRPHkwsjiAL2y85wyhngKAoTHZk1ZdALba1yg2s5dcRSkekhaCMuW86l?__cft__[0]=AZUGFlaeG3CUflMgDGoZXOkHzR8riGLLNrFZCJyX-43lyKLIiPj41movRrWyIGQvXnEugQa9ncDlh1ZP_P4FIgVOWwLHEOVdZ1D7F8imr5Z_74Pd0EAaw9nk36ROdIpopJB8eHIwVAPmbypPIpFmGNw5Ph9sqX5_Sfj12Pu1S3H7OZIit4bCfP0mPXzj9lrWbq0-g0urZrdqIXSHa5T2WSZyTYkylYdrdcLUl02B1F95sA&__tn__=%2CO%2CP-R,1826,0,positive
pfbid0GXCKewL7k9Qsmdp5i2ggLWgtXw5GW1ZSNSPBp6WYrLzsSh9RUJmcLPfLqFP5ELZHl,OpenAI,33,510,36,0,0,0,0,0,546,79,"Since 2012, the amount of compute for training to AlexNet-level performance on ImageNet has been decreasing exponentially — halving every 16 months, in total a 44x improvement. By contrast, Moore's Law would only have yielded an 11x cost improvement: https://openai.com/blog/ai-and-efficiency/",2020-05-05T00:00:00,[],https://scontent.fcai19-7.fna.fbcdn.net/v/t1.6435-9/95582019_1399137263608215_6705405446204686336_n.png?stp=dst-png_s960x960&_nc_cat=104&ccb=1-7&_nc_sid=730e14&_nc_ohc=sV6P8lfiYk8AX_ovgG8&_nc_ht=scontent.fcai19-7.fna&oh=00_AfApzrL9gmFx2dVlx0EBuZYJUkw0jS5Z12OysTkuvjKhHw&oe=64F08DA3,https://www.facebook.com/openai.research/posts/pfbid0GXCKewL7k9Qsmdp5i2ggLWgtXw5GW1ZSNSPBp6WYrLzsSh9RUJmcLPfLqFP5ELZHl?__cft__[0]=AZWep8B6KpZGlGt_0mqHbDgDGLNGaMPCfVRH9G7o3CyAw2T1IbGU11zbItYB2v9NkieiXrJgZbCnny-3XbWOzo2zzlWzX5Js0q9iQNqxRXnVGWHmzklPxF-ROq6Qk-qCOLKxJJ6MDmJTUtPxzpkD4vh5eq4CQYvfLXRwguuLvwUSdv2nN7EYDDQmFEC1AZNd7PW3s6Z57cGaVkViPJjz78GF&__tn__=%2CO%2CP-R,579,0,positive
pfbid0zE6DPpxLCpYDqwgtqdCxXfY9Hs8sKPBZi3UBQixi6BT4or9FtmeehXmXCV2RsfbYl,OpenAI,114,483,55,39,0,0,0,0,577,54,"Introducing Jukebox, a neural net that generates music, including rudimentary singing, as raw audio in a variety of genres and artist styles. We're releasing a tool for everyone to explore the generated samples, as well as the model and code: https://openai.com/blog/jukebox/",2020-04-30T00:00:00,['blob:https://www.facebook.com/4e2e5d88-8b08-41ef-8530-73cd147752d5'],https://scontent.fcai19-7.fna.fbcdn.net/v/t15.13418-10/94976179_802439936951914_8132937521811161088_n.jpg?stp=dst-jpg_p640x640&_nc_cat=102&ccb=1-7&_nc_sid=ad6a45&_nc_ohc=ArGNel84b6wAX9J7IV6&_nc_ht=scontent.fcai19-7.fna&oh=00_AfA8j3HGAgYB_JGNhWh8JeUCNK8kV9GdrD6CNGDc3x-v3w&oe=64CE7B09,https://www.facebook.com/openai.research/posts/pfbid0zE6DPpxLCpYDqwgtqdCxXfY9Hs8sKPBZi3UBQixi6BT4or9FtmeehXmXCV2RsfbYl?__cft__[0]=AZXY_Razauh9vYUXA94BQS_x8Am047Wtp9tIiknFaULxvu5cStguf3k864ZuUtuoRWcs8WBF_GGbf92rfAf_hyl5vjP_dJHLDfzpgS0Q5cxqW5d_MWWxBnoXSJ54n-aeamwM0xl5Z2CPAdjidTcMdcG9iAvI-GX6akcoPnuOrYuxSTvZbjPgqJjbZBrqji1Q4QvVDfXR5lHnSzw9qBQZICiNGl2elEwO3YkuZUfkJhL1Kw&__tn__=%2CO%2CP-R,691,0,positive
pfbid02Nci2KkWRSnoiTUjYjGrieN4wKi3JCuTXeKWEzanR4hP3UPNytPsDKgCpTyydkvTjl,OpenAI,116,635,60,0,0,0,0,0,695,50,We're standardizing OpenAI's deep learning framework on PyTorch to increase our research productivity at scale on GPUs (and have just released a PyTorch version of Spinning Up in Deep RL): https://twitter.com/OpenAI/status/1222927584033247232,2020-01-30T00:00:00,[],https://scontent.fcai19-7.fna.fbcdn.net/v/t1.6435-9/83896874_1320269424828333_6405901231872540672_n.png?stp=dst-png_s960x960&_nc_cat=108&ccb=1-7&_nc_sid=730e14&_nc_ohc=64kDD6x2rbMAX-OqPAd&_nc_ht=scontent.fcai19-7.fna&oh=00_AfDgDZwAG9zvAZ2ryYIZcGZ0-KQRiQVjbnGn-me95BEgJA&oe=64F0B5C9,https://www.facebook.com/openai.research/posts/pfbid02Nci2KkWRSnoiTUjYjGrieN4wKi3JCuTXeKWEzanR4hP3UPNytPsDKgCpTyydkvTjl?__cft__[0]=AZWO5TzRIELlhLAW1ebJ6FMLQ-AkXyZrDKhV21sphpQ1MkEai0epAeRxUCc0dBeQ1IRqVKc3FTjyO4K7lkeYyiI_7f2NY1xD4l8UaBOXneeTgj4SvK4_DVC9K7SL9CLaHwjS9D9gzh_ZvXwrgqCaiTB_zvSBOL3dYCeTfxACzBwXQbFD_MTO0Q5437HnW7X0lF9J-qLP9QuPINmqJtfuWnWc&__tn__=%2CO%2CP-R,811,0,positive
pfbid02SbaVaC1z25KsiUMpkmrY58ZTyVaZcHTnRTn3SP2Wb7RgUPi38S7KFGkEJNTjT1Ufl,OpenAI,44,416,42,0,0,0,0,0,458,30,"We're releasing ""Dota 2 with Large Scale Deep Reinforcement Learning"", a scientific paper analyzing our findings from our 3-year Dota project: https://openai.com/projects/five/One highlight — we trained a new agent, Rerun, which has a 98% win rate vs the version that beat @OGEsports.",2019-12-13T00:00:00,[],https://external.fcai19-7.fna.fbcdn.net/emg1/v/t13/10332535334742334873?url=https%3A%2F%2Fopenai.com%2Fcontent%2Fimages%2F2019%2F12%2FOPEN_AI_DOTA_FINALS_3_DSC1231.JPG&fb_obo=1&utld=openai.com&stp=c0.95.2000.1044a_dst-jpg_flffffff_q75_s500x261&ccb=13-1&oh=06_AbF6p-HICXOlVnPMEjxsWaGDYXzmYb17UkEBwKWK1MGZwQ&oe=64CB057A&_nc_sid=ff403b https://external.fcai19-7.fna.fbcdn.net/emg1/v/t13/11374216730095658970?url=https%3A%2F%2Fwww.ox.ac.uk%2Fsites%2Ffiles%2Foxford%2Ffield%2Ffield_image_highlight%2Fannie-spratt-sggw4-qDD54-unsplash.jpg&fb_obo=1&utld=ac.uk&stp=c0.5000x0.5000f_dst-emg0_p98x98_q75&ccb=13-1&oh=06_AbGARO_mJ_4ADkEIDdEsPZay_HjqrgnssNQJFTn4DK6lyA&oe=64CAF4C7&_nc_sid=dbad39,https://www.facebook.com/openai.research/posts/pfbid02SbaVaC1z25KsiUMpkmrY58ZTyVaZcHTnRTn3SP2Wb7RgUPi38S7KFGkEJNTjT1Ufl?__cft__[0]=AZUYt_MRjDECon84e-Jx_j-KXewp_iem9a50VcVamLRsTVLFVmPZW3N-5A1XpLdsCpnxn4SOwhB6ygrzlPRbvr9vN06wCOsWMuWkVvmh1icwADnSgOQrQaj-llCO3QRHo3yAq1e6WA1oauC-Clc0nIBmzAeDOnJipBr5E-os_C0oWGi4IwmIWsWz-DFon3L712rGTKvdL5e8HUujf8Wws-AG&__tn__=%2CO%2CP-R,502,0,positive
pfbid0hbsgcUQ9dMQebDqr5jMyLg8ijdy8vfi6knqsDbtBHPed4hfxwX2pUBzTHArc2H3Wl,OpenAI,43,303,0,24,0,0,0,0,327,16,"A surprising deep learning mystery:Contrary to conventional wisdom, performance of unregularized CNNs, ResNets, and transformers is non-monotonic: improves, then gets worse, then improves again with increasing model size, data size, or training time.https://openai.com/blog/deep-double-descent/",2019-12-05T00:00:00,[],https://scontent.fcai19-7.fna.fbcdn.net/v/t1.6435-9/79932933_1270728539782422_5130827674796687360_n.png?stp=dst-png_s1080x2048&_nc_cat=105&ccb=1-7&_nc_sid=730e14&_nc_ohc=xpZHdEfEJoEAX9hIxSR&_nc_ht=scontent.fcai19-7.fna&oh=00_AfCxT0Y3istq4qdtgG7Ffrpe9XsKK8t8wWz1tWijfH-CIA&oe=64F0BFA0,https://www.facebook.com/openai.research/posts/pfbid0hbsgcUQ9dMQebDqr5jMyLg8ijdy8vfi6knqsDbtBHPed4hfxwX2pUBzTHArc2H3Wl?__cft__[0]=AZWohJcYh1ms6tOLX954firYAwWBksAzgxiO2KL6fR-iurpFaqMGK79O8K_cv_KbOzFACV9WJk6M09VpXhU1cDz0TjRiUYkEd7wgG9NVWQuBpu1e_Hhp0u6HcMxt2zpndcruBRGS5EuabzIbQlgy3H8Q_wMXvhdoLhSoRbi0VZ2LSkMizpFevbNbuGDu0sopmnCRdmubWTvCHmp48Ah1sy1P&__tn__=%2CO%2CP-R,370,0,positive
pfbid02LpJYMzysvaKK7KcaL5mydXaHc2gW584oY6wRyQFMMXHkYL9LbybzaBKCu8KZcp92l,OpenAI,40,215,19,0,0,0,0,0,234,9,"We're releasing Procgen Benchmark, 16 procedurally-generated environments for measuring how quickly a reinforcement learning agent learns generalizable skills.This has become the standard research platform used by the OpenAI RL team: https://openai.com/blog/procgen-benchmark/",2019-12-03T00:00:00,[],https://external.fcai19-7.fna.fbcdn.net/emg1/v/t13/143141077403433689?url=https%3A%2F%2Fopenai.com%2Fcontent%2Fimages%2F2019%2F12%2Fog-image.jpg&fb_obo=1&utld=openai.com&stp=c0.5000x0.5000f_dst-jpg_flffffff_p500x261_q75&ccb=13-1&oh=06_AbGlSm6GXValX170a_STnd5A_Fg_fFouTnU16wspsUlVjw&oe=64CAE5D4&_nc_sid=dbad39 https://static.xx.fbcdn.net/rsrc.php/v3/yw/r/8iuTX4LlGZO.png,https://www.facebook.com/openai.research/posts/pfbid02LpJYMzysvaKK7KcaL5mydXaHc2gW584oY6wRyQFMMXHkYL9LbybzaBKCu8KZcp92l?__cft__[0]=AZUX-V6vGh3Q4rFSwDMFtX4owTJpbVMOXF15UzI8APePD3c87waSizy1eo99UKQm5QaD7UKdu2AVxoxQ6hxPIFWcmfTEWWeIXRjmZEm8tOGqgBfoHePeNSHKiWrpzBZj0Si8U0C_nwqQ4_bgjLzdCt0XoQhYfsPMAQKr7bQUK6dPee6aUCupIBWYG3442PR46l05cMrJWwClktLUhyBPghqE&__tn__=%2CO%2CP-R,274,0,positive
pfbid0bwNT8rA56RND34ReK4Q2gYoG86p5zynXAgFMknhmeQvor2Fg5PoU9uisLc2NvXrrl,OpenAI,36,191,24,0,0,0,0,0,215,8,"We're releasing Safety Gym, environments and tools to evaluate reinforcement learning with safety constraints: https://openai.com/blog/safety-gym/Aims to ultimately help agents satisfy real-world safety requirements while training (eg not driving off a cliff, not writing abusive content).",2019-11-21T00:00:00,[],https://external.fcai19-7.fna.fbcdn.net/emg1/v/t13/11810377064647312513?url=https%3A%2F%2Fopenai.com%2Fcontent%2Fimages%2F2019%2F11%2Fsafety-gym-cover-2.png&fb_obo=1&utld=openai.com&stp=c0.5000x0.5000f_dst-jpg_flffffff_p500x261_q75&ccb=13-1&oh=06_AbGfuZIE5pZM3FsoYjZsMm8DFWHughbZ2iZQ7o6JqI9ajQ&oe=64CAA037&_nc_sid=dbad39,https://www.facebook.com/openai.research/posts/pfbid0bwNT8rA56RND34ReK4Q2gYoG86p5zynXAgFMknhmeQvor2Fg5PoU9uisLc2NvXrrl?__cft__[0]=AZUY31j56-d5evFZ0ZdFsi7BL3kWbP45mXuDhm808vVKHN8wvmQ-K_NBEf7PHOhH5pHTcgU5FLZ6nX-OBF6jWHK3NhTS-NxG_6K8f14QBqMaN5KO9LJI_j8o7Bv1Ax6EMsOWgI77EiJIDn_MJRr4zOvUcyCZ3hx2r7-A2zO4U58TIX0061fAzzK4Wn0c4wRbnLqnK-hmHNkcLEnezvzt8oXX&__tn__=%2CO%2CP-R,251,0,positive
pfbid0Le9XENh122dqnknsDrVLd1cLQZURcgp4ob2PtEAcRBCoxtUt9RWKk1JX4etTNcRKl,OpenAI,57,252,29,22,0,0,0,0,303,43,We're releasing the 1.5billion parameter GPT-2 model as part of our staged release publication strategy.- GPT-2 output detection model: https://github.com/.../gpt-2-output.../tree/master/detector- Research from partners on potential malicious uses: https://d4mucfpksywv.cloudfront.net/papers/GPT_2_Report.pdf- More details: https://openai.com/blog/gpt-2-1-5b-release/,2019-11-05T00:00:00,[],https://scontent.fcai19-7.fna.fbcdn.net/v/t1.6435-9/75543459_1244743475714262_1371225926234275840_n.jpg?_nc_cat=111&ccb=1-7&_nc_sid=730e14&_nc_ohc=nBK3Bi_4l9QAX88GM_l&_nc_ht=scontent.fcai19-7.fna&oh=00_AfD1XTIun10Se-BEtB-_Exq_T2wPAlfx5q-M34ayZZKngQ&oe=64F09C2E,https://www.facebook.com/openai.research/posts/pfbid0Le9XENh122dqnknsDrVLd1cLQZURcgp4ob2PtEAcRBCoxtUt9RWKk1JX4etTNcRKl?__cft__[0]=AZVBOkRhLMXDX7KlaS5CGew2kPcU_sSN-94s7-kfgM0hY2AIVPO6LKpguvUIUjT7Nqq9NUdP-UNKt16qqwuVNThaAm7dvjCiJzyYVlq1g-Zb3XHoGeooJjC9uk_mt2hMDMllu3k9AhIaVoX6g3yzXcyqC7epE0v6fL3iGrDiexmAWxArYDqQUHCtzLrlC5Rngt5qFJCF8UJ7-eumnJ7UPFDk&__tn__=%2CO%2CP-R,360,0,positive
pfbid0vb6ZpGokbTMYK6Pr2cMNhpepzLgqiRQfSjkrtRx4rRCS7zyZCJsFXDP1SNP58ZMml,OpenAI,31,407,56,0,0,0,0,0,463,36,"""Solving the Rubik's Cube with a Robot Hand"" took many human hands over the past 2.5 years — meet our Robotics team! (PS they're hiring: https://openai.com/jobs/!)",2019-10-16T00:00:00,[],https://scontent.fcai19-7.fna.fbcdn.net/v/t1.6435-9/72568141_1227404510781492_891891542887759872_n.jpg?stp=dst-jpg_p180x540&_nc_cat=110&ccb=1-7&_nc_sid=730e14&_nc_ohc=TouZQIEDPFIAX8syxvM&_nc_ht=scontent.fcai19-7.fna&oh=00_AfAZLOYxjk8SryX9OT3LlM1gS3pGtJz7SozhknJPAqRsFQ&oe=64F0A557,https://www.facebook.com/openai.research/posts/pfbid0vb6ZpGokbTMYK6Pr2cMNhpepzLgqiRQfSjkrtRx4rRCS7zyZCJsFXDP1SNP58ZMml?__cft__[0]=AZUhOkE32NBwrJAx65JvYSq8UeoslsdJZZgC81xnLYSNGlqLfFi_57MwLLfl3pTc64EO1ksDpJbpw1DAYznFGDoAqznMsCzKlAEnePVvd7zB0D0UrdTFcIOmzPti2qDtqdT6otTdDTp8DpfQkv866kDIZamid-cyXZADBq6P-p-vtsENyzPVHXxJIe19obcDjRJZDUdArlODeR1iLU962GFt&__tn__=%2CO%2CP-R,494,0,positive
pfbid0249aKmz4szqbnVCBy6G5jJw1tSF7r3oneKoq3qAQLpm19YDo3aXfQGSSrbAu8A8u5l,OpenAI,62,236,18,0,0,0,0,29,283,20,"We’re all used to robots that fail when their environment changes unpredictably. Our robotic system is adaptable enough to handle unexpected situations not seen during training, such as being prodded by a stuffed giraffe:",2019-10-15T00:00:00,['blob:https://www.facebook.com/c268b154-b7a0-4c80-ba2f-bb43a81c4ace'],https://scontent.fcai19-7.fna.fbcdn.net/v/t15.13418-10/70874576_588448761953904_6591947588658790400_n.jpg?stp=dst-jpg_p180x540&_nc_cat=109&ccb=1-7&_nc_sid=ad6a45&_nc_ohc=crQIseudmPAAX_NZW-M&_nc_ht=scontent.fcai19-7.fna&oh=00_AfDaaj21zZNHBW7e_ocGq9T3o7XrFQDoZQShvEcDzk277A&oe=64CEC302,https://www.facebook.com/openai.research/posts/pfbid0249aKmz4szqbnVCBy6G5jJw1tSF7r3oneKoq3qAQLpm19YDo3aXfQGSSrbAu8A8u5l?__cft__[0]=AZUIo22cRyXmdj_bEgo5_yavtBlHzPedoCdsVag45tilfHR8J-R78S-WcIooCdZ6z0v5SGctBDXWjGwPHQ-1aqOk4byEVQMvMhB-61ApxhEqg0oPhv9Kik2w6P369-f2y6R426YT1B1XZf7ZCL5OCNcEUqP4fJMDAG510yt-79qIeJ1yphQcux-uf9TYc_eUTbuBbBs5UW78x9XVxgqeWC0N7O-M4txUeNOzoPNJWjW7iA&__tn__=%2CO%2CP-R,345,0,positive
pfbid02CU4nSc8HNfBCRRfq9b4xvpbwHBfxCotzHrxjELCzreS8HD8TJm2YjffMyFBMrWeol,OpenAI,313,472,69,88,0,0,0,0,629,33,"We've trained an AI system to solve the Rubik's Cube with a human-like robot hand.This is an unprecedented level of dexterity for a robot, and is hard even for humans to do.The system trains in an imperfect simulation and quickly adapts to reality: https://openai.com/blog/solving-rubiks-cube/",2019-10-15T00:00:00,['blob:https://www.facebook.com/3ffee3de-b66d-4b8d-a4d6-69f5fa36fc47'],https://scontent.fcai19-7.fna.fbcdn.net/v/t15.5256-10/69893344_2528029124150391_2791287258416676864_n.jpg?stp=dst-jpg_p180x540&_nc_cat=111&ccb=1-7&_nc_sid=ad6a45&_nc_ohc=5a837OnV-dAAX_AQ4OZ&_nc_ht=scontent.fcai19-7.fna&oh=00_AfAvqF1C1g-01ZuzeMfjlLrdhzuZReveiPuz-ISxHXsDdg&oe=64CE131F,https://www.facebook.com/openai.research/posts/pfbid02CU4nSc8HNfBCRRfq9b4xvpbwHBfxCotzHrxjELCzreS8HD8TJm2YjffMyFBMrWeol?__cft__[0]=AZWmVDldBHR8pzkzki1gqXb4CkXsljl7dftoYF0SKm1cMP-ySyasqvhFAGloMVZ5mYxyA0lSDGgy5qQs7xYzM6mh9Vf4A0yAqk3p639nhgh6DzwGhkwzTUQSqpyB9NLdeih6caE5ibjXuUyBLBUOyamzxlXTxFs6YefscG5e0FKVNhLfS9KjjsMDIFkouxxQKj4noGZ7tV0zNJ4MHv-enzEafrp_IQvvL3Ge9aG7Fthm1Q&__tn__=%2CO%2CP-R,942,0,positive
pfbid0MDnT8o9axWy1vpqbqX7fNTkkZRJsJhpHYgy3fD93m1dNmh1MwTfUNhG33MFrM3Lql,OpenAI,31,107,12,0,0,0,0,0,119,11,Now accepting applications for our 3rd class of OpenAI Scholars: a 4 month full-time program for individuals from underrepresented groups to study deep learning and produce an open-source project: https://openai.com/blog/openai-scholars-spring-2020/,2019-10-11T00:00:00,[],https://external.fcai19-7.fna.fbcdn.net/emg1/v/t13/9011803195624031144?url=https%3A%2F%2Fopenai.com%2Fcontent%2Fimages%2F2019%2F10%2FIMG_7650-2.jpg&fb_obo=1&utld=openai.com&stp=c0.95.2000.1044a_dst-jpg_flffffff_q75_s500x261&ccb=13-1&oh=06_AbFD3vSisZPwta1xFtjEifGDxMJt-rMKcV68x-aBqJuVhg&oe=64CB1478&_nc_sid=ff403b,https://www.facebook.com/openai.research/posts/pfbid0MDnT8o9axWy1vpqbqX7fNTkkZRJsJhpHYgy3fD93m1dNmh1MwTfUNhG33MFrM3Lql?__cft__[0]=AZUnr1f6YXWhrozHHeMT5EaCspnqzi-nrc8d92xQQz3px_hDP-kUWoWAShM9y9oCkIeY973EKRYgKgx_NDU_PE5ox7McWDWmvgb_aNVjxV3Btc0c8GxQ2n2ZUsEzidZ5a91QHZ-iYAd8x4zkpG3KcYd56AtiqH8T3HJC6Ff-9_ofOLODHGiU5OemvnvbzQOAAhJumLlr1qRcRDVx8Tj5j9YV&__tn__=%2CO%2CP-R,150,0,positive
pfbid02o4amGzEQU56eYehuERQ4YQTkg6z5Sa2sC3GeXQXDXy5C7GxqsDmsmdBknybFixmal,OpenAI,15,85,0,0,0,0,0,0,85,2,"We've fine-tuned GPT-2 using human feedback for tasks such as summarizing articles, matching the preferences of human labelers (if not always our own). We're hoping this brings safety methods closer to machines learning values by talking with humans. https://openai.com/blog/fine-tuning-gpt-2/",2019-09-19T00:00:00,[],https://external.fcai19-7.fna.fbcdn.net/emg1/v/t13/8084641966648390132?url=https%3A%2F%2Fopenai.com%2Fcontent%2Fimages%2F2019%2F09%2Ffine-tuning-gpt-2.png&fb_obo=1&utld=openai.com&stp=c0.5000x0.5000f_dst-jpg_flffffff_p500x261_q75&ccb=13-1&oh=06_AbFpha_Q3B1De7ebXDS6AfefOLntfXUbUWp274gacyPwUw&oe=64CAAF12&_nc_sid=dbad39,https://www.facebook.com/openai.research/posts/pfbid02o4amGzEQU56eYehuERQ4YQTkg6z5Sa2sC3GeXQXDXy5C7GxqsDmsmdBknybFixmal?__cft__[0]=AZUG-vUVd2ZKf0cElT2wKiJPZ5wOcedEjvrxHIXPOwSPNhUFwd8Xupd7h-hVNhSwDkkOQGCj2zX9_g5PGO3GnCSWHjAcILaShWHNA2iZk9gCnsjm-z9A5P8LoMGlyb2Zz9E7CpvWHlYxB67m-_PK6zyZcLxbUSX6TZ-GUQCmRTHGcA0Z7_4G_jLDZcftQl6cyeSOrhUpzNMh8XKLtRqSFJ9g&__tn__=%2CO%2CP-R,100,0,positive
pfbid0DcMfqcWYVDkhYDY6eBo4N288BgGk1vbKiqkhjmGZNqdiUh5jfjgmrASnETUKuGeHl,OpenAI,109,181,24,20,0,0,0,0,225,20,"We've observed AIs discovering complex tool use while competing in a simple game of hide-and-seek. They develop a series of six distinct strategies and counterstrategies, ultimately using tools in the environment to break our simulated physics: https://openai.com/blog/emergent-tool-use/",2019-09-17T00:00:00,[],https://scontent.xx.fbcdn.net/fb.png https://external.fcai19-7.fna.fbcdn.net/emg1/v/t13/3337143555001472154?url=https%3A%2F%2Fmedia1.tenor.co%2Fimages%2Ff252207778e6eeead072e9557b451862%2Ftenor.gif%3Fitemid%3D4570342&fb_obo=1&utld=tenor.co&stp=dst-emg0_q75_s362x200&ccb=13-1&oh=06_AbGCdt_IkTgs4se0dXih8PfMjyMfRMVASbP9icGcQlPHvQ&oe=64CAFFA8&_nc_sid=dbad39,https://www.facebook.com/openai.research/posts/pfbid0DcMfqcWYVDkhYDY6eBo4N288BgGk1vbKiqkhjmGZNqdiUh5jfjgmrASnETUKuGeHl?__cft__[0]=AZVhsxtcr4n02n38GYIKH3oyqelCDoCZea31N2BSLCNYwFKu3JxKHhuPQ7Ttobd2OshRv7WY1XGDVoz-cuorE9hd5w2Si_3rgHlYw0NrxFhqHttIMqmkcx1JFvYR7bnENTXwRUldH1sIrQ7I8xrslQ4ER_TtvRtgEaUOiDWj8CA_P9n3UUWiGIy1RRmkqR747RTK10qFOxcgw3yN2MluDApc&__tn__=%2CO%2CP-R,334,0,positive
pfbid02nc3ZFjqAsg1EJEXkvZrRqdU3omx4q2dND6HvJDo3YXph8VTzsAxMxCmfUkuHmCGVl,OpenAI,8,56,8,0,0,0,0,0,64,7,"We're releasing a new method to test for model robustness against adversaries not seen during training, and open-sourcing a new metric, UAR (Unforeseen Attack Robustness), which measures how robust a model is to an unanticipated attack: https://openai.com/blog/testing-robustness/",2019-08-22T00:00:00,[],https://external.fcai19-7.fna.fbcdn.net/emg1/v/t13/14298140227007166338?url=https%3A%2F%2Fopenai.com%2Fcontent%2Fimages%2F2019%2F08%2Fespresso-2.gif&fb_obo=1&utld=openai.com&stp=c0.5000x0.5000f_dst-jpg_flffffff_p139x139_q75&ccb=13-1&oh=06_AbHbCj2YmUc_rLRu0IifoZXIq1fJPPw29P8sFea_peXGXQ&oe=64CB261B&_nc_sid=dbad39,https://www.facebook.com/openai.research/posts/pfbid02nc3ZFjqAsg1EJEXkvZrRqdU3omx4q2dND6HvJDo3YXph8VTzsAxMxCmfUkuHmCGVl?__cft__[0]=AZUtXxMcoSChLdiH4Rq4O-asCQI61nnnqF2mkB2m6HCnNNYoVVTuONmG_d8J2p5YHIpSD-msTmH3C8C7Rghu0MkZZ0iwPMAO6VlbQQvuulSYkK8MwQNObPMuqfUm6j9nWjOrT1Klm06vJolDKqFCsLirGmIS-6f1EaqM09HOJcnv7gHs0IaUII4C3Ji_tpg5d4CMZXBfDGMEZIvWh78eT7ab&__tn__=%2CO%2CP-R,72,0,positive
pfbid0VWrYPYkpRXUfttJqh3ExC8BESpGQLg33SdVo52sNyZMhHp2zexTCjvQfRxFMLJynl,OpenAI,18,92,0,7,0,0,0,0,99,5,"GPT-2 6-month follow-up: we're releasing the 774M parameter model, an open-source legal doc organizations can use to form model-sharing partnerships, and a technical report about our experience coordinating to form new publication norms: https://openai.com/blog/gpt-2-6-month-follow-up/",2019-08-20T00:00:00,[],https://external.fcai19-7.fna.fbcdn.net/emg1/v/t13/12967374653218535997?url=https%3A%2F%2Fopenai.com%2Fcontent%2Fimages%2F2019%2F08%2Fgpt-2_update_8-15a-1.jpg&fb_obo=1&utld=openai.com&stp=c0.5000x0.5000f_dst-jpg_flffffff_p500x261_q75&ccb=13-1&oh=06_AbEHRhotMe5pn-NLqGxpZTZcHUOCknOG8E0rOOtRoBVhdw&oe=64CAA367&_nc_sid=dbad39,https://www.facebook.com/openai.research/posts/pfbid0VWrYPYkpRXUfttJqh3ExC8BESpGQLg33SdVo52sNyZMhHp2zexTCjvQfRxFMLJynl?__cft__[0]=AZXqzdRnCYrsKMAg3hoAqEy_EeWGLxanjRcKRNlpD83Ro7jcCxMQqscb9-TkucpjsapgMj_JWdgmSAiN09IEkwmXlOJuDiY81kXr81OoRbQTt872CiB_ij4vNPIFa82ZuXHhw6RnLW_8SMLfA2XVkuVBnswbsfq49dFCcO1QdPAFl4-v9GeftL5PQWFO61nLSOpcOzGzP2HcE54RceNMDe9T&__tn__=%2CO%2CP-R,117,0,positive
pfbid02UeBRJHfEEFUKb2ZfwJaLCFAwdcXc418TSDeFKgnTYFRYivxZa2cP7uNnjoQE2vMkl,OpenAI,9,143,14,0,0,0,0,0,157,4,Each Thursday at OpenAI is Learning Day: a day where employees have the option to self-study technical skills that will make them better at their job but which aren't being learned from daily work.Here's how it works: https://openai.com/blog/learning-day/,2019-08-01T00:00:00,[],https://external.fcai19-7.fna.fbcdn.net/emg1/v/t13/10231629015635778685?url=https%3A%2F%2Fopenai.com%2Fcontent%2Fimages%2F2019%2F08%2Flearning-day_small-1.jpg&fb_obo=1&utld=openai.com&stp=c0.5000x0.5000f_dst-jpg_flffffff_p500x261_q75&ccb=13-1&oh=06_AbGkrAxhE95Ckh9mnK1QZbskO6ax3IazM7UM5ywg14YQzQ&oe=64CAE21C&_nc_sid=dbad39,https://www.facebook.com/openai.research/posts/pfbid02UeBRJHfEEFUKb2ZfwJaLCFAwdcXc418TSDeFKgnTYFRYivxZa2cP7uNnjoQE2vMkl?__cft__[0]=AZXwzt-YANOpHeVF1rorGyHCj23Q3ak0DqIZ7n1BnKjPfRca72TsBjqJSqACC6ey-vo7_ukKb_qflZpaVgR5o112qTscX7CgRd7pJpZTnoTGwDY0ZiXA15apSnhO-aAOfK-2WsjKrAhHRb7WXrRjp7VE0ujF0OTtjh6rTAcKKNQkhX0BQUUW7oOdr0ZJCeI7Dya3LXJA7dwWn-b2F2dr-CyI&__tn__=%2CO%2CP-R,166,0,positive
pfbid0jxH5jc4fAMBjyTvexdgsC6GVTtcyx6rqFnqzJfTVdsnPcGUoruBLZkJ7H7YoetHXl,OpenAI,39,161,10,0,0,0,0,0,171,4,"A conversation with Sam Altman and Satya Nadella about the promise of AGI, the need for massive compute power to make it real, and OpenAI/Microsoft's joint commitment to AI safety: https://www.linkedin.com/.../urn:li:activity.../",2019-07-22T00:00:00,[],https://external.fcai19-7.fna.fbcdn.net/emg1/v/t13/9569501322522741459?url=https%3A%2F%2Fdms.licdn.com%2Fvideo-thumbs%2FC5605AQE9_sIGKsrFdA%2Fb6d0083ee991464d9c17e7dc6be78a4b%2Ffeedshare-videocover_high-captions-thumbnails%2F1280x720-00001.jpg&fb_obo=1&utld=licdn.com&stp=c0.17.1280.668a_dst-jpg_flffffff_q75_s500x261&ccb=13-1&oh=06_AbEdsUlBS65ecVcl6nzWwBwjgOXN_MF4vgqDIj5nZqbWUg&oe=64CAF632&_nc_sid=ff403b,https://www.facebook.com/openai.research/posts/pfbid0jxH5jc4fAMBjyTvexdgsC6GVTtcyx6rqFnqzJfTVdsnPcGUoruBLZkJ7H7YoetHXl?__cft__[0]=AZXNw-MzIlkjiIQy13AkWi4jesh08g5Hf_b_9tjYnLLyc0u4WPGnx8f1hd9VeWyaDIbVZ1bRX-FOmIsxnMD0CUp9OeT5oetFCbWcN38N2xWNu5V6PcqwmK4yW-aMbQwIaK8tiUWxCMUTDF3CDxcp27rcPD8x6bJbJ7H7zIyCxfgI6qUp2-6FTuAuans62ikx2Wo2luuy6uX1yiRMIwSlit0-&__tn__=%2CO%2CP-R,210,0,positive
pfbid0pmCbRDf4Di55qwh2dmYHhyKEpZ2h1gMsvxnqUhe6aT3J7LVD7rWA8UGiwc4DfF7Vl,OpenAI,119,404,49,60,0,0,0,0,513,27,Microsoft is investing $1 billion in and partnering with OpenAI to support us building beneficial AGI: https://openai.com/blog/microsoft/,2019-07-22T00:00:00,[],https://external.fcai19-7.fna.fbcdn.net/emg1/v/t13/10974070184528544238?url=https%3A%2F%2Fopenai.com%2Fcontent%2Fimages%2F2019%2F07%2Fopenai-msft-twitter_7-21b-1.jpg&fb_obo=1&utld=openai.com&stp=c0.5000x0.5000f_dst-jpg_flffffff_p500x261_q75&ccb=13-1&oh=06_AbFmPdW9lD1UZbGJ0n3MzxVWOe85_U7h7bkR4ogwzsGAgA&oe=64CAD7DE&_nc_sid=dbad39,https://www.facebook.com/openai.research/posts/pfbid0pmCbRDf4Di55qwh2dmYHhyKEpZ2h1gMsvxnqUhe6aT3J7LVD7rWA8UGiwc4DfF7Vl?__cft__[0]=AZXeIkGA6BfLfRevo4lzu-I03u1R-6euWTS-Q9-LxO8h6yUiNxjpIUzXeNDVNSQ9D-cXjBS-7UH9MpILm-n_HPaoFgqwb-5IswrVhAqFRvQS3Yy6LwErxDHwqbp7OtVxJBSQwDeC8J6BBhhu4lCkbFJGq0CI8CWEQ_AfHDmuEECTJcvM59weAX0QpXdV13EzvaMpkL-Dl6k06dx3qKahbx7t&__tn__=%2CO%2CP-R,632,0,positive
pfbid037YooenDhCZ97SMNa56eU5PJuEioAqFD8f9C4ine9ubDkczbyDENiA3bhzyarUM4ml,OpenAI,31,110,9,7,0,0,0,0,126,17,MuseNet is playing an experimental concert from now until 3pm PT on livestream: http://twitch.tv/openai No human curation or filtering involved — these are samples generated directly by MuseNet without any human intervention. Please enjoy!,2019-04-25T00:00:00,[],https://scontent.fcai19-7.fna.fbcdn.net/v/t1.6435-9/58570496_1027575917431020_839234633953443840_n.jpg?stp=dst-jpg_p180x540&_nc_cat=107&ccb=1-7&_nc_sid=730e14&_nc_ohc=YgHVFNMz4O8AX_BgPGy&_nc_ht=scontent.fcai19-7.fna&oh=00_AfAp8cxwRjttt7I0h5aFIw-UJaNFYh_zaWYxRm6jmQW2xw&oe=64F0B60D,https://www.facebook.com/openai.research/posts/pfbid037YooenDhCZ97SMNa56eU5PJuEioAqFD8f9C4ine9ubDkczbyDENiA3bhzyarUM4ml?__cft__[0]=AZUJkYjEmpwxP4vk7HycGYIDLoqCPXA4Dq5RTRpYTxhNDSW7OPgEmrsTxYJJVTHlTzY39Y57sAMYxhdDnYhqLa1apKzB-gA3r2NefwlAEH1_9LSZ4Bwacx60emS4GQApvXldC6PvDX_MM8_elbX-Ak_OPxfuIhZEiD6uiIYu4QU4topa14d1kkgw4XYLh-IdXoOjMXs6Y95gpBnXZf2WnT-n&__tn__=%2CO%2CP-R,157,0,positive
pfbid02bKmSsZDP1haAY6qsdznNhszaSDTcKMN53Rrg9MttxWrG6SC3ELFDUrUuD9EMUHgEl,OpenAI,47,146,14,9,0,0,0,0,169,26,"We've created MuseNet, a neural network which discovered how to generate music using many different instruments and styles.Listen to MuseNet samples, and interact with a prototype co-composer tool, here: https://openai.com/blog/musenet/ MuseNet will play an experimental concert today from 12–3pmPT on livestream: http://twitch.tv/openai",2019-04-25T00:00:00,['blob:https://www.facebook.com/177cdad4-7c2a-4c81-9a20-f40935acd5ec'],https://scontent.fcai19-7.fna.fbcdn.net/v/t15.13418-10/56990496_285271705728631_7403366962136350720_n.jpg?stp=dst-jpg_s960x960&_nc_cat=105&ccb=1-7&_nc_sid=ad6a45&_nc_ohc=BFEVx3vvh9MAX_Ujo8b&_nc_ht=scontent.fcai19-7.fna&oh=00_AfAcYgXUJgT5n3pFbKQDVP6rngQLMkYjBI5FligRLdJrEw&oe=64CE4B21,https://www.facebook.com/openai.research/posts/pfbid02bKmSsZDP1haAY6qsdznNhszaSDTcKMN53Rrg9MttxWrG6SC3ELFDUrUuD9EMUHgEl?__cft__[0]=AZWy0Iw6SWFiqopZ03Tr65yIfnzbfPXMC_4NlurN8qm7mGah0SbknCp_WQiZxBuaef-UMw029nGtVTUMEMBAmFmgMeA_W9xDOAy4dEsScmXkdEreeO5eJ2TGyGg9zJt7ilJuqyGAtThxzckoug5D6ZNOeZE542owyItAN8UQPU06YDz823W99LGUv9GBNzTZt-1hdEp73qjKW1TklrR6WVBCXmUx7AtPJi2TB4zXdCf4mg&__tn__=%2CO%2CP-R,216,0,positive
pfbid02EHnFZZ52CGfGiEgNzT9DrpmU7SQZt2Pts7zWom6sAZnhxX3oh32hzEXFtmRaB5ZKl,OpenAI,30,156,12,12,0,0,0,0,180,7,"We’ve developed the Sparse Transformer, a deep neural network which sets new records at predicting what comes next in a sequence — whether text, images, or sound. It uses an algorithmic improvement of the attention mechanism to extract patterns from sequences 30x longer than possible previously.Read more: https://openai.com/blog/sparse-transformer/",2019-04-23T00:00:00,['blob:https://www.facebook.com/a51eb2b2-1e45-4fa7-b84f-b4514e7705cb'],https://scontent.fcai19-7.fna.fbcdn.net/v/t15.13418-10/56675406_664805310643087_4839925631418368000_n.jpg?_nc_cat=106&ccb=1-7&_nc_sid=ad6a45&_nc_ohc=dG45wE2EJrwAX87XKpK&_nc_ht=scontent.fcai19-7.fna&oh=00_AfAIFXIsFmgrBA3GDPnBgcXp2bmY6qXtCjOm6-5UFZUgBw&oe=64CD328D,https://www.facebook.com/openai.research/posts/pfbid02EHnFZZ52CGfGiEgNzT9DrpmU7SQZt2Pts7zWom6sAZnhxX3oh32hzEXFtmRaB5ZKl?__cft__[0]=AZXAfbJG2EC4zK971rMN03S0Ybo-vBOIAOCcb8mu8FnvD2JtoiQJuMu-1Smg2nNI-NGdx-T1ssUGQsIKg3vFQBSokqqBVeUlPjq9vG5bbnr3FXYXDWYQDEaSNT_HYw1PwpEyd1rGXZkGrXXkpy3ZoA-bDn2pu4saoFMjXhM3OK2Ua5m3iCXQU4mhr78RdllmY3jaeS2JvfP2E5xT8vwlagdKl6WfrHNtRbsWzyfG7i7mfg&__tn__=%2CO%2CP-R,210,0,positive
pfbid02U9Zs1BvGzpEoTo2Gctwr3RjCMgiCZN13hMDsXQEgoSpmKsUd692xLMDSrXsQhTEWl,OpenAI,35,134,14,0,0,0,0,0,148,7,"OpenAI Five is now the first AI to beat the world champions in an esports game. Here's what happened, and how we made our comeback since losing to pros in Aug 2018: https://openai.com/blog/how-to-train-your-openai-five",2019-04-15T00:00:00,['blob:https://www.facebook.com/8182eca5-d59c-479c-96b5-ff24aa7f71f5'],https://scontent.fcai19-7.fna.fbcdn.net/v/t15.5256-10/56386579_2334614650115286_5883325023300616192_n.jpg?stp=dst-jpg_p180x540&_nc_cat=109&ccb=1-7&_nc_sid=ad6a45&_nc_ohc=5lynefe5eAEAX8HYIf5&_nc_ht=scontent.fcai19-7.fna&oh=00_AfBIowMFkwiiDTDyVUblspNHuFo_Zd5mjgdeKps2XdRZww&oe=64CDD5D5,https://www.facebook.com/openai.research/posts/pfbid02U9Zs1BvGzpEoTo2Gctwr3RjCMgiCZN13hMDsXQEgoSpmKsUd692xLMDSrXsQhTEWl?__cft__[0]=AZU00NpJOeL0wqBGchUdcI6mb7awhHOYIXJfEqOzz7um-G4t8PMNlDoinRRK5q0BF3fqaSiMd20tXdHPM2CxdzNnlblNGuWmLOMCkMP7Dq4uGWgk5PFAtQQth0TSY6Mpp_D4s090VM-f-vy3LNLElBnXiwqCLFmCPqj9JP_gtEV4KpwgBdCgmGzMO1eN1vI1FklYdFc0_itzM60XqDy0L2i0ifAX14Tcu_mP_EDDSpGYNg&__tn__=%2CO%2CP-R,183,0,positive
pfbid0bibMM8rSUUrNHFeGFomxvVRaQGESgfUPss9UVeEVooAPyiHmsSxtTg99p8HHceFwl,OpenAI,35,116,11,0,0,0,0,0,127,11,"Today's the day!!! Watch OpenAI Five Finals here, starting 11:30a PT: https://www.twitch.tv/openaiThis event will be the first time an AI has attempted to play the world champions in an esports game — and that won't be all we show today.",2019-04-13T00:00:00,[],https://external.fcai19-7.fna.fbcdn.net/emg1/v/t13/17739606816183267951?url=https%3A%2F%2Fstatic-cdn.jtvnw.net%2Fjtv_user_pictures%2F7eb0b67b-9041-4abc-b54d-67d7497c5676-profile_image-300x300.png&fb_obo=1&utld=jtvnw.net&stp=c0.5000x0.5000f_dst-jpg_flffffff_p139x139_q75&ccb=13-1&oh=06_AbEojVc3OYAS_smjSck678YpE7KCJb_KOUEX-Alqk6FuXg&oe=64CA9F45&_nc_sid=dbad39,https://www.facebook.com/openai.research/posts/pfbid0bibMM8rSUUrNHFeGFomxvVRaQGESgfUPss9UVeEVooAPyiHmsSxtTg99p8HHceFwl?__cft__[0]=AZVGcu1RPuUFVtN2aFrrMXnvlp86SuTHsEe0KHD0hB6mHicX4FwRQL5qDJ8WlP5XzaGr_BQEUTMDvi2NWDiy0PizXL-oMrkTZAbVJa5nfkqLi7s3gBmyE8HeR10iQhc5-7FivT4ZwGMgM7Z2Yau6E4yPyKGplV55RWnmhyLbb05WPl2ofbrpDIuVDvotrUw2H7H0ELWxqrMLhmrnaq2MFIAZ&__tn__=%2CO%2CP-R,162,0,positive
pfbid02VX59gjNCrHVzuDy5DRvrRcL74vbHTfZz27PToaCXMUrRR2f42yk18avJggUkonrgl,OpenAI,62,204,20,20,0,0,0,0,244,31,"On April 13th, we'll host OpenAI Five Finals, a live event with surprises in store. One highlight — we'll be playing against OG, the Dota 2 world champions. This will be the first time an AI has attempted to play the world champions in an esports game: https://openai.com/blog/openai-five-finals/Games will be streamed on Twitch. If you want to attend in person, request an invite here: https://docs.google.com/.../1FAIpQLSfYQD1CtdY5Qu.../viewform",2019-03-26T00:00:00,[],https://scontent.fcai19-7.fna.fbcdn.net/v/t1.6435-9/55495908_1009468975908381_6470230272779485184_n.jpg?stp=dst-jpg_p526x395&_nc_cat=102&ccb=1-7&_nc_sid=730e14&_nc_ohc=jTPvDu9R4rIAX9dDuq6&_nc_ht=scontent.fcai19-7.fna&oh=00_AfDYNS2t_ElLuxM20VC6n4Oehln4VNtSvpxe43KL8iREfg&oe=64F0A37E https://scontent.fcai19-7.fna.fbcdn.net/v/t1.6435-9/55512158_1009468625908416_4220139761588764672_n.jpg?stp=dst-jpg_s600x600&_nc_cat=107&ccb=1-7&_nc_sid=730e14&_nc_ohc=fc8oA0Y5ifUAX9V7Jwv&_nc_ht=scontent.fcai19-7.fna&oh=00_AfAggSzz8THmuy3tsrAhjJdqu-9KPcKgbNhoKne7Y8C-Jg&oe=64F0AD1A,https://www.facebook.com/openai.research/posts/pfbid02VX59gjNCrHVzuDy5DRvrRcL74vbHTfZz27PToaCXMUrRR2f42yk18avJggUkonrgl?__cft__[0]=AZXqeTrBdE7ObJwc97S-pGhfgnma0-QWJKyK1tLLGyltqNG-YlDaTZsn28aEhHIE67Fzqp-CpiVsegNrpxHKWGB-lfq3zld8AFXCIIqvJZCC3R7r6pCFYAQK88OfjSwwNnNLewtRGoTRzSVSyogbBAHG3UKt9ILh8PGVH_30YFSk7CJgO4N0MphDYJ2eLj0TIom5PZ0diBhJw1HbcmFHBOW3&__tn__=%2CO%2CP-R,306,0,positive
pfbid0zsYs8aU8UZXj5Z6UbXgk8P3XeGXgRar66SNtsqbq1maN5Gqa99s9vNU94AtzzGWCl,OpenAI,3,115,10,0,0,0,0,0,125,11,"Check out the final projects from our first Fellows cohort, including work on generalization, scaling distributed neural networks, and stabilizing energy based models. Our Fellows program is a new 6-month apprenticeship in deep learning: https://blog.openai.com/openai-summer-fellows-2018/",2018-12-19T00:00:00,[],https://scontent.fcai19-7.fna.fbcdn.net/v/t1.6435-9/48427538_952810634907549_4982338599400767488_n.jpg?stp=dst-jpg_p180x540&_nc_cat=101&ccb=1-7&_nc_sid=730e14&_nc_ohc=2BUFCyz1QIgAX_Ulzkw&_nc_ht=scontent.fcai19-7.fna&oh=00_AfDnUuOQLIRxMi5JKP97AncML0hHaixAL77soOwNDib9Wg&oe=64F09614,https://www.facebook.com/openai.research/posts/pfbid0zsYs8aU8UZXj5Z6UbXgk8P3XeGXgRar66SNtsqbq1maN5Gqa99s9vNU94AtzzGWCl?__cft__[0]=AZUWDeFZDASV11P6GHSLTt5zZSmIrOHUzWow6NzAgOH3ckUXFes6dIh356_vhPrKfzGKY8mTRDi24QAWaUjGJsu4zQcYLrMtxPADEQ2rr3-K89e6avbSOrMWm1R9fP5RJ7iV_uBR6fWTXc4HWKcK1bXES12OTngGv0v3pswaLcs4yl6d7zm8vM1wpt2Ui-m0saxNT-6cVgLIJQtslfTJx6_7&__tn__=%2CO%2CP-R,128,0,positive
pfbid0NuRDMyt6vLcrPFZbAZUGSBx3aoDyKRpKJJs9vkwFakAEFNUsCd2yPqEFffkNhfYkl,OpenAI,12,99,0,0,0,0,0,0,99,4,"Announcing the first finding from our ""Science of AI"" effort: a simple statistical metric that lets us predict the parallelizability of neural network training on a wide range of tasks: https://blog.openai.com/science-of-ai/",2018-12-14T00:00:00,[],https://scontent.fcai19-7.fna.fbcdn.net/v/t1.6435-9/48363911_949974048524541_2556369903288320000_n.png?stp=dst-png_s600x600&_nc_cat=106&ccb=1-7&_nc_sid=730e14&_nc_ohc=-zjzJC-fLrUAX9puXIV&_nc_ht=scontent.fcai19-7.fna&oh=00_AfDMbpOa7B3kaSMImvi6d2QSjiejXfKm-qU8gkbzN2UTYQ&oe=64F09018,https://www.facebook.com/openai.research/posts/pfbid0NuRDMyt6vLcrPFZbAZUGSBx3aoDyKRpKJJs9vkwFakAEFNUsCd2yPqEFffkNhfYkl?__cft__[0]=AZUIlHFs3eEqFjo9dFs--rW_ygERqb__psOERzw9Q8Isen7d_H_gGgtdEc-iTcJZXR_Y9BSypNy8Lti8XcCowDZ37VSJCiy2dSrItJ20_U-p98cCQtfbxy0xFliHJT611USS_XDgEZbDV4FtLQ4vEdkPbxaNb-a6vNSLmzxUGxYxuD8aMGFynOIorR2V-5j-dhUaVciX1pmnazBCJM5Vx2Ij&__tn__=%2CO%2CP-R,111,0,positive
pfbid02PVpRUbiwvTuJFtyeBTYWSqncx6hmAkggzhoECaRYa9Nm9rkpRWos5cMZywkksjrkl,OpenAI,11,96,0,0,0,0,0,0,96,3,"We’re releasing CoinRun, an environment generator that provides a metric for an agent’s ability to generalize across new environments - https://blog.openai.com/quantifying-generalization-in.../",2018-12-06T00:00:00,[],https://scontent.fcai19-7.fna.fbcdn.net/v/t1.6435-9/47579280_944711155717497_3659726385787699200_n.png?stp=dst-png_p843x403&_nc_cat=107&ccb=1-7&_nc_sid=730e14&_nc_ohc=3T0cM40hetUAX_5XAuT&_nc_ht=scontent.fcai19-7.fna&oh=00_AfAPoHWl1EHNAyqO0I98YqMkYxKXn5_xmVF7FMUwKG6R-A&oe=64F0B39A,https://www.facebook.com/openai.research/posts/pfbid02PVpRUbiwvTuJFtyeBTYWSqncx6hmAkggzhoECaRYa9Nm9rkpRWos5cMZywkksjrkl?__cft__[0]=AZWrKxyc9efbyvzq1ar5_cnxdKQTNIx2oJl1Gbw9JMo3F2EZKaJAkGSgEbZE-tVxHSdO2paZ0_NeslD1M8yIBXhjIzmRut-RVBjL1-DX0bhcS5i3DV-wl_5Dd8DcL5HmXm3eAOhLdDgQKdPSgCv2_aUWW5MeJDERVVVS2GhEB3cuek7O3uEB4rXai4cowotVUXhX9g8Y8Z7kfFwxCN2Z5qGO&__tn__=%2CO%2CP-R,107,0,positive
pfbid02uybtwBcqSZGFdxsikS69KWZpscXcdqCcVmHMTfaUMod4WoiJuCEytijUc8bZybtel,OpenAI,48,143,23,0,0,0,0,0,166,7,"We’re releasing Spinning Up in Deep RL, an educational resource designed to let anyone learn to become a skilled practitioner in deep reinforcement learning. Spinning Up consists of crystal-clear examples of RL code, educational exercises, documentation, and tutorials.Details: https://blog.openai.com/spinning-up-in-deep-rl/",2018-11-08T00:00:00,[],https://external.fcai19-7.fna.fbcdn.net/emg1/v/t13/11592251509111946445?url=https%3A%2F%2Fblog.openai.com%2Fcontent%2Fimages%2F2018%2F11%2Fspinningup-2.jpg&fb_obo=1&utld=openai.com&stp=c0.5000x0.5000f_dst-jpg_flffffff_p500x261_q75&ccb=13-1&oh=06_AbF1u4eS32Y1f6h_iAxAGi4SvTt6DZYQQ2NwHPFjBzWzBg&oe=64CAFDCB&_nc_sid=dbad39,https://www.facebook.com/openai.research/posts/pfbid02uybtwBcqSZGFdxsikS69KWZpscXcdqCcVmHMTfaUMod4WoiJuCEytijUc8bZybtel?__cft__[0]=AZUBIsZp3_eFISUIMBJkW6V58Ii7Gl2JAujdZ0iWM5TyEstUJO5Ot5m7zeIjpA5_Q1jOU5i_cZLI6bHdxVBSxqwEJXSIOhJNT_jFrEPqhBdIU3fhGcRQsmiXz3sEk9aCvponxr3srrvko_CJ2MQdNxQPQ32AM21Zzu15L3Q_hElxnCisDRIOqpw_khayauA9Tl-nzalL78KLF2n55_IMAhlt&__tn__=%2CO%2CP-R,214,0,positive
pfbid029i5BCToMUTrekVDys7RqbMmd9NqoFquDEdDx6sg1ac8BenyFox7maqXYinymKiUrl,OpenAI,17,120,9,0,0,0,0,0,129,2,"We’ve built an energy-based model that can quickly recognize, generate, and transfer simple concepts after only 5 training demos: https://blog.openai.com/learning-concepts-with-energy.../",2018-11-07T00:00:00,['blob:https://www.facebook.com/07e6f62e-fe7c-4f53-b54e-a7ef26ff9984'],,https://www.facebook.com/openai.research/posts/pfbid029i5BCToMUTrekVDys7RqbMmd9NqoFquDEdDx6sg1ac8BenyFox7maqXYinymKiUrl?__cft__[0]=AZULTIherHiE0lwQNnFb5FQF0EtSrAcTmJfTMfJfvFeTLoVrMzl-9jUff9ipAH--eIk_02_pFWitRMzCqePeE2NdoK9sH-NVkgRtqjFQvMYcz8oXSQlOuq4eoAiJN2obMKFagfifcpQL3beRzTgNYkT12I-4-vJFBAYOjbTj2zmBBKYlRY3IaQJAxzUyvyduapZs7VcNz_oFQ5Igk38U4DTU5C7KfgQ8EACN1QOjRenrkw&__tn__=%2CO%2CP-R,146,0,positive
pfbid0LRhRbGehBjPiVLSoNnYECtQtxgXbwi22FfNpmAig1HRapu8xK35JpFxN2x9gWVZxl,OpenAI,22,99,6,6,0,0,0,0,111,1,Random Network Distillation: A prediction-based method that achieves state-of-the-art performance on Montezuma’s Revenge: https://blog.openai.com/reinforcement-learning-with.../,2018-10-31T00:00:00,[],https://scontent.fcai19-7.fna.fbcdn.net/v/t1.6435-9/45063130_923751781146768_4587169619252346880_n.jpg?stp=dst-jpg_s960x960&_nc_cat=100&ccb=1-7&_nc_sid=730e14&_nc_ohc=PnIJX5W33okAX_DOS6K&_nc_ht=scontent.fcai19-7.fna&oh=00_AfBWSpHLhuWzmABp1jTnkXOl8IA-rOZevvohpQr28A-54Q&oe=64F093C9,https://www.facebook.com/openai.research/posts/pfbid0LRhRbGehBjPiVLSoNnYECtQtxgXbwi22FfNpmAig1HRapu8xK35JpFxN2x9gWVZxl?__cft__[0]=AZXsD4wCGg2O3T9OKoc8lhqS4xJRAoYuxxcJWAFkBqoR1XZ7B2vBauRb5G2Atyl0hgiqVsIzJXDjrT5tK4d54jl465et0246gJKWzbPuixtUMBgb4x5Pw5DAvIur5wzwLAp_noYiTSKcsz6NmbBecLwfnlYhEoUCccew9W6fJJsnMisHkUk72A6CINf9W3noNVxp-bWragInykTv7lbp50jr&__tn__=%2CO%2CP-R,133,0,positive
pfbid02q5mM2T4acKLw76XJ6Agvinze8YohoG4NmiRjiTFBVf6uviWTY1XkX8fA7HAwXdYzl,OpenAI,29,150,11,0,0,0,0,0,161,7,"We’re proposing an AI safety technique called iterated amplification that lets us specify complicated behaviors and goals that are beyond human scale, by demonstrating how to decompose a task into simpler sub-tasks, rather than by providing labeled data or a reward function.Details: https://blog.openai.com/amplifying-ai-training/",2018-10-22T00:00:00,[],https://external.fcai19-7.fna.fbcdn.net/emg1/v/t13/1545026211747430384?url=https%3A%2F%2Fblog.openai.com%2Fcontent%2Fimages%2F2018%2F10%2Famplification_cover-1.jpg&fb_obo=1&utld=openai.com&stp=c0.5000x0.5000f_dst-jpg_flffffff_p500x261_q75&ccb=13-1&oh=06_AbHskFC7M4QWSEiFmquuLfjdZ9NSiS9sNs4Rf1N23CmJfQ&oe=64CAD3E1&_nc_sid=dbad39,https://www.facebook.com/openai.research/posts/pfbid02q5mM2T4acKLw76XJ6Agvinze8YohoG4NmiRjiTFBVf6uviWTY1XkX8fA7HAwXdYzl?__cft__[0]=AZWYvglbK0c8717Rd_CNoNa8UU0gpMDzh8iurXutloqM3zHq-3bd-oOuYIQ-_s4-ji-OrsOvj0tW2qZ6np6vxUrc4kTUhEgvGzqSYJdbJKXxUbFbUeynJEq5qeTEd58oI7ubFgiQLVd3tb2N7cOEKqDoeemPPKvwsL8H6hKSGg6AK_m1lhAsut-yvkXjdvwstwAiw3zYXOk58yjoUbEOaIdQ&__tn__=%2CO%2CP-R,190,0,positive
pfbid0AM6XSPZ7d1hvS96ot8wNWMtb1PBnQms7gTXv3imLB4d7Dd7Ep24nheNfJtFDeDz3l,OpenAI,8,42,4,0,0,0,0,0,46,2,"Apply for our Winter 2019 OpenAI Scholars Program, open to individuals from underrepresented groups in STEM interested in becoming deep learning practitioners https://blog.openai.com/openai-scholars-2019/",2018-10-11T00:00:00,[],https://external.fcai19-7.fna.fbcdn.net/emg1/v/t13/2348593341852676635?url=https%3A%2F%2Fblog.openai.com%2Fcontent%2Fimages%2F2018%2F10%2FIMG_8120-1.jpg&fb_obo=1&utld=openai.com&stp=c0.5000x0.5000f_dst-jpg_flffffff_p500x261_q75&ccb=13-1&oh=06_AbGxHpWtbsUcR1WGAhWI69R6IpUCd9zCRhgGr1VybU3grQ&oe=64CA8F05&_nc_sid=dbad39,https://www.facebook.com/openai.research/posts/pfbid0AM6XSPZ7d1hvS96ot8wNWMtb1PBnQms7gTXv3imLB4d7Dd7Ep24nheNfJtFDeDz3l?__cft__[0]=AZXrtOywz25xsLzhyeg6kAtXRqCv2PLTAAP5jP0qNfucUYbH6eKzWsl65Lun3Aoe2Cb7ExobAMfjIuhbKCRJ4fG9WC7Z7IiXbedGA-Il4YXSB5ma17hQWX6HcH9mtj6n7cu0a4XrKi4qkHUEF7HC7VsxDYVvTBLgS8tywcYcpjL3u7hO41LQ4LN3XofgPToVaLBmLgfBM0QB5WohPph35MOl&__tn__=%2CO%2CP-R,54,0,positive
pfbid02UA1CXzwNiAzqHwHsy2KjGuvK8QEySiaJXzspEzmqfp7XtMvo9XZrVDaBrCPTMr5rl,OpenAI,13,81,7,0,0,0,0,0,88,6,Come join the OpenAI team as a Fellow or Intern in 2019 — applications now open: https://blog.openai.com/openai-fellows-interns-2019/,2018-10-09T00:00:00,[],https://external.fcai19-7.fna.fbcdn.net/emg1/v/t13/1903602800208380603?url=https%3A%2F%2Fblog.openai.com%2Fcontent%2Fimages%2F2018%2F10%2FImage-from-iOS-2.jpg&fb_obo=1&utld=openai.com&stp=c0.5000x0.5000f_dst-jpg_flffffff_p500x261_q75&ccb=13-1&oh=06_AbFBSzhu8UT9nQ68ewoOnTZRO5omJzzNRo3ZNFqTs6N5Hw&oe=64CABB63&_nc_sid=dbad39,https://www.facebook.com/openai.research/posts/pfbid02UA1CXzwNiAzqHwHsy2KjGuvK8QEySiaJXzspEzmqfp7XtMvo9XZrVDaBrCPTMr5rl?__cft__[0]=AZXDMECO9zoMneRvi_yC9ezYXrSM5SuQgkzQkTwCqxVjxVa0aT_zs1tkfLyIZY-z724Ghiho2i_uvT1ZB9uyMGgPGifd4W9s8xtxGrVbnntbBmBciL4Bid6rY28MDRbH6e5JfzKNQ7SU-B8oBUimNo-_3czagVBz_NMjVQ23X28Z6kGFL9dYIgun4S2ZvtH3lnzJiHal5wbvTUzDsAKz7oXP&__tn__=%2CO%2CP-R,101,0,positive
pfbid0ESC3WP5q7aVYfNnx4Pk4wx4TpFd9XcRefxmXJEaX46GuxBqTT2c2MmBS1CpREVUel,OpenAI,8,91,0,0,0,0,0,0,91,3,Details on the final projects of our first class of OpenAI Scholars: https://blog.openai.com/openai-scholars-2018-final-projects/,2018-09-10T00:00:00,[],,https://www.facebook.com/openai.research/posts/pfbid0ESC3WP5q7aVYfNnx4Pk4wx4TpFd9XcRefxmXJEaX46GuxBqTT2c2MmBS1CpREVUel?__cft__[0]=AZW--zMzTAA6oCpxu395J6q0Zwm6ikF410qMfLjWrKC7Seh3u4LO-8DSjC9jA9Epa4BW9VGtLji0P-ykzVwKRTgoqaJpht7Wm7VcL2amJ0QG9v_mGdYAbEwGw-vx8b8I84neVclsoGz-tYvxztC0CE8G6I4qJ3qZ6aQWdIM_P2pXQsYTID6BUsrep9XizC2PAcpU8qt_yEpDztEMCySq258b&__tn__=%2CO%2CP-R,99,0,positive
pfbid0Sv32jfU4M3C7x78fZfavHnkKJagkEJEKmQ9KWGAgYHrycXC5NtMYkC7yEZzgJVCMl,OpenAI,10,71,0,0,0,0,0,0,71,13,OpenAI Five match starting now: https://www.twitch.tv/dota2ti!!https://twitter.com/OpenAI/status/1032347087701082112,2018-08-23T00:00:00,[],https://external.fcai19-7.fna.fbcdn.net/emg1/v/t13/15117684417020091009?url=https%3A%2F%2Fstatic-cdn.jtvnw.net%2Fjtv_user_pictures%2F9b1993ab-8ae9-4136-9af8-6ddb59e87af1-profile_image-300x300.png&fb_obo=1&utld=jtvnw.net&stp=c0.5000x0.5000f_dst-jpg_flffffff_p139x139_q75&ccb=13-1&oh=06_AbGn1lu9nDzL8vGS1Iq7ldspotPUqB_IRxrsukvh6vudDg&oe=64CACB37&_nc_sid=dbad39,https://www.facebook.com/openai.research/posts/pfbid0Sv32jfU4M3C7x78fZfavHnkKJagkEJEKmQ9KWGAgYHrycXC5NtMYkC7yEZzgJVCMl?__cft__[0]=AZUDp0IJ3Cv2iJqTtZD_fNCo8AX7huP4wS93YxXivXNNGyoS1eXM7MZPPOh9eN7nCwgf2ABbvXe0vTPxMUpNSoz9R9pOiA99GVTldOr748oFUucTETLrg5KgHhhbU7HseSWzxaAXO6u681tU41s2fuz-MXJCLWx0L_GkDckxndPTjW6nZ5W83YGFn3kmoRan7EylzYRapHR5sdaMFm45uJ-Y&__tn__=%2CO%2CP-R,81,0,positive
pfbid01RspUZ8Us4AkitJzEfDzwNL7DXvVnC4rDzJH3ZRHJ4PMS3vE1LaqAoEYaLgKBSiPl,OpenAI,8,66,0,5,0,0,0,0,71,2,"Post-game analysis of the OpenAI Five Benchmark games, with Dota analysts William ""Blitz"" Lee and Kyle ""melonzz"" Freedman: https://www.youtube.com/watch?v=80pm62J9kto",2018-08-20T00:00:00,[],https://external.fcai19-7.fna.fbcdn.net/emg1/v/t13/6574230782340504116?url=https%3A%2F%2Fi.ytimg.com%2Fvi%2F80pm62J9kto%2Fmaxresdefault.jpg&fb_obo=1&utld=ytimg.com&stp=c0.17.1280.668a_dst-jpg_flffffff_q75_s500x261&ccb=13-1&oh=06_AbGvnWy2UrXF-QJU_DlP81VuaL4U7y0NatqpCJDNgAx-Hw&oe=64CA8BFA&_nc_sid=ff403b,https://www.facebook.com/openai.research/posts/pfbid01RspUZ8Us4AkitJzEfDzwNL7DXvVnC4rDzJH3ZRHJ4PMS3vE1LaqAoEYaLgKBSiPl?__cft__[0]=AZXxCYR2mGRubKyKwzbUbbnnFfoILjHJgjJ19g-6YnOAyCpwbQg2_Bp4DsoNMNuI8cEPY2DLfQUQIUAd2r5jJHSHLAHEDnSFCrSNORdf7FDPBJGXTUijci97XQXAvDbvxlMCrDU6cvWKJAjdBIQCWJoAJdlseSwpmeVm3FCDKP8YWR_phbHJYgsWVf_U_XNyC_ZyKlVxSrrGp-RoxfdbDRtl&__tn__=%2CO%2CP-R,79,0,positive
pfbid02ETPfFPVBtmSuBTVDxh3kB1u5rzwSBaTuNie3ExDcfn7eoCQdjzHHkk8b3Y7Waw8El,OpenAI,49,252,22,21,0,0,0,0,295,29,"OpenAI Five will be playing against five of the world's top Dota 2 professionals in front of nearly 20,000 audience members at The International on Wednesday, Thursday, and Friday: https://openai.com/five/",2018-08-20T00:00:00,[],https://external.fcai19-7.fna.fbcdn.net/emg1/v/t13/16038220233170292576?url=https%3A%2F%2Fopenai.com%2Fassets%2Fimages%2Ffive%2Fti-e53c9d7b0e.jpg&fb_obo=1&utld=openai.com&stp=c0.5000x0.5000f_dst-jpg_flffffff_p500x261_q75&ccb=13-1&oh=06_AbEDhMUZdqLvmsiG5zQYcyYMov9Ab9stv5Yj_qUvzQsQHQ&oe=64CA978A&_nc_sid=dbad39,https://www.facebook.com/openai.research/posts/pfbid02ETPfFPVBtmSuBTVDxh3kB1u5rzwSBaTuNie3ExDcfn7eoCQdjzHHkk8b3Y7Waw8El?__cft__[0]=AZXqXkjo_U_fS785B4LC0CoxHl6RPm3GdfntdQ4OE_d4IgO-1vDXZHUJRsbIyIp35FEJgSehzL93rQAJlm7UivVsndpliB7SMCow_vqx33dpjQU_5q8mUB3_Lkb4Yony2OOAt4x81yB8t7vZcSGU8dTl9tTNOwzpyNZMb-5g7-v756etHGlhdHq4I-cgknqKQGveW-CDZ5g6rfKEnRlshL-u&__tn__=%2CO%2CP-R,344,0,positive
pfbid0v6vNVDizuuyeXsa2Sr3r4oHoT9WdhMmWdq7nog7o8EtyAfu7i8PFkMizfDrKPTYzl,OpenAI,32,145,12,0,0,0,0,0,157,10,"Results from yesterday's Benchmark versus 99.95th percentile Dota players: https://blog.openai.com/openai-five-benchmark-results/.Great play by the human teams, giving us great insight into OpenAI Five's progress.",2018-08-06T00:00:00,[],https://external.fcai19-7.fna.fbcdn.net/emg1/v/t13/16331596921203992840?url=https%3A%2F%2Fblog.openai.com%2Fcontent%2Fimages%2F2018%2F08%2Fmain.jpg&fb_obo=1&utld=openai.com&stp=c0.143.3000.1566a_dst-jpg_flffffff_q75_s500x261&ccb=13-1&oh=06_AbHjDiJh0PwnbjzkN4CgCJQ7oTM1bTXIYyXTVSka6ihGOA&oe=64CADA4C&_nc_sid=ff403b,https://www.facebook.com/openai.research/posts/pfbid0v6vNVDizuuyeXsa2Sr3r4oHoT9WdhMmWdq7nog7o8EtyAfu7i8PFkMizfDrKPTYzl?__cft__[0]=AZUcx7uikJWnUp_1IQfYWztmaWrlhK8F4VoOOc2T80Em_kxzvBQRcEQiLulSgt9Rg0P3_qCEkQF5bNSlz0skvM5P69_GIStfWQldc_MnalzTrazRs2WUB9mi0bVNujzXzr5uMnS1IoJHXbe3RMWOu0mCZZ5ktxfGeY505nr15KIozAjh6sL_TTYqfM5zC6LBaj0ps1vcKGmIy7vmLYWw7rSc&__tn__=%2CO%2CP-R,189,0,positive
860882887433658,OpenAI,236,395,56,45,0,0,0,0,496,25,"We've trained a human-like robot hand to manipulate physical objects with unprecedented dexterity. Our system, called Dactyl, is trained entirely in simulation and transfers its knowledge to reality, adapting to real-world physics using techniques we've been working on for the past year. This system is trained using the learning algorithm and code created for OpenAI Five: https://blog.openai.com/learning-dexterity/",2018-07-30T00:00:00,['blob:https://www.facebook.com/2f19c507-6839-401f-92c9-5388632ba1ed'],https://scontent.fcai19-7.fna.fbcdn.net/v/t15.5256-10/36168813_860911347430812_6354903773747347456_n.jpg?stp=dst-jpg_p180x540&_nc_cat=107&ccb=1-7&_nc_sid=ad6a45&_nc_ohc=jF4Jn_xqO3cAX9WazvD&_nc_ht=scontent.fcai19-7.fna&oh=00_AfCffKFNYvdKG4VgCsZhQxQLaeoqYiiaiJMxL70JkYvvKA&oe=64CDBBEC,https://www.facebook.com/openai.research/videos/860882887433658/?__cft__[0]=AZW9MsV0r8zmPopRCGQQRLwcKCu9yw9GY9VbNRnHzF41kYFbai528_0RxR0Y8HxwlNtfTQaGMR2iOy-FkZsaiHtJfDx2uvM2jm9FkSTV9l2KYX2oN4Tnj9LR0W1QYrCicOINgBsW7C7XBLYPglbvHvESMOfB27pXmgddITq3KcZV7AoK65s5t6lIBOP2lvQA_DBJ8MK11wrEiojrhSQ63CaU&__tn__=%2CO%2CP-R,732,0,positive
pfbid0Q4Fje1nB5ipyi7oPBWfwzpVM2UMR88VZrqJ25g3RH8uNvspVj8yeK7UqfEpqecaWl,OpenAI,15,122,0,0,0,0,0,0,122,5,"Our first class of OpenAI Scholars is underway, and you can now follow along as this group of experienced software developers becomes machine learning practitioners. We had over 700 applicants for the 8 OpenAI Scholars slots and reviewed each application on a standardized list of criteria for maximal fairness. We hope this group inspires many other developers to make the transition to machine learning too: https://blog.openai.com/openai-scholars-class-2018/",2018-07-25T00:00:00,[],,https://www.facebook.com/openai.research/posts/pfbid0Q4Fje1nB5ipyi7oPBWfwzpVM2UMR88VZrqJ25g3RH8uNvspVj8yeK7UqfEpqecaWl?__cft__[0]=AZV8KTeXBtx5cK28c_2Oz63NqkVygkL_bDVv-EuYZIQkS23cBSLykME4B8K6KSUrrsNgC81aM3bnIFWtgdOxz9zA0___PlBVvxM9KqBy6ac0xrbAwgUMPOLbV7EYi1mB5C1HloHbf1DK2FrB9baBj2EwIc_OD-XzYI0uUpy879w_cRezRwEYFdJNacVAeHC1tj-NwnvR9HFPjg3W9XfywkFB&__tn__=%2CO%2CP-R,137,0,positive
pfbid0LKh4yMnBxrgRvo1PQn7VR4pXc4hxQ31VX3ka1UgMuhHXSBiB62ZjKtQToK27NusUl,OpenAI,42,211,17,15,0,0,0,0,243,24,"We’ve removed the most significant restrictions on OpenAI Five’s gameplay — wards, Roshan, mirror match. We'll play 99.95th-percentile players on August 5th to see if we have any hope of beating top professionals by The International at end of August: https://blog.openai.com/openai-five-benchmark/Request an invite to attend in person: https://docs.google.com/.../1FAIpQLScD7voLwWw0ma.../viewform",2018-07-18T00:00:00,[],https://external.fcai19-7.fna.fbcdn.net/emg1/v/t13/13207241381658221720?url=https%3A%2F%2Fblog.openai.com%2Fcontent%2Fimages%2F2018%2F07%2Fbenchmark-2.jpg&fb_obo=1&utld=openai.com&stp=c17.0.766.400a_dst-jpg_flffffff_q75_s500x261&ccb=13-1&oh=06_AbFnxWZUyabSpacD7Tcc5wYlDWai-193Lx6yDGsMrzX5Ng&oe=64CAAE9A&_nc_sid=ff403b https://external.fcai19-7.fna.fbcdn.net/emg1/v/t13/18298997520789307537?url=https%3A%2F%2Fdev.dota2.com%2Fimages%2Fmisc%2Fvbulletin4_logo.png&fb_obo=1&utld=dota2.com&stp=c0.5000x0.5000f_dst-emg0_p45x45_q75&ccb=13-1&oh=06_AbFY0t-KZBkB9LvxClikx4z_SeVGzcwAfeGfhg_lHepOlg&oe=64CABAC4&_nc_sid=dbad39,https://www.facebook.com/openai.research/posts/pfbid0LKh4yMnBxrgRvo1PQn7VR4pXc4hxQ31VX3ka1UgMuhHXSBiB62ZjKtQToK27NusUl?__cft__[0]=AZUCGC4Qa3qlkLuvV_GhlC4ukIqyM2_QnkBWOZuiY6PNIG5SrXBKsalaxI9aS8KZBsyZJ9acg5-N3Pp81lUtDP5QAHMfQEqKvRsCAmbQLQZcgwOz7f2FlizCuSRm8vJMveH7sd7fF3S_SzmpQuWK7jQQVg6M6Bi1iHcHLbBjv01ZWx3XNFOzEVBFarxM54tXKdi4rqN15lzcJLAWHjvisYiL&__tn__=%2CO%2CP-R,285,0,positive
pfbid02xokCj2dCd4cF8QWvtRAYWASPj4VGMUKiZZ3j4PmL2UJgE3rR7k9WxrAH4s8T6GTkl,OpenAI,35,127,0,8,0,0,0,0,135,11,"Synthesizing realistic high-resolution images with Glow, a new reversible generative model: http://blog.openai.com/glow/",2018-07-09T00:00:00,[],https://external.fcai19-7.fna.fbcdn.net/emg1/v/t13/17504876426706911491?url=https%3A%2F%2Fblog.openai.com%2Fcontent%2Fimages%2F2018%2F07%2Ftransforms2.png&fb_obo=1&utld=openai.com&stp=c0.0.1024.535a_dst-jpg_flffffff_q75_s500x261&ccb=13-1&oh=06_AbEi9lgB3hN9PZZqL4J41_SJyW9gfw_xLj5wUJpsgDW8AQ&oe=64CA90A8&_nc_sid=ff403b,https://www.facebook.com/openai.research/posts/pfbid02xokCj2dCd4cF8QWvtRAYWASPj4VGMUKiZZ3j4PmL2UJgE3rR7k9WxrAH4s8T6GTkl?__cft__[0]=AZUDH_LnICU1U4veYq96LaRnq6uGphXM6pallt90h1BdYxOGVDR7dcvIIiPQVQgV2uj2_TAxDZjW8C3rY23HvkCW-Lef_IbHxhxHE2GWCN5HLx6lHoRXlDv9dkCSNYiGZue7i4PiNcdf47sr-SC2MlNpH6aXnwbV3Y5EyibAzg08y83h7EkgIQEnEqe2DpiBIVWveaFiYaF5IPo0lVzd3FBi&__tn__=%2CO%2CP-R,170,0,positive
835717133283567,OpenAI,19,116,12,10,0,0,0,0,138,5,New high score on Montezuma's Revenge using only a single demonstration: https://blog.openai.com/learning-montezumas-revenge-from.../,2018-07-04T00:00:00,['blob:https://www.facebook.com/06ccdb68-4c1e-4dd4-8b0c-0489dee975f6'],https://scontent.fcai19-7.fna.fbcdn.net/v/t15.5256-10/34648941_835718836616730_2216774174997741568_n.jpg?_nc_cat=109&ccb=1-7&_nc_sid=ad6a45&_nc_ohc=PCvrkH7h-hsAX9s1S2Q&_nc_ht=scontent.fcai19-7.fna&oh=00_AfCNtCRWHRvNYRXIriTYd87FHxTlKb99v-Se2OipAyaWvg&oe=64CEA085,https://www.facebook.com/openai.research/videos/835717133283567/?__cft__[0]=AZV4y6tKcqKH8upkqHLnNG8QSrj4UiWZV6MaXoLgJHuW_oI4X76HWY2DQaJiWIocg-oqdGcyiFvLGnCX3NCBhSUSj8zEfP7Uxqso_PjsIz2uNqBsRsPAp5hbJ97yAuEanH_dua1eD7sT-cHuv54EADokV8RRGEdHuv33UQoy7hyKUyu36DvfcKwlRPaBbx7VLryhU-7WM-_4phFDJERDZSrn&__tn__=%2CO%2CP-R,157,0,positive
826535460868401,OpenAI,292,405,51,44,0,0,0,0,500,70,"Our team of five neural networks, OpenAI Five, has started to defeat amateur human teams at Dota 2. Here we describe our progress to date, how our system works, and how you can follow along as we gear up to play a team of top professionals at the Dota world championships, The International, in August: https://blog.openai.com/openai-five",2018-06-25T00:00:00,['blob:https://www.facebook.com/35c7e00b-258b-4199-b743-aff45bfea05c'],https://scontent.fcai19-7.fna.fbcdn.net/v/t15.5256-10/32205320_826695094185771_1591021440247791616_n.jpg?stp=dst-jpg_p180x540&_nc_cat=106&ccb=1-7&_nc_sid=ad6a45&_nc_ohc=0uuuZyNdqEcAX_z9FYV&_nc_ht=scontent.fcai19-7.fna&oh=00_AfDKH0y5VnyiPWMOhzCwXWqTRU5Wobl3KeGPt68TZQzZDw&oe=64CD3C30,https://www.facebook.com/openai.research/videos/826535460868401/?__cft__[0]=AZX5iPvjgdmt52RuhDcEU8LvfZ0-r5DFgWbw-RAryxFdYezIO8G2kLXDKcJvxn8YQALZBpjLasTMPmVlk3HQ5JntQfJEhHgEMWkJjHrhi57w-GNjvI0Ho8Q24JDech_kvSz2zw_nLSs95uqyW0sNJEvs3wYj4zUyPozrRCr1tj9AQPYGpLUirGwVLDlet7B2FZPoRDR1Va7J0H2MiU0DPdyR&__tn__=%2CO%2CP-R,792,0,positive
pfbid036Vygs8UKwLAciYvkBwuYvYTCkhQRuVuFftqfHfx4DwWPnBHC6hXbYKxPhCZwtRPTl,OpenAI,33,99,0,0,0,0,0,0,99,1,Fine-tuning an unsupervised pretrained transformer to set new state-of-the-art on diverse language tasks: https://blog.openai.com/language-unsupervised/,2018-06-11T00:00:00,[],https://external.fcai19-7.fna.fbcdn.net/emg1/v/t13/9709556438508701750?url=https%3A%2F%2Fblog.openai.com%2Fcontent%2Fimages%2F2018%2F06%2Flanguage-twitter-card.png&fb_obo=1&utld=openai.com&stp=c0.5000x0.5000f_dst-jpg_flffffff_p500x261_q75&ccb=13-1&oh=06_AbHCa4X_lkLIjlBYVFC61VVQVBpbTlpZXswUYYoBit-4oA&oe=64CA9488&_nc_sid=dbad39,https://www.facebook.com/openai.research/posts/pfbid036Vygs8UKwLAciYvkBwuYvYTCkhQRuVuFftqfHfx4DwWPnBHC6hXbYKxPhCZwtRPTl?__cft__[0]=AZUkCNMtUJSL5C8MreIFsD_r0pevfSBlXyNh8-3OLNygDNgZLoA4ObeVeRxw8m430528B8bzc23yihZ1StZ9v3sN-p-mHtbxMynwRMfqhPtZcaOLAk5STMv4EDPFoyjvWCmau90wmVtz6Whmqx7UY3Wo2SOt7KZqnNA1RFSYBLIFj4HyRzDEhDrjJNEqfp9-ii16d3dK3ALWQKSo3c34k6FN&__tn__=%2CO%2CP-R,132,0,positive
pfbid027SUUvFLvnd4yCTE29D6aF4zKazK7NqTYHTLYZWNA6cHtH1Nwe6ZxwrHXGN8Pb5ULl,OpenAI,177,117,9,0,0,0,0,0,126,5,OpenAI Fellows - an apprenticeship program for people that want to transition into AI research: https://blog.openai.com/openai-fellows/,2018-05-30T00:00:00,[],https://external.fcai19-7.fna.fbcdn.net/emg1/v/t13/13205123854688193397?url=https%3A%2F%2Fblog.openai.com%2Fcontent%2Fimages%2F2018%2F05%2Fopenai-fellows-twitter%402x.png&fb_obo=1&utld=openai.com&stp=c0.5000x0.5000f_dst-jpg_flffffff_p500x261_q75&ccb=13-1&oh=06_AbGx98ZOXgsEJxcEbyQaHTV31CFMEePR3GjSkikfcywVKA&oe=64CA98A3&_nc_sid=dbad39,https://www.facebook.com/openai.research/posts/pfbid027SUUvFLvnd4yCTE29D6aF4zKazK7NqTYHTLYZWNA6cHtH1Nwe6ZxwrHXGN8Pb5ULl?__cft__[0]=AZX7sYD55hWAJTWSlI3X1mgWQQyZylobXFRQH2i-hnEn-JJ3mpq2KNNc8ZaTqBYIW7XqM7cUtELo3TJi4rJwvHBdIH7FMoigMIBc5DZbQ4TgqfkkVyR-UsPqi_awNSkwKLfR7P2uVxfTSlTIlZtmj-cKhXB6XLtWrmaIKkv1rGGhqdfVXEeymFvG0YVeNhRmPTD2ERb8Xr2preg_Ynh1PIYm&__tn__=%2CO%2CP-R,303,0,positive
pfbid02DTBYDNDK5BqyeVLmwVjTDAXfmDiyW2t7gysJw8595sdrn6ySPkyjXKG4nuct5Jegl,OpenAI,0,106,0,13,0,0,0,0,119,31,"We've just released an analysis showing that the amount of compute used in the largest AI training runs has been increasing exponentially with a doubling period of 3.5 months since 2012 (net increase of 300,000x): https://blog.openai.com/ai-and-compute/",2018-05-16T00:00:00,[],https://external.fcai19-7.fna.fbcdn.net/emg1/v/t13/4496888800888123355?url=https%3A%2F%2Fblog.openai.com%2Fcontent%2Fimages%2F2018%2F05%2Fcompute_diagram%402x-1.png&fb_obo=1&utld=openai.com&stp=c0.5000x0.5000f_dst-jpg_flffffff_p500x261_q75&ccb=13-1&oh=06_AbED8pPrtpkm9isoVBJJEiE208frY1ETsPPQnCJdoq7CeQ&oe=64CAEB2A&_nc_sid=dbad39,https://www.facebook.com/openai.research/posts/pfbid02DTBYDNDK5BqyeVLmwVjTDAXfmDiyW2t7gysJw8595sdrn6ySPkyjXKG4nuct5Jegl?__cft__[0]=AZWqImA_Qy-SI9O2joVZttF36-jp1hcvlIg87Lv5LWOlhCnKSKaNLiUobz8TcgY8awf1e-3q1PslgSl1J_U1RcZ95M2rbHCCYD93L11jkBFpARTLneaZ0Nx5iQ8t4cJFANuaV2PyOCbwebSGLuzj1ghfpEY2EZMjn2BsUHXCO3vx5o3ETegDszJAAkE5fRfHrknYxcRl-pBD30DrBVroUB8J&__tn__=%2CO%2CP-R,119,0,positive
pfbid02ZrunS5nVfhwjPmdYju4TML5xm3jv6VmJumXaHZiQhr4hCsbdLoiHHkp14GeUkjZEl,OpenAI,17,61,0,0,0,0,0,0,61,4,Evolved Policy Gradients: https://blog.openai.com/evolved-policy-gradients/,2018-04-18T00:00:00,[],https://scontent.fcai19-7.fna.fbcdn.net/v/t45.1600-4/30431342_6096981947792_6716301786824572928_n.png?stp=c44.0.1112.580a_cp0_dst-jpg_q90_s526x296_spS444&_nc_cat=104&ccb=1-7&_nc_sid=67cdda&_nc_ohc=yc0SDm8_Y-sAX-ziWb0&_nc_ht=scontent.fcai19-7.fna&oh=00_AfA3A-_EThSTy-p6Ve3SSuWuuMWGk9JtPe74O94-zt2OpA&oe=64CE1AC6,https://www.facebook.com/openai.research/posts/pfbid02ZrunS5nVfhwjPmdYju4TML5xm3jv6VmJumXaHZiQhr4hCsbdLoiHHkp14GeUkjZEl?__cft__[0]=AZWLPQP8EKloPKkNaJ89liHSL0SvdhUBuO-qDkNVq7kECm0lC6XJ99-p5mcBYL1mwBEkkbgd6l7YgRO2xo8rkaIm_kQr8BqKDSP8-zwHOvIQQXmU2TKIGkxPJHTGH1ax2qQBQEDbnQxIGCe1TCDXENRVapvpttTee5ZiTQogTvaRfpMh9l8Fe07wcinsMICiQmT0A0sVDy6aPQmr53ET4dZ5&__tn__=%2CO%2CP-R,78,0,positive
pfbid0CmsHsdQcHq6DRbqzmV1aNS1XaTC9kbhjcoikV4cKP1gxviK831kMReArZnxoaTu6l,OpenAI,12,86,13,0,0,0,0,0,99,2,OpenAI Charter: https://blog.openai.com/openai-charter/,2018-04-09T00:00:00,[],https://scontent.fcai19-7.fna.fbcdn.net/v/t45.1600-4/29964443_6097077910792_3224460333993164800_n.png?stp=c12.0.144.223a_cp0_dst-jpg_p168x128_q90_spS444&_nc_cat=107&ccb=1-7&_nc_sid=67cdda&_nc_ohc=G8NKXaU2TJwAX83dPPF&_nc_ht=scontent.fcai19-7.fna&oh=00_AfBoqe86emXo4HXkWI3i3E2SK_WL8Jfjak7qpYbAdOhacg&oe=64CDD13A https://external.fcai19-7.fna.fbcdn.net/emg1/v/t13/504300988958196505?url=https%3A%2F%2Fi.ytimg.com%2Fvi%2F8nxWkns6zUE%2Fmaxresdefault.jpg&fb_obo=1&utld=ytimg.com&stp=c0.5000x0.5000f_dst-emg0_p98x98_q75&ccb=13-1&oh=06_AbF9Gvru9sq_h9RFHPI3I8whizlzgTp3rlU87TI-mmwziA&oe=64CADCEA&_nc_sid=dbad39,https://www.facebook.com/openai.research/posts/pfbid0CmsHsdQcHq6DRbqzmV1aNS1XaTC9kbhjcoikV4cKP1gxviK831kMReArZnxoaTu6l?__cft__[0]=AZVFIxtzda6iFabp71Mz24M8uuhNhKySXoO17VJKyxIdrcQqiPYcsvPU9i09De00oem3iexZUmZ4nvmafsjdtAcOAL3ny1CsaeSUpRZlpBy4eU5-bSZaAB5OCXzdkNp4lUWrhqYOYGQ-TtRFYQNhhViPQaeR_-E-cQX0Wf60e0ZIEUh6v6izTQFuwYrRdEAssMtSR1AjVPXpYx8Ei4-PDKAewsdxsGvvXkwa59h25oonaQ&__tn__=%2CO%2CP-R,111,0,positive
pfbid0265Bs17QYnvYWNriEmGUaGHmUe8dQXLornB4fYond7PGhmskGWiWEg7qQQ6aroPB4l,OpenAI,12,64,9,0,0,0,0,0,73,1,A new reinforcement learning competition to aid research into transfer learning. More details: https://blog.openai.com/retro-contest/,2018-04-06T00:00:00,[],https://scontent.fcai19-7.fna.fbcdn.net/v/t45.1600-4/31343536_6097817654007_5500713569747992576_n.jpg?stp=c12.0.144.223a_cp0_dst-jpg_p168x128_q75_spS444&_nc_cat=106&ccb=1-7&_nc_sid=67cdda&_nc_ohc=gFbYBshBPHoAX9cxN1E&_nc_ht=scontent.fcai19-7.fna&oh=00_AfDgCxdOqUTahrhy6kpwhY0EGgKLtyH6sgm9KJ38mvLXhQ&oe=64CDE607,https://www.facebook.com/openai.research/posts/pfbid0265Bs17QYnvYWNriEmGUaGHmUe8dQXLornB4fYond7PGhmskGWiWEg7qQQ6aroPB4l?__cft__[0]=AZWQ7tJcVmbfIH0pbHlGIgxQeZE5C6Y9OsJsGuc-BicFlV4Q6c2kffWb479If_VBfZcuGec5HNJRL1U3tFRcHm3vu2AOTKo6LFUaaryAqaj51w7hOFDl0TuzOOU9VwYtLZvH3eQ4E2JxhzYNjdifmCYhXIFeiVm3J8Dm9rWUDMtxp96gS0k1Rwx16-KqS9MtvaXkBnu2-IymEOAL3wc1oXyxPQTXkNryASryVW65PcfzPQ&__tn__=%2CO%2CP-R,85,0,positive
pfbid0XqwvvFN2pQwFTBeQdeZsrvwhfTNStQnrEu6KNucpNotCTWL8m74mQaKcRXTcy4yNl,OpenAI,36,177,14,0,0,0,0,0,191,16,Now accepting applications for OpenAI Scholars: mentorship and financial support for people from underrepresented groups to get into AI.Details: https://blog.openai.com/openai-scholars/,2018-03-06T00:00:00,[],https://scontent.fcai19-7.fna.fbcdn.net/v/t45.1600-4/30540624_6097078189792_6994388103058161664_n.png?stp=cp0_dst-jpg_q90_s526x296_spS444&_nc_cat=106&ccb=1-7&_nc_sid=67cdda&_nc_ohc=riH4tn09ULoAX-JJe87&_nc_ht=scontent.fcai19-7.fna&oh=00_AfCIzgR1K8ycGR17xy226-pp0aAsJFL0zZo9Mxja3Estfg&oe=64CD73BB,https://www.facebook.com/openai.research/posts/pfbid0XqwvvFN2pQwFTBeQdeZsrvwhfTNStQnrEu6KNucpNotCTWL8m74mQaKcRXTcy4yNl?__cft__[0]=AZUAzGvbbujj_DQvh29hVT-zmc49PjBOW-tzTLdd71QJjOOSYm2QVC9CyOMz9BU9HgrcBVDKLjA2UkZGR62DZG3PQvkoVXgpnZlgj5YqIPhOGIlNQzRe-K-Apgpkv8F9hYFeRYI2EOzzatOYfdETcgSaX1xxGu1F62K74QSsdjQCKrLxzWn0U9vw1yNsDGZWRitb7NjelyOD4S-Oe7H5FeKW&__tn__=%2CO%2CP-R,227,0,positive
767139913474623,OpenAI,58,187,21,0,0,0,0,0,208,7,"We're releasing eight simulated robotics environments and a Baselines implementation of Hindsight Experience Replay, all developed for our research over the past year. We've used these environments to train models which work on physical robots. We're also releasing a set of requests for robotics research. Check out the blog post for more details:  https://blog.openai.com/ingredients-for-robotics-research/",2018-02-26T00:00:00,['blob:https://www.facebook.com/bea3fa0d-e012-4c9a-ab34-9ebdc6f5ce82'],https://scontent.fcai19-7.fna.fbcdn.net/v/t15.5256-10/27852960_767148630140418_6344893248657424384_n.jpg?stp=dst-jpg_p180x540&_nc_cat=100&ccb=1-7&_nc_sid=ad6a45&_nc_ohc=cVvrmfBT1FQAX8jMsqg&_nc_ht=scontent.fcai19-7.fna&oh=00_AfDjDbwuvjdNEN7SPpSMgZrEyg_cCD6-Qx_ZPvpiLr7TKA&oe=64CDEC4F,https://www.facebook.com/openai.research/videos/767139913474623/?__cft__[0]=AZWagjqpgudJAOiQrNAIgnqGWUOje5AvF_epMBZj4r3-qwhUH5Jh1QPBHPLZanM8wETCWy82d6y1VnNTn7L8UFCKuE-vLv5bsln1eUdMk3rnDjzCLg1KP6xvO0UJJEI05Y63QvUHprQYQ3bLi5VtCpv5Gi88PKC-ZvgH5Rj3xGagV6q0J7vmkFnXoFd9YyMZS4f2KtBaNxIsVos5NOAIZRWE&__tn__=%2CO%2CP-R,266,0,positive
pfbid01Ba3L1G1FPxQdbTA8qYTYBAGFYnjnUP6BBnMR1akpmYceDLF7csbGyJkUfZ5HYsxl,OpenAI,18,97,6,0,0,0,0,0,103,2,"A system for automatic disambiguation of which object is meant by a word in a sentence (so, whether a particular sentence refers to Jaguar the car or jaguar the animal): https://blog.openai.com/discovering-types-for-entity.../",2018-02-07T00:00:00,[],https://scontent.fcai19-7.fna.fbcdn.net/v/t45.1600-4/31263353_6097899758192_8831983010178924544_n.png?stp=c0.66.519.271a_cp0_dst-jpg_p403x403_q90_spS444&_nc_cat=101&ccb=1-7&_nc_sid=67cdda&_nc_ohc=v6C590ptHUoAX9EMMoE&_nc_ht=scontent.fcai19-7.fna&oh=00_AfA1uMyzkRYntzVpLdXJXsL6MZ38fffLztzp6gvpyovmzQ&oe=64CE6AEA,https://www.facebook.com/openai.research/posts/pfbid01Ba3L1G1FPxQdbTA8qYTYBAGFYnjnUP6BBnMR1akpmYceDLF7csbGyJkUfZ5HYsxl?__cft__[0]=AZVrWgTg7vzBcvTF5kxsUzeoudyjMq4xU7YJNWQFF_3wGdJ4-FSr2WmXUFHSSEk2OovpX40rcSybTjgf4GL3NXPzRsRdC77RflBX0rXf-WECtqEDwT1d3rV1TlR4IwCfEd9Dz1RKQ7XzB1S7huI1BMPThcTriPRy1NvE9Sfj7vAe1R88L0_w1lWC-5azahb0WP32i_bOd7uF6rKAKOTOOQI7&__tn__=%2CO%2CP-R,121,0,positive
pfbid02xyFFbReVYpm1uvMyGs5NhKC1xKM8Wb63szFpZzMsuHtRDJsHaVo1EcFhakdc6Atzl,OpenAI,22,125,9,0,0,0,0,0,134,7,"Announcing Requests for Research 2.0, a new set of unsolved problems which have come up in the course of our research at OpenAI: https://blog.openai.com/requests-for-research-2/. Intended for newcomers and practitioners alike!",2018-01-31T00:00:00,[],https://scontent.fcai19-7.fna.fbcdn.net/v/t45.1600-4/30553868_6097077910992_1278854872053055488_n.png?stp=c0.126.526.274a_cp0_dst-jpg_p526x296_q90_spS444&_nc_cat=106&ccb=1-7&_nc_sid=67cdda&_nc_ohc=eMvLt9_AC4cAX9U3loy&_nc_ht=scontent.fcai19-7.fna&oh=00_AfDpszsTaZMODyCfG_cdIZM2Qwsizu7RhhQwacPgyk2q5g&oe=64CD5024,https://www.facebook.com/openai.research/posts/pfbid02xyFFbReVYpm1uvMyGs5NhKC1xKM8Wb63szFpZzMsuHtRDJsHaVo1EcFhakdc6Atzl?__cft__[0]=AZV0c9frQSLvmcJ3o2nVkTVOcL8rh_2XP72jiZuPmkiE3k9fw1CXBWSUqrFZA7fnzLUQ879Pp2_NdrlRtAffWns-_fS4Np6rDp2I9Wbz6JVtahxIRP7BDMX--gP9AtaE6b5NOh6IdqFYKFLr93fn8sMCtkZHzxltsC_aFqUfXAnZ_8rY-CF2hjPxUtbYEjUmcZ-PX5vdu9a2HBRH3wCURcoi&__tn__=%2CO%2CP-R,156,0,positive
pfbid02oEdWVdffssDgaM7FfZFD2W1jMz5FnTkSyDiqXPyWYHMJHc7Fwjkp82v8ZZnsbbjjl,OpenAI,5,62,0,0,0,0,0,0,62,4,"We’ve been running Kubernetes for deep learning research for over two years. While our largest-scale workloads manage bare cloud VMs directly, Kubernetes provides a fast iteration cycle, reasonable scalability, and a lack of boilerplate which makes it ideal for most of our experiments. We now operate several Kubernetes clusters (some in the cloud and some on physical hardware), the largest of which we’ve pushed to over 2,500 nodes. This cluster runs in Azure on a combination of D15v2 and NC24 VMs.Details: https://blog.openai.com/scaling-kubernetes-to-2500-nodes/",2018-01-18T00:00:00,[],https://scontent.fcai19-7.fna.fbcdn.net/v/t45.1600-4/30277230_6097255841792_7873350935391502336_n.png?stp=c130.0.1443.753a_cp0_dst-jpg_q90_s526x296_spS444&_nc_cat=106&ccb=1-7&_nc_sid=67cdda&_nc_ohc=q-QUPe66VIYAX-M56Vm&_nc_ht=scontent.fcai19-7.fna&oh=00_AfCKfeQo6wQQfO-kPuaiLHMU4nwpTQ1yMMI-6EsbiFnEHA&oe=64CDC725,https://www.facebook.com/openai.research/posts/pfbid02oEdWVdffssDgaM7FfZFD2W1jMz5FnTkSyDiqXPyWYHMJHc7Fwjkp82v8ZZnsbbjjl?__cft__[0]=AZXd76MaIhAa2ESaEqKRMytC0NldjxcoQDW1fwle2z1ocd-Nkgx0FcGGNcAgiKHewq-POr08KgI1tcG4QNWQFIRT7_bsShk_mGNrW8DXB4eyZCzrwLMA1Sn1bgbfrajm_WM-xknix9ft1UhkpvmKAvNLCx93ZgiFtpevhpHRVfiiUGopO9fbwQr11UuZfoAkbevnXTOtxT4vUsOrg2SC0sSt&__tn__=%2CO%2CP-R,67,0,positive
711728979015717,OpenAI,31,226,0,0,0,0,0,0,226,21,"We’ve developed a hierarchical reinforcement learning algorithm that learns high-level actions useful for solving a range of tasks, allowing fast solving of tasks requiring thousands of timesteps. Our algorithm, when applied to a set of navigation problems, discovers a set of high-level actions for walking and crawling in different directions, which enables the agent to master new navigation tasks quickly.Details: https://blog.openai.com/learning-a-hierarchy/Code: https://github.com/openai/mlsh",2017-10-26T00:00:00,['blob:https://www.facebook.com/a73dc9e8-9b63-45dc-b67a-117e129c5135'],https://scontent.fcai19-7.fna.fbcdn.net/v/t15.5256-10/22743322_711729469015668_2889745586926387200_n.jpg?stp=dst-jpg_p480x480&_nc_cat=103&ccb=1-7&_nc_sid=ad6a45&_nc_ohc=toWsetxSalMAX8gj2Zs&_nc_ht=scontent.fcai19-7.fna&oh=00_AfD1JBgG4wIfCOlGu3O1mG915goEXCUx8C2ntDA3xaBcJQ&oe=64CD2F11 https://external.fcai19-7.fna.fbcdn.net/emg1/v/t13/908506521983058228?url=https%3A%2F%2Fmedia.springernature.com%2Fm685%2Fspringer-static%2Fimage%2Fart%253A10.1038%252Fs41598-017-15795-7%2FMediaObjects%2F41598_2017_15795_Fig1_HTML.jpg&fb_obo=1&utld=springernature.com&stp=c0.5000x0.5000f_dst-emg0_p98x98_q75&ccb=13-1&oh=06_AbHuT8pFZJrKnqlLLpwiIZXIQJwVN0aA5BacXu8Ox-ZcCA&oe=64CAEF4E&_nc_sid=dbad39,https://www.facebook.com/openai.research/videos/711728979015717/?__cft__[0]=AZVlWruCSnTL-rRNhOwbZ3nORRXii-Wci-ie0ePf3kjFd-B6-_yWHHi_xVk2Hr65r_4vkYrbSJJGvpxaq3jybmdm7jYbiPK9_8QZkooFqVI_QvWp7bsPX5Ls7WKYl_oQ5xR8ybmKe4mSZy59m6wYWVbR1UwAosk8yEdMQ2iHRMOtmsoyhYHKadBwMx6V1XjT0TjQLGK4wIWGKOLlBHT1SKrZ&__tn__=%2CO%2CP-R,257,0,positive
708882182633730,OpenAI,26,168,21,0,0,0,0,0,189,13,"Our latest robotics techniques allow robot controllers, trained entirely in simulation and deployed on physical robots, to react to unplanned changes in the environment as they solve simple tasks. That is, we’ve used these techniques to build closed-loop systems rather than open-loop ones as before. The simulator need not match the real-world in appearance or dynamics; instead, we randomize relevant aspects of the environment, from friction to action delays to sensor noise. Our new results provide more evidence that general-purpose robots can be built by training entirely in simulation, followed by a small amount of self-calibration in the real world: https://blog.openai.com/.../3027275a-fd2c-4681-9433.../",2017-10-19T00:00:00,['blob:https://www.facebook.com/0e53e4a2-2d0d-4eab-a16c-f1c53bf1f191'],https://scontent.fcai19-7.fna.fbcdn.net/v/t15.5256-10/22691390_708883465966935_7818220687935406080_n.jpg?_nc_cat=111&ccb=1-7&_nc_sid=ad6a45&_nc_ohc=OO5RjS8QQYoAX81sWn_&_nc_ht=scontent.fcai19-7.fna&oh=00_AfA0MkOzBPLGFkq6PetrtQf8RXMFJyRSKnXZu2VADlRV3A&oe=64CE4958,https://www.facebook.com/openai.research/videos/708882182633730/?__cft__[0]=AZUCVaxBsa5zEwuebNn2Z47LPsDT0LqvB99p9V-aerr5MT-VI78vjfKTf1ifeUnsxCUbCwonQlHXcl5It-323jgd11rX0QfiT1C8YAHuqriMMrwR8MMURr90r19u_-YsLZYV1Ttrfl24-eT4Z8GznQyXTM7aBSY_oZrkswPmrCtF7grRWLpY3Wje0N_sKiZLIUL0Q4nJK6uucprXBsu8mPQZ&__tn__=%2CO%2CP-R,215,0,positive
pfbid0DcaN3FfCBU4HC5ByNGASmoAj7x3ij7RdtX6wA9aB4WTgMYdPEFHpAnoyUqmshoDql,OpenAI,10,119,10,8,0,0,0,0,137,6,"Beating stronger opponents by adapting to their strategies, via meta-learning: https://blog.openai.com/meta-learning-for-wrestling/",2017-10-11T00:00:00,[],https://scontent.fcai19-7.fna.fbcdn.net/v/t45.1600-4/30788127_6097025444607_1144406186481680384_n.png?stp=c0.11.526.274a_cp0_dst-jpg_p526x296_q90_spS444&_nc_cat=111&ccb=1-7&_nc_sid=67cdda&_nc_ohc=qKglbsbyQrcAX8dlO4E&_nc_ht=scontent.fcai19-7.fna&oh=00_AfBD79ybFCobNkVhqxHc0ZghWW4Jv9X4d5nCjNrNE_mfjg&oe=64CEB1FB,https://www.facebook.com/openai.research/posts/pfbid0DcaN3FfCBU4HC5ByNGASmoAj7x3ij7RdtX6wA9aB4WTgMYdPEFHpAnoyUqmshoDql?__cft__[0]=AZUUw_yiptIXcuK_0QunmMeLRaSQwUsIDyu_hK51eNetZutjeuAaROKXhXcczvKtz2Gs_a2pZvw9SISGVWuPqMM0wGiJ5VuuyM6Q7MA0IzlnF5BxkZ_qcr5y9WgxpF4eZWMo94Ol3wvSPvY2sRvDyDhOXR_vdSFgoYj69JzNUCYJVp0BaA_CFKwZEIWzI9QcNzxXZDk-zQZlA6q4J26Dek2Y&__tn__=%2CO%2CP-R,147,0,positive
705623112959637,OpenAI,109,366,31,43,0,0,0,0,440,28,"We’ve found that self-play allows simulated AIs to discover physical skills like tackling, ducking, faking, kicking, catching, and diving for the ball, without explicitly designing an environment with these skills in mind. Learn more: https://blog.openai.com/competitive-self-play/",2017-10-11T00:00:00,['blob:https://www.facebook.com/056c2330-739e-48d6-865d-beb8b986db90'],https://scontent.fcai19-7.fna.fbcdn.net/v/t15.5256-10/22469326_705636856291596_1696687037412802560_n.jpg?stp=dst-jpg_p180x540&_nc_cat=107&ccb=1-7&_nc_sid=ad6a45&_nc_ohc=IPWB0PzEt30AX_B-hvE&_nc_ht=scontent.fcai19-7.fna&oh=00_AfCBHqTYEjl2jJmt7N2aI4znWVyMOkSFeRBZtH0v1xNPMQ&oe=64CDCF2D,https://www.facebook.com/openai.research/videos/705623112959637/?__cft__[0]=AZVUQ35jibtyyAIWuye0wCErdGlanXb7meHGTB4TuyGeU3tDeBvEr9kll8MIfvAcdgZKRi2LWSNj0ooiEJOMRiUrfjJaKVbCOM3egzt1K9IkHNHnDT4fMFzDSGLuTAUfOjo1FGNAKJaoY_jjTIiRpT7GYrtUIf2nPwNm60jzw6ahqlRV7S9xRJiu95ULxsoD6Q8m3er_5h8d76CIWnnaZ8aR&__tn__=%2CO%2CP-R,549,0,positive
681674202021195,OpenAI,354,676,68,77,0,0,0,0,821,136,"We’ve created a bot which beats the world’s top professionals at 1v1 matches of Dota 2 under standard tournament rules. The bot learned the game from scratch by self-play, and does not use imitation learning or tree search. This is a step towards building AI systems that can accomplish specified goals in complicated situations involving real humans. Learn more: https://blog.openai.com/dota-2",2017-08-12T00:00:00,['blob:https://www.facebook.com/b8eadcb7-b261-4114-911e-7f56611fbd19'],https://scontent.fcai19-7.fna.fbcdn.net/v/t15.5256-10/20820622_681700032018612_7244162381423575040_n.jpg?stp=dst-jpg_p180x540&_nc_cat=107&ccb=1-7&_nc_sid=ad6a45&_nc_ohc=3Jr2nKFteJUAX8LnCeg&_nc_ht=scontent.fcai19-7.fna&oh=00_AfAKbjqQBPzUR3ocSJ4iHPUmLgDQntguo-k9I4nIHZfq2Q&oe=64CECC01,https://www.facebook.com/openai.research/videos/681674202021195/?__cft__[0]=AZUk2Yza-mQYjNwRT3yNY0q0gNZHkhqczi972EAPdnF_mPyJjiXMYfvW_vdE6rMWF7DbCaV_tFfxZjDB7tkHJs-ukLGViyG159pe3SmLV4xTy-krA0EHYVboEI0VXKhkKo1QFRXf5Na61jmot-H83S4jw8BWPYUoaSHgsP-zEQMugT6g9yy9LMCDBZsHrhnwC-uhKurFkmilflkBKYuoVSP1&__tn__=%2CO%2CP-R,1175,0,positive
678477012340914,OpenAI,25,109,11,0,0,0,0,0,120,14,"Releasing RL-Teacher - an open-source implementation of our interface to train AIs via occasional human feedback rather than hand-crafted reward functions. The underlying technique was developed as a step towards safe AI systems, but also applies to reinforcement learning problems with rewards that are hard to specify.Details: https://blog.openai.com/gathering_human_feedback/",2017-08-03T00:00:00,['blob:https://www.facebook.com/c0ad2237-9f85-4c87-be4e-d5f652b8631f'],https://scontent.fcai19-7.fna.fbcdn.net/v/t15.5256-10/20642643_678477385674210_6678732071503921152_n.jpg?_nc_cat=103&ccb=1-7&_nc_sid=ad6a45&_nc_ohc=fPmLLfaJtFQAX_mH1I1&_nc_ht=scontent.fcai19-7.fna&oh=00_AfAUKzEfE6hc7COz4Ioyiei0_rO_5vzJp4ui-zHrgcZ92g&oe=64CE12F7,https://www.facebook.com/openai.research/videos/678477012340914/?__cft__[0]=AZVEH60TWzgTauMhUDm3RPdQmqBv1T6JRz7Vv2HKqMTqZOktpKxUg943c4geCkab7_O7R1VDbvzZJJ8yHoPFcuNKsiS7oeZKDgHSRnVJbyB3Kd3Rn6TtQZO6R5PXGwjqeiOTRSAoP0NHy8FwYaROoo6ywriUGEA3HSGHOp8frwxzuqLhJh2cN33nHw7vBGcSILLboYuoQPe9kSUjBnW0FNC9&__tn__=%2CO%2CP-R,145,0,positive
671188546403094,OpenAI,61,187,0,18,0,0,0,0,205,19,"We’ve created images that reliably fool neural network classifiers when viewed from varied scales and perspectives. This challenges a claim from last week that self-driving cars would be hard to trick maliciously since they capture images from multiple scales, angles, perspectives, and the like.Details: https://blog.openai.com/robust-adversarial-inputs/",2017-07-17T00:00:00,['blob:https://www.facebook.com/87eb7af0-0178-4f8c-b685-d687a9f578f0'],https://scontent.fcai19-7.fna.fbcdn.net/v/t15.5256-10/20172697_671188753069740_8671296309266743296_n.jpg?_nc_cat=110&ccb=1-7&_nc_sid=ad6a45&_nc_ohc=L_q0EHm-DZ0AX9ftZRl&_nc_ht=scontent.fcai19-7.fna&oh=00_AfBgg4-0X2FjtsbzqdDzdhiK6vZZPaCitGiGWBQUzFjftg&oe=64CDBAF3,https://www.facebook.com/openai.research/videos/671188546403094/?__cft__[0]=AZWi1quTxYtcOWgjZXX8X46E7nBtsP0ASBCK84IVZLdHR0OrS_Zp5XgIglVD7Ao-Lym6sp1laG5CE623ILNfYBARFOpaVxksEfCvj3IFvI2308z1MlhVbm2c7u57g-oHymajMyAzzNEwUfZwo0CoH05TxNAkDd3wm1jGDUGaeMHok8OVnkaZHLhPACcWcKlDb5Fo1T1f5Sk4sqQShnCjgP1i&__tn__=%2CO%2CP-R,266,0,positive
pfbid0zNPcVEKCm3EYkaiZMThTJr5PaLoSPWg1xzo7QBzmK8rw4fCP8RaPhQJUeRdpuwM3l,OpenAI,9,163,0,0,0,0,0,0,163,7,"We’re open-sourcing a high-performance Python library for robotic simulation using the MuJoCo engine, developed over our past year of robotics research.Details: https://blog.openai.com/faster-robot-simulation-in-python/",2017-06-28T00:00:00,[],,https://www.facebook.com/openai.research/posts/pfbid0zNPcVEKCm3EYkaiZMThTJr5PaLoSPWg1xzo7QBzmK8rw4fCP8RaPhQJUeRdpuwM3l?__cft__[0]=AZXWZPk8zAhCkTLpuM0fYFbog3aOzGRvZ83h2OAtBw_-mmCsmBPwmaqkIQ9R4RvGuOrdAgChM1cUdzuirBgOaiu9xUS8p2Th9XfmcEArzH5hc2iGenaZz7OgKBDc4c4P4bc4NwftmI4gcqcWsbnJL4_HtVbi501uxZqps1lGtxw4cQ7DJu6gCyw4muuURDJSuDkiK7TfI1SWCle4dwuwos1b&__tn__=%2CO%2CP-R,172,0,positive
654736041381678,OpenAI,25,106,10,0,0,0,0,0,116,7,"One step towards building safe AI systems is to remove the need for humans to write goal functions, since using a simple proxy for a complex goal, or getting the complex goal a bit wrong, can lead to undesirable and even dangerous behavior. In collaboration with DeepMind’s safety team, we’ve developed an algorithm which can infer what humans want by being told which of two proposed behaviors is better.Details: https://blog.openai.com/deep-reinforcement-learning-from.../",2017-06-13T00:00:00,[],https://scontent.fcai19-7.fna.fbcdn.net/v/t45.1600-4/19945342_6075501505767_9195105937956798464_n.png?stp=cp0_dst-jpg_q90_s526x296_spS444&_nc_cat=102&ccb=1-7&_nc_sid=67cdda&_nc_ohc=mMva7a6hTh8AX_YUnHh&_nc_ht=scontent.fcai19-7.fna&oh=00_AfDIyOz6Cak4t7LSyBXbbhRL88z56stYCqwPuVyC-lD1SA&oe=64CDAFC6,https://www.facebook.com/openai.research/posts/654736041381678?__cft__[0]=AZVAEL0T5oj1rrAbXXIK_ez_-Kgv3LUUU_kza45AgZJWaAzDySmAPBzdhEntPO_YCrMzsqFUKim7HN9ZSM0vtiHxVV70bcqKtSUVdT5wLnYjXwNmIIUiJz6QwszXYlyYvam-P35e8hmJP4NcTjyaxLJBb1lIeKUMlLivWencfFwYr-lyZtVBWtEyVFYaAe18ot2GwwqQfl8WMiYK8h5tP52v&__tn__=%2CO%2CP-R,141,0,positive
652694368252512,OpenAI,13,94,8,0,0,0,0,0,102,2,"Multiagent environments where agents compete for resources are stepping stones on the path to AGI. Multiagent environments have two useful properties: first, there is a natural curriculum — the difficulty of the environment is determined by the skill of your competitors (and if you’re competing against clones of yourself, the environment exactly matches your skill level). Second, a multiagent environment has no stable equilibrium: no matter how smart an agent is, there’s always pressure to get smarter. These environments have a very different feel from traditional environments, and it’ll take a lot more research before we become good at them.Details: https://blog.openai.com/learning-to-cooperate-compete.../",2017-06-08T00:00:00,[],https://scontent.fcai19-7.fna.fbcdn.net/v/t45.1600-4/19677982_6075501506367_8887743733064269824_n.png?stp=c0.113.480.251a_cp0_dst-jpg_q90_spS444&_nc_cat=111&ccb=1-7&_nc_sid=67cdda&_nc_ohc=vbCscIGKW3oAX99N3eY&_nc_ht=scontent.fcai19-7.fna&oh=00_AfCyINlFK-HzPMClpA8lbDDV6EUnnI1xIv_LVIsdZzkiQA&oe=64CE85A7,https://www.facebook.com/openai.research/posts/652694368252512?__cft__[0]=AZU0flAbzj501r_ghtgtYTCWgJTWCzC-YaDhsq9sLBdAC8SnawJDIIky-d-ee3rk2fkGgHKIvz5IneL6iPjfFNC1aXJBQSzOCSG09lZCdiHI2-9z0O1kF3qnLaQSPU5MFU3wOq7lUF_-ZmkifI1LPzHhPf4t9FFi-2S4dTvHx7cak3TlgLbB52vDuZg-tIzw7Q6Xk_O3rDgQuQAZFIMXhbx_&__tn__=%2CO%2CP-R,115,0,positive
646410832214199,OpenAI,28,126,11,0,0,0,0,0,137,4,"We’re open-sourcing OpenAI Baselines, our internal effort to reproduce reinforcement learning algorithms with performance on par with published results. We’ll release the algorithms over upcoming months; today’s release includes DQN and three of its variants.Details: https://blog.openai.com/openai-baselines-dqn/",2017-05-24T00:00:00,[],https://scontent.fcai19-7.fna.fbcdn.net/v/t45.1600-4/19886465_6075803211567_2367123533873545216_n.jpg?stp=c12.0.144.223a_cp0_dst-jpg_p168x128_q75_spS444&_nc_cat=111&ccb=1-7&_nc_sid=67cdda&_nc_ohc=rOh_0hGhBVcAX-_D_sZ&_nc_ht=scontent.fcai19-7.fna&oh=00_AfDxZpENwbllW9ZUcxY3tnUqz6NubGObddID3mu7cUd4hg&oe=64CE6955,https://www.facebook.com/openai.research/posts/646410832214199?__cft__[0]=AZWzncnkrV-sfxNl_gjyGzR30ndWb15JuKI-hPwc7YhX4j6drfGQ2hqjtVXWZ-IlWJYRg4taPBxStH-8Cx8wgg1X0Gl3eOdcaRmjAVsoIStWABzMeCBaK-ksDd0KxTWEXNonTGdJKGWvx0AsnUuTDtF7pnfKWdGKk5C7yd_bXPWnPePTYQh7i6hIjvO0c4osaRSJWu9MkVCic3X9XT3WEa3hkqcMcqOubGAMTVlskRkj7g&__tn__=%2CO%2CP-R,165,0,positive
642411485947467,OpenAI,219,263,21,31,0,0,0,0,315,19,"We’ve created a robotics system, trained entirely in simulation and deployed on a physical robot, which can learn a new task after seeing a human do it in VR once.Details: https://blog.openai.com/robots-that-learn/",2017-05-16T00:00:00,['blob:https://www.facebook.com/0b50aaa6-008b-4412-9fec-74ef953ddac4'],https://scontent.fcai19-7.fna.fbcdn.net/v/t15.5256-10/18555451_642415089280440_9104049079343644672_n.jpg?stp=dst-jpg_p180x540&_nc_cat=110&ccb=1-7&_nc_sid=ad6a45&_nc_ohc=taU7FAZIA6MAX8H_FL5&_nc_ht=scontent.fcai19-7.fna&oh=00_AfAfBMqgQVeWdnlrKESs3i5xJ7zOH85QkwE7bTmgMs9b5g&oe=64CF17B9,https://www.facebook.com/openai.research/videos/642411485947467/?__cft__[0]=AZWAFiiVbG6tuWggWh1y5P-CMBCvoDBF2rP4SfO0ygkNJI_QrnXg1nrb7DiHL2uF1mpCjSImCrCOHuuGvRLUgYXBpMOQ_WBOa_1n--nU7m688_HFFwewsr-UBzzJuKqKmhcFcUBgFXv0p7QS4DABnzISuaIOR_tzq8dl0glbPuy5bt5s-BAtt-dikSOJveSsW3Hhy1WsFAxUzIoi-WdrLQ7X&__tn__=%2CO%2CP-R,534,0,positive
434615506727067,OpenAI,7,44,8,0,0,0,0,0,52,11,Introducing OpenAIhttps://openai.com/blog/introducing-openai/,2015-12-12T00:00:00,[],https://scontent.fcai19-7.fna.fbcdn.net/v/t45.1600-4/17508671_6073104724807_906883710350000128_n.png?stp=c30.0.1340.700a_cp0_dst-jpg_q90_s526x296_spS444&_nc_cat=109&ccb=1-7&_nc_sid=67cdda&_nc_ohc=NSHOoN-s27UAX94M_uL&_nc_ht=scontent.fcai19-7.fna&oh=00_AfBOOgS_egv4-YQ_L6NFRt5w0CocIzREJL3d2PCE7CdO_A&oe=64CD30A3,https://www.facebook.com/openai.research/posts/434615506727067?__cft__[0]=AZX2BS8XVI4NH77_80ombRjbyTyVzEucYUetMEH3km-iJPQDml1qpgVtdL0mupER_drvbRPCDCDCGxLq8KkBFCIYIkzL4W8-cJCUKn_bwI0kTS4CGKY1qZiSQ2fgV48jaDtl4218rn5D4mxTsEs3UY02t-AQDpEdxIMteuRxEbO20JShABNEbtrj8nYwz2zUzehN5hKVgzGNvGsL_msnWxmE&__tn__=%2CO%2CP-R,59,0,positive
