id,name,shares,likes,loves,wow,cares,sad,angry,haha,reactions_count,comments,Summary,posted_on,Video_URL,Image_URL,URL,Positive_Reactions,Negative_Reactions,Sentiment Analysis,Rating
pfbid02XgnKRwVv2zYzqLZCZoASYx86FsJryPyujqnYVwh3ExX3U5sojH7z6zQBQ6juxi7El,NVIDIA AI,0,2,0,0,0,0,0,0,2,2," Training neural networks to build other deep networks?  Technical walkthrough: Our latest research provides insights for advancing neural network design, and highlights meta-network architecture & optimization techniques for #deeplearning. #HPC #datascience.Read more: https://nvda.ws/45yAJSJ",2023-08-18T01:37:54.424853,[],https://external.fcai19-7.fna.fbcdn.net/emg1/v/t13/14431281525084588784?url=https%3A%2F%2Fdeveloper-blogs.nvidia.com%2Fwp-content%2Fuploads%2F2023%2F07%2Fnetwork-graphic-1.jpg&fb_obo=1&utld=nvidia.com&stp=c0.5000x0.5000f_dst-jpg_flffffff_p500x261_q75&ccb=13-1&oh=06_AbEDPAwW_BWTY0X16zWlofBwV65KEATkaQQwiLZ4q8EQww&oe=64E0222C&_nc_sid=ca20c4,https://www.facebook.com/NVIDIAAI/posts/pfbid02XgnKRwVv2zYzqLZCZoASYx86FsJryPyujqnYVwh3ExX3U5sojH7z6zQBQ6juxi7El?__cft__[0]=AZVfrYSXVdcPjPpAaPBMzMeJAl9y4pE9mpFgw2g5WDDLwlcrJNMGs1riFsXgNWJtxrbRecTnhWzAWrVnzZEIx-Bl1DceT-jR4GE-clWq70PusZyRcn19BTV7cmZahU0xZseklIRSJNlCYZgGNh6XUanrtMVYdAqx76zN_0TiKgkkAl2g8XqZMohtvY7h0KjLkCaGJ1w93oao04Npt8NSEW7u&__tn__=%2CO%2CP-R,2,0,positive,2
pfbid0whebBzHftkKuhBpG3vgifpKmJsfexahSAmkqjEd4y2TizgTkjSDb4iGPhsRwcySKl,NVIDIA AI,0,4,0,0,0,0,0,0,4,0,"Join NVIDIA's Anand Muralidaran, Global Business Development for Retail, CPG & QSR, and #AI experts as they discuss retail innovation strategies and hear how to deliver exceptional digital and in-store experiences at #VMwareExplore on August 21, 2:00 - 3:30 PM PDT. https://nvda.ws/3OHP88x",2023-08-17T23:53:59.645924,[],https://scontent.fcai19-7.fna.fbcdn.net/v/t39.30808-6/366747064_677145837783034_3404313578997611592_n.jpg?stp=dst-jpg_s960x960&_nc_cat=102&ccb=1-7&_nc_sid=730e14&_nc_ohc=UEwX51kkF8AAX9Nrz6e&_nc_ht=scontent.fcai19-7.fna&oh=00_AfAaw9r2htYQDr_MmCv3QEE729nsLS1DPSKNSyuLDNPkBQ&oe=64E47CDE,https://www.facebook.com/NVIDIAAI/posts/pfbid0whebBzHftkKuhBpG3vgifpKmJsfexahSAmkqjEd4y2TizgTkjSDb4iGPhsRwcySKl?__cft__[0]=AZXQeyym0OMoU4m0oH9uf1TsVb71qOGxaZHuEE5vGnsg5Il2wkSRjVLETGcYnHiNt_9bqQZY7PdHrnPpQC0-VjRRYLupq5K6KNnSeG7vLSuHQOhQrdoz97sJQsDjJlfDs5z_DcQckmlbd3XzEX1-NOv0Sk9ykRSAGWIZFJiu1-qxD6vNkAycHdlESfpfmp7DtGBcjW0L-KHghcsfbQbSjxEt&__tn__=%2CO%2CP-R,4,0,positive,4
pfbid0bgkBydTPKj756YeVJ2cY7HKfcyvU2zYLsu4aFdMaag5ee2tjKsXvnGWU1v2GaiQsl,NVIDIA AI,0,4,0,0,0,0,0,0,4,0,Learn how NVIDIA and Generative Red Team Challenge are giving thousands of hackers the space to test and evaluate the latest generative AI platforms at DEF CON.The challenge enables the hacker community to be at the forefront of building safe and trustworthy AI in an unprecedented manner. ,2023-08-17T22:53:59.698563,[],https://external.fcai19-7.fna.fbcdn.net/emg1/v/t13/7878606628636544559?url=https%3A%2F%2Fblogs.nvidia.com%2Fwp-content%2Fuploads%2F2023%2F08%2FDefcon-Hacker-Trusted-AI-blog-green-1280x680-1.jpg&fb_obo=1&utld=nvidia.com&stp=c0.5000x0.5000f_dst-jpg_flffffff_p500x261_q75&ccb=13-1&oh=06_AbG9fA_xz5qlx5BHBZ4nJM2iwE12gJ53PPLEaBBdyRTAcA&oe=64E00761&_nc_sid=dbad39,https://www.facebook.com/NVIDIAAI/posts/pfbid0bgkBydTPKj756YeVJ2cY7HKfcyvU2zYLsu4aFdMaag5ee2tjKsXvnGWU1v2GaiQsl?__cft__[0]=AZXVN0JToiAGpjgshdTbgfN9HhWFKnFLGLVFndSLda1ra6PDCqhizXByPDxehDzxRb8BJeRsiTcNUQgiKx8WVjklBI5XUD9msUfSgHDZrKUSi7rSoAdG3t8E31ecpHnTE7KgXGHZ5nAFxUpikrC6IXcz9rcNsFeyc_oD8Z0oCDBZJwnTzBm8AxNFtb9uDAvTzt57FDfYTKftArOIGrMfE9_I&__tn__=%2CO%2CP-R,4,0,positive,4
pfbid024vaZ4f6ExSfnD49QFFyM2R3xeXAc8srGU4eMGowrx8ps4nMQKhdxmhj2EvHeTNxjl,NVIDIA AI,1,18,2,0,0,0,0,0,20,1,"Congratulations to the #NVIDIAInception members who showcased their applications at #SIGGRAPH2023.NVIDIA Inception provides startups with the latest developer resources, preferred pricing on NVIDIA hardware and software, and exposure to the venture capital community. Learn more and apply > https://nvda.ws/47z3iRQ",2023-08-17T20:53:59.796274,[],https://scontent.fcai19-7.fna.fbcdn.net/v/t39.30808-6/368203032_677069514457333_664900476645195511_n.jpg?stp=dst-jpg_p526x296&_nc_cat=104&ccb=1-7&_nc_sid=730e14&_nc_ohc=BoUF9sQsP9UAX_FHBjS&_nc_ht=scontent.fcai19-7.fna&oh=00_AfA5HNypM0T5D7w44tqB8XVwz5PyrMFrTiZgu_tKg28TBA&oe=64E39A0C,https://www.facebook.com/NVIDIAAI/posts/pfbid024vaZ4f6ExSfnD49QFFyM2R3xeXAc8srGU4eMGowrx8ps4nMQKhdxmhj2EvHeTNxjl?__cft__[0]=AZW7fBqhnHbboh5N8z4K1SLwYFcOMZuK9II8seleWV9KqNP0qNFcSOgijVfxUdtKlN-0jDshY-94BQnDeN6CNRC0dsxeZuRNpnpX2OwhLOeu68ZPjcOmaNlf-KqwyVh-nTXMoW-48v2gADy1SAmS5QuL47EvJbs7h2YpbZUzEP5ZMRjTc3XhA2Ig09nzy9HxCzBWcBXRWfRX_Tm_Wcyyum3e&__tn__=%2CO%2CP-R,21,0,positive,21
pfbid02s8p9rXo91DZoVjSNBdKNt6GtE6z2DxBmMeoUeCzWKQmZYaQVSsdLgPzBtFJ3Ykevl,NVIDIA AI,0,40,0,0,0,0,0,0,40,2,"NVIDIA AI playground on NGC empowers you to experience state-of-the-art #LLMs like Llama 2 on GPU-accelerated stack, directly from your browser without any setup. ",2023-08-17T01:53:59.888188,[],https://external.fcai19-7.fna.fbcdn.net/emg1/v/t13/5542144220579380821?url=https%3A%2F%2Fcatalog.ngc.nvidia.com%2Fdemos%2Fllama2.jpg&fb_obo=1&utld=nvidia.com&stp=c0.5000x0.5000f_dst-jpg_flffffff_p500x261_q75&ccb=13-1&oh=06_AbGWlGIbqmXAod1ZpPi-MwcSOMl6pYhjOjIeAPQBbWXL6Q&oe=64E08FA9&_nc_sid=dbad39,https://www.facebook.com/NVIDIAAI/posts/pfbid02s8p9rXo91DZoVjSNBdKNt6GtE6z2DxBmMeoUeCzWKQmZYaQVSsdLgPzBtFJ3Ykevl?__cft__[0]=AZVVOOyXJZcw979bD0nTLBCzhZIwdSRGKr4jYBFemZtqp75iE64P5SAtLQqOjSoDuR3AIkcW6s0J39q4t33rMILwZbD-XkR-UTulXHl1W5vkNbPWSQfsWF7tZcorBDrQDyuV0sGeJcdAF1dMUpoJxvjfPY9_pO_PQmIVa11SXDAdcNtU81zvCXnh9RRB6VOMeltMcGABDkv7u-Sr5wDdEkX1&__tn__=%2CO%2CP-R,40,0,positive,40
pfbid08Arj43Wm4LELRttjSCm4dx5qyshxYGpnjNykbZzKw1sU1e6QM4XbTnUHt18Rbgs9l,NVIDIA AI,0,18,2,0,0,0,0,0,20,3,"Just 6 more days! Don't miss NVIDIA founder and CEO Jensen Huang live on stage with VMware CEO Raghu Raghuram at the #VMwareExplore General Session Keynote on August 22, 9am PDT. Save the date. https://nvda.ws/3Oy05cz",2023-08-17T01:54:05.276746,[],https://scontent.fcai19-7.fna.fbcdn.net/v/t39.30808-6/367996338_676497384514546_3603516827144516680_n.jpg?stp=dst-jpg_s960x960&_nc_cat=100&ccb=1-7&_nc_sid=730e14&_nc_ohc=Pda0P7uo6Z8AX8DJMzf&_nc_ht=scontent.fcai19-7.fna&oh=00_AfAJPttspH0rD5wQEi2V6b3NgzYz2jxu28LSqsaX5RP7pQ&oe=64E32DA8,https://www.facebook.com/NVIDIAAI/posts/pfbid08Arj43Wm4LELRttjSCm4dx5qyshxYGpnjNykbZzKw1sU1e6QM4XbTnUHt18Rbgs9l?__cft__[0]=AZUaDfbVYUSxODVIPW82NuumoHyd8kRaxcI89Po7cUq4gDyx0g3BL2iuA3Hj-qyK5LaIDQOqy6H07NUvfFw2oZEQjoD9qzuteii_pm9SuM-se7lu7H4GkFZLV1TiLOVEs6iepYLCLa6gVGwzd4byJxhhtSNaeKnYzYff6kpvksj99Z_OFFMeyfCpXVH6UohLS_KCh5GYyN4mYgD0QdTHxfOt&__tn__=%2CO%2CP-R,20,0,positive,20
pfbid0euGyonYSyhEYJVQfELfdcai1hWeykiKUvVG3hQZNLxytVckcyvZu55784atd8wBml,NVIDIA AI,0,4,0,0,1,0,0,0,5,2,Hear innovators discuss opportunities for all industries to leverage the #3D internet to accelerate their path to automation and digitalization. Watch the full #GTC23 session on-demand: https://nvda.ws/43Uth3c,2023-08-17T01:54:05.365199,['blob:https://www.facebook.com/dac93f6f-2484-4a41-89ac-3a21647a7a68'],https://scontent.fcai19-7.fna.fbcdn.net/v/t15.5256-10/356578588_1348200862458247_7658110916804258436_n.jpg?stp=dst-jpg_p180x540&_nc_cat=109&ccb=1-7&_nc_sid=ad6a45&_nc_ohc=FI5g9q1aj1YAX9STZcm&_nc_ht=scontent.fcai19-7.fna&oh=00_AfCprEWgBjge5KGfWAkbZthwQ314-PVZB4WlO6sXi8xF5Q&oe=64E36827,https://www.facebook.com/NVIDIAAI/posts/pfbid0euGyonYSyhEYJVQfELfdcai1hWeykiKUvVG3hQZNLxytVckcyvZu55784atd8wBml?__cft__[0]=AZX2GXsh2zL153eYEG9k2lj7VKLFvOEhqgoRUlDwt2WUxPgkrrgfyGmnyFX3GnluI-pACJMpxCtmGqei2OiicTilPM_tStfMwxR6m-SQp3EnTge7-AeWaU4PPpbIbJBB3G5i3dC4wp42V6mDZ2d3oRluhWYIbNoSJ2uwGl_dL6wIPcLfrJP-TgnYErOzL5z8Bi4Jr5bOf13L1UHdjaw6QGYMPBCTcRbucp-kZ9jhufykl8RHKRMLpDBpIUkpAV4d7ZE&__tn__=%2CO%2CP-R,5,0,positive,5
pfbid0Uin4RCL985uoKmze76H7UQoENDotDKqGGpzCmtkSqAnQ3HTpayvoYAqhfHd2Z9dul,NVIDIA AI,0,8,0,0,1,0,0,0,9,1,"Watch this video to learn about NVIDIA AI Foundations - a set of #AIfoundries that enable training, customization, and deployment of #generativeAI models. NeMo is for custom #LLMs, NVIDIA BioNeMo is for drug discovery, and NVIDIA Picasso is for image, video, and 3D applications. ",2023-08-16T01:54:05.460026,[],https://external.fcai19-7.fna.fbcdn.net/emg1/v/t13/2437802010146837235?url=https%3A%2F%2Fi.ytimg.com%2Fvi%2Fum8BhDSuzoY%2Fhqdefault.jpg&fb_obo=1&utld=ytimg.com&stp=c0.5000x0.5000f_dst-jpg_flffffff_p480x250_q75&ccb=13-1&oh=06_AbE4cTKo6LVpte1Tol5BbVxGP5pyi5dy1WMgBs8PUW0CoQ&oe=64E0758C&_nc_sid=dbad39,https://www.facebook.com/NVIDIAAI/posts/pfbid0Uin4RCL985uoKmze76H7UQoENDotDKqGGpzCmtkSqAnQ3HTpayvoYAqhfHd2Z9dul?__cft__[0]=AZXl6K7A00Xw9bB5iAskP4Vb4eaP_T2nCJ-p0sHeklMKXHbxnUTdLp2BOva7aSCJUkRhbWnkIELI-lCu3ksZt7MfcsMQSBE0xTEOllwfVgn6fKZNCPQi4NFPZsPNEbdXBA3dkpC68MiWiKFv6Hjtl_wvMRR-1S3MfSlLU3GkbxXJbV7Mep0yG3fnAUSJyo-1lE_rc0HfXISdshhJob5BK3kr&__tn__=%2CO%2CP-R,9,0,positive,9
pfbid0Ys3Gb4kKY5tyqPEyvLRyC9Bk5UDpSnz5Ar4PRP6mRqxxFKLDp2YLZze7HyWzMwXml,NVIDIA AI,0,25,0,0,0,0,0,0,25,3, Rapid recap of #NVIDIAResearch released recently at #SIGGRAPH2023 https://nvda.ws/3QEqMPm,2023-08-16T01:54:11.613493,['blob:https://www.facebook.com/400bc2b3-1dac-471d-8154-1bc01e8f0d83'],,https://www.facebook.com/NVIDIAAI/posts/pfbid0Ys3Gb4kKY5tyqPEyvLRyC9Bk5UDpSnz5Ar4PRP6mRqxxFKLDp2YLZze7HyWzMwXml?__cft__[0]=AZV62b0BL30M0Cg3ikLop794h_SCLgEysyqYWAov5qsaPzSJjVYHNeRBg1mbvQoGPGbI6GqMDVjD6_pgtuPFvlSckIuKYZHubcEhivWfWyjB6OVwr4snwWGB5eFV8zXtLWB-A0oA-_kN5gi3p5YiX_-IPz6cMOG2BuuieL6MakVQghPkcPtM2L0VIjS2jcK208Rt7DB8N80UgkRrWo87BJKx&__tn__=%2CO%2CP-R,25,0,positive,25
pfbid02aZsd82F6SXgnUZNJHnADGDHfYoVDLyntBPeekHjLCHfZV96PaRyupVjd2e3BahVql,NVIDIA AI,0,9,0,0,1,0,0,0,10,2,"With NVIDIA AI Playground, you can now experience the CLIP model running on GPU-accelerated stack directly from your browser. Just upload a few images to the CLIP model and ask a question to identify the most relevant image. #generativeaihttps://nvda.ws/3E0bNb7",2023-08-16T01:54:11.659380,['blob:https://www.facebook.com/01451ad4-26e3-49b8-8d77-04357129b04b'],,https://www.facebook.com/NVIDIAAI/posts/pfbid02aZsd82F6SXgnUZNJHnADGDHfYoVDLyntBPeekHjLCHfZV96PaRyupVjd2e3BahVql?__cft__[0]=AZVstW35bb8FYq0MZv28Pfhr_6FVLY6mBnjNIq38IHVqWMnatb2MozcF5H_z56b2w2tV72OlPFEXAe7etGAAyRFc60Am_5QdUaZT2fP25WwfwhvPmFXwtF-ET5SJjAYEswKOFLIzWXVJprGxZB7S9v6C-pEXWBglPhvX2AuiA4rpXKFz9z1kDRXfAHXetHrRcCKYPkcN49QQnnbF5QfYsYL2odG6Rt2-7pTlHqfKm6iRBA&__tn__=%2CO%2CP-R,10,0,positive,10
pfbid038FzK78Bqpw4Sp4dsSTmyf2roz9uPv2jCAzMQe13X8KWvDGzs5sKiXg3CuUfopcpQl,NVIDIA AI,1,17,1,0,2,0,0,0,20,2,"NVIDIA and VMware have partnered together to democratize #AI and #ML for all enterprises. Learn more about NVIDIA and VMware's AI-ready enterprise platform at #VMwareExplore. Aug. 24, 10am PDT. Register now. https://nvda.ws/3QE98v3",2023-08-16T01:54:11.718447,[],https://scontent.fcai19-7.fna.fbcdn.net/v/t39.30808-6/367737400_675977794566505_2481421947832284039_n.jpg?stp=dst-jpg_s960x960&_nc_cat=111&ccb=1-7&_nc_sid=730e14&_nc_ohc=TaSgR3Hl60sAX-nbnyF&_nc_ht=scontent.fcai19-7.fna&oh=00_AfAv1zvbyFlKaXxY17ScaO-2Ytf8upN-JV_ysALHa1T7mg&oe=64E32604,https://www.facebook.com/NVIDIAAI/posts/pfbid038FzK78Bqpw4Sp4dsSTmyf2roz9uPv2jCAzMQe13X8KWvDGzs5sKiXg3CuUfopcpQl?__cft__[0]=AZWyxv-XqNv9358q8mcY3oqQGeuS3G0Lp4WtPhfFBNn97gsm3s3Eo7MzVHGUcnIphjxg8SOSVxRQcpCbInh9f6zdLpLRQrr-fsMsNMs1XKTkksfBaob_77eFgWHJQ9yvsi4TFp5iMPqYX1tuOg-3HOlyvgzHbVog8jRw7uMyRwsaDfi_QOOJZ4uIu1It1goG4VQZEupq_WA6DsYzJFSrgAPC&__tn__=%2CO%2CP-R,21,0,positive,21
pfbid02QHNKgHXBXKQCqJRtioD1jCNP3S5fJvPe7LZciuctHAGnVKzYKSfaRmohR9JMFKhCl,NVIDIA AI,11,119,0,0,0,0,0,0,119,3,"The latest release of NVIDIA AI Enterprise now includes support for NVIDIA NeMo, a cloud-native framework allowing enterprises to build, customize, and deploy large language models for their #generativeai AI workloads. Learn more. https://nvda.ws/45mTeJI",2023-08-16T01:54:11.767604,[],https://external.fcai19-7.fna.fbcdn.net/emg1/v/t13/12253497637852918515?url=https%3A%2F%2Fs3.amazonaws.com%2Fcms.ipressroom.com%2F219%2Ffiles%2F20237%2F64d24d613d633211dc4accf8_nvidia-ai-workbench%2Fnvidia-ai-workbench_b68901a1-80dc-4062-ac16-7e7f2d1e58e4-prv.jpg&fb_obo=1&utld=amazonaws.com&stp=c0.5000x0.5000f_dst-jpg_flffffff_p500x261_q75&ccb=13-1&oh=06_AbHJUUELazsqn1xCMkY6QeoMkL9zIC6R7ZN59CLca6G4Ug&oe=64E0850B&_nc_sid=dbad39,https://www.facebook.com/NVIDIAAI/posts/pfbid02QHNKgHXBXKQCqJRtioD1jCNP3S5fJvPe7LZciuctHAGnVKzYKSfaRmohR9JMFKhCl?__cft__[0]=AZUAF7d2j9pkQYixhVj0e5PC1_rygs1swOZw8jcbjKXYRCvM9Z2o81d6QM8oHnQZTUKaK-tIKR9VGaMBTv9Hj0H5Qu8UnEaJKlXn2bfD9EbXUt3yW6KMMGSbgUDTOxkEogM3mGg-FMtIG8hTzKHPwsddr9zTn3et2QJ3Ccn5L4v-SMIVPbePbcQ_FnRPWVpGcOq_WCAAV4f0rdhuJPMmanJt&__tn__=%2CO%2CP-R,130,0,positive,130
pfbid0fJyVsmKYSB9ECr6mecxFxV7LFSU6y4BFc9xTUCeDiRgScbST6X1WyGXq6x57GTpZl,NVIDIA AI,15,96,6,0,0,0,0,0,102,1,"With NVIDIA AI playground, you can now experience NeVA, a multi-modal vision language model, directly from your browser. Just upload an image to NeVA model and ask questions related to the image. #generativeai https://nvda.ws/3Kz2LFH",2023-08-15T01:54:11.818595,[],https://scontent.fcai19-7.fna.fbcdn.net/v/t39.30808-6/367703088_675482994615985_7696830558684165335_n.jpg?stp=dst-jpg_p180x540&_nc_cat=109&ccb=1-7&_nc_sid=730e14&_nc_ohc=jbheL3GhVXIAX_9R_Hd&_nc_ht=scontent.fcai19-7.fna&oh=00_AfC6jWxBJosHTwqJA7qsT4U5WPMqt7ezoj4_ZaRYaIRy_w&oe=64E3FB4C,https://www.facebook.com/NVIDIAAI/posts/pfbid0fJyVsmKYSB9ECr6mecxFxV7LFSU6y4BFc9xTUCeDiRgScbST6X1WyGXq6x57GTpZl?__cft__[0]=AZX5rhtIlcu5ATHaMyhmAMoA9KCOyei2qzM28klV65xMKwVzT7rrR6PAmdgidZVoTXMZtj6Jq_0aEC_DZDUIeAIMFxvQ0D_FyuSAwheWOtNMJLK_tdRzZGK3tfnS7p4B5NaeAgGgII_9fI1N8vA5yBsSM52S623QzAOhmnV2QMv_v9iZg4JFixaMP3unz9DpMBtZSntiddxMldY6VnT-NXDO&__tn__=%2CO%2CP-R,117,0,positive,117
pfbid02x1ZLW1AYiAjqzQfuvaPPBVzx1Z9ZQfheUVjrpDpMrhPJajAXJNaBBwsMsCxZ8Ttxl,NVIDIA AI,8,36,3,0,0,0,0,0,39,1,"The NVIDIA Graduate Fellowship Program provides financial and technical support to graduate students tackling the biggest research problems with NVIDIA technologies. Applications are now open, with awards of up to $60k per student. Apply by Sept 7 > https://nvda.ws/3s8DU5i",2023-08-15T01:54:17.983951,[],https://scontent.fcai19-7.fna.fbcdn.net/v/t39.30808-6/367697422_675457597951858_5778302363678118310_n.jpg?stp=dst-jpg_p180x540&_nc_cat=105&ccb=1-7&_nc_sid=730e14&_nc_ohc=bFgSnwbJyJ0AX-yVsP6&_nc_ht=scontent.fcai19-7.fna&oh=00_AfCovTzw8jSsNVZGimMowQ3a99X1ZWHiawhKL073a1Q3gA&oe=64E3B86F,https://www.facebook.com/NVIDIAAI/posts/pfbid02x1ZLW1AYiAjqzQfuvaPPBVzx1Z9ZQfheUVjrpDpMrhPJajAXJNaBBwsMsCxZ8Ttxl?__cft__[0]=AZWBDkfO7gPCBXS_8W21U0KYPOHe0-oQPsC9efSnLtsp5gw6FH4g9C8Tuo3NkB7I7sMyvyq5ZqQChVzAkKlywjtCqvn7iphOzllsdnrkIBVvExrcWjGLUGqnfJxIRKNYiEpIyAdyOuIeMYBNhlUiJyElsCS92EH1qwobz5qbvJxUS6SRzGzvmFGEwgqizRMyfhrMYd7iVSx4WKfzbxnOy32u&__tn__=%2CO%2CP-R,47,0,positive,47
pfbid0rv9RV1WLuTiD96i9AuJRpfPqh6Ys718WduU3QidbACwtzZcaDhuayWwDzUdNRFaXl,NVIDIA AI,0,15,1,0,2,0,0,0,18,5,Register for Speech AI Day on September 20 to learn the latest trends and cutting-edge techniques in #speechAI. Register Free: https://nvda.ws/3DQGfnM#Finance #AI #Retail #telco,2023-08-15T01:54:18.041448,[],https://scontent.fcai19-7.fna.fbcdn.net/v/t39.30808-6/367697625_675431827954435_6918436948151067699_n.jpg?stp=dst-jpg_p526x296&_nc_cat=102&ccb=1-7&_nc_sid=730e14&_nc_ohc=sZ1M5DHqbTwAX8hp7aE&_nc_ht=scontent.fcai19-7.fna&oh=00_AfBy7B6uKc9MOtta0BnJLO7DMyyDWAA_7ewClhQATCj1rw&oe=64E36462,https://www.facebook.com/NVIDIAAI/posts/pfbid0rv9RV1WLuTiD96i9AuJRpfPqh6Ys718WduU3QidbACwtzZcaDhuayWwDzUdNRFaXl?__cft__[0]=AZWA_mYO05Yem65tOjvI6aY72ZofsZlRzMBRYZG1waLlmyKGrgrXVFk4rXrusFVlHXvf3vfu5TmioPHh7bjqAldK-RZzKLo37Jqcu6r80_4R2lpvcZ1c4BQNszqzPiZ16WnqgA8jsMFP54divINliI6oC5g8E1mtRE0O5tfzckhu343GiRSx1UXtxCplCOpPzj-ZllPPyl5XzMPiFdovcEHl&__tn__=%2CO%2CP-R,18,0,positive,18
pfbid0oX8aLdc1xvcwzPY6r9efFFSqBJqVHw2dRTkwQUdmpsVyPyQsSKcZQWmrrJWXiQZYl,NVIDIA AI,1,18,2,0,2,0,0,0,22,1,"Join Erik Pounds, Sr. Director, Product Marketing, of NVIDIA and Robbie Jerrom, Principal Technologist of VMware, to learn how NVIDIA and VMware will help your organization adopt #generativeAI and unlock opportunities. Aug. 22, 2:45pm PDT. Register now. #VMwareExplore https://nvda.ws/44YXiQF",2023-08-15T01:54:18.095762,[],https://scontent.fcai19-7.fna.fbcdn.net/v/t39.30808-6/367691964_675409857956632_6794440359065049910_n.jpg?stp=dst-jpg_s960x960&_nc_cat=109&ccb=1-7&_nc_sid=730e14&_nc_ohc=SNHrho7Y96YAX8b_2Ie&_nc_ht=scontent.fcai19-7.fna&oh=00_AfCSTwvGB5gyNS2Q-viBaKpbdTNcMnPSD6E3hpcLuVjg0g&oe=64E2D3E0,https://www.facebook.com/NVIDIAAI/posts/pfbid0oX8aLdc1xvcwzPY6r9efFFSqBJqVHw2dRTkwQUdmpsVyPyQsSKcZQWmrrJWXiQZYl?__cft__[0]=AZXFPmJHj5b1CpRpbbJFOLiFUdLM7O1xWn1yV9bYBUO1NZRVapHP0Gdj0PAX6yHee7CaV_P4qjo0LuLeRXRlMtLzoYFFSuS5EbhvleozCBAT6aN9aL4qy7U1S3e6iZbRmVLhvUWvchG8l4eLdUkhHBsidsj762da-yt-F_ALtKHzwEI7WhrFSADDEP-wbgBjPnbBDPl-ZQQ-tvrA9i9xcHYp&__tn__=%2CO%2CP-R,23,0,positive,23
pfbid02E7CP14w6cg7vUxVBSdUeXrAt9yKnCqbeaJmkkFNNpFdaGUhKPv1Hdi1EuBeqVXYEl,NVIDIA AI,0,17,0,1,1,0,0,0,19,2,"A textured approach: #NVIDIAResearch shows how #generativeAI can help create and edit photorealistic materials, accelerating #3D workflows. ICYMI: Check out the #SIGGRAPH2023 Real-Time Live  Best in Show paper: ",2023-08-13T01:54:24.227029,[],https://external.fcai19-7.fna.fbcdn.net/emg1/v/t13/17125692829042608338?url=https%3A%2F%2Fblogs.nvidia.com%2Fwp-content%2Fuploads%2F2023%2F08%2FTxt23D.jpg&fb_obo=1&utld=nvidia.com&stp=c0.5000x0.5000f_dst-jpg_flffffff_p500x261_q75&ccb=13-1&oh=06_AbGylAB6cpE6g1LpQJV-Msv_C2slxlscG3tCDZpjf7Us3g&oe=64E01F3D&_nc_sid=dbad39,https://www.facebook.com/NVIDIAAI/posts/pfbid02E7CP14w6cg7vUxVBSdUeXrAt9yKnCqbeaJmkkFNNpFdaGUhKPv1Hdi1EuBeqVXYEl?__cft__[0]=AZUGgPPZOSoGRrj9-mydvnuw18bJtX5Ma_XqJcnelSRJ7qKI2CaYsnaKyo5umYoCdLOghuCXOyvEecCrNv70fmD2KJ6BTvFA2w5ZyHFUO2Oe92keF3-kjjZa9bUBgCAj816Xld-EpGrveiqLJr80Iw5kZxbaPi9cA2__QL7d87riHmVSHtGsrsM5buSLpAU6RGWc01c2HNWq_Y78TSQubjld&__tn__=%2CO%2CP-R,19,0,positive,19
pfbid02oAP28uJg9AzaKgWpWfMUEjhBi4d1RhboTWxWYYs12UtNpGsfPMFx4C6hShFp61wbl,NVIDIA AI,3,47,3,0,0,0,0,0,50,2,"NVIDIA AI playground on #NVIDIANGC empowers you to experience state-of-the-art #generativeai models like Stable Diffusion, running on GPU-accelerated stack, directly from your browser without any setup. https://nvda.ws/3DOJdJC",2023-08-13T01:54:24.278421,[],https://scontent.fcai19-7.fna.fbcdn.net/v/t39.30808-6/366613258_673948038102814_5328627193437454238_n.jpg?stp=dst-jpg_p526x296&_nc_cat=110&ccb=1-7&_nc_sid=730e14&_nc_ohc=95Vo53a5zxMAX-fg0No&_nc_ht=scontent.fcai19-7.fna&oh=00_AfDfbK6lwCI8Tk9ZiLAGzadCnLlkmecWAedixMqfW77Cmw&oe=64E3CA52,https://www.facebook.com/NVIDIAAI/posts/pfbid02oAP28uJg9AzaKgWpWfMUEjhBi4d1RhboTWxWYYs12UtNpGsfPMFx4C6hShFp61wbl?__cft__[0]=AZUk4E__XBIFZgIBZ21zSBYIvlNBPAeaJUZdaZ1MTvJag9gJhfbEsSbqSq2ElxYunvevfrsV9TKo91ilvAGdPLx-SLjTVZUwjJKMLP3lxTzddvC2SSNwK3IuBokGhSv1ZMfU-q9c427SNSkFRcYjryKbx8XlokGMtVe50qE1wm8bkPDAYH4N-Q0m1c2OVWMdhF4qsitRyruWgyiD48nBf0Dc&__tn__=%2CO%2CP-R,53,0,positive,53
pfbid08vKkqwYAPS9Dk5oonxZwmxynXhY5XDEQLhNcSwLEWgvge2DPV8kn7wfNj1Uw7a9Hl,NVIDIA AI,0,26,0,0,3,0,0,0,29,3,"Join us at #VMwareExplore, August 21–24, at the Venetian Convention and Expo Center in Las Vegas, Nevada. We will be showcasing our partnership with VMware and highlighting how together, we are empowering industries with #generativeAI.",2023-08-12T01:54:24.324450,[],https://scontent.fcai19-7.fna.fbcdn.net/v/t39.30808-6/366925465_673864458111172_6394993584708722608_n.jpg?stp=dst-jpg_s960x960&_nc_cat=106&ccb=1-7&_nc_sid=730e14&_nc_ohc=87MFMlU1cN8AX9Gdt2p&_nc_ht=scontent.fcai19-7.fna&oh=00_AfA-X9nf-HJrITerVHkA2DWQDgFtK4HmG0Xc4y7jsbeg2g&oe=64E39E96,https://www.facebook.com/NVIDIAAI/posts/pfbid08vKkqwYAPS9Dk5oonxZwmxynXhY5XDEQLhNcSwLEWgvge2DPV8kn7wfNj1Uw7a9Hl?__cft__[0]=AZXoKuPk4GRKZfqSr6M08W_bRAdmv9PkxYRSq-vCaE1HeUec6-S-9il34VeCfLufjUJN7M4rJ30BA9skzBCJ9CJBFEhKldzn3kz8ZqpNtlBxGh_Srqs3WB_ZU_tuEJVlSUrHNeNaITDgnc9mcIaquMZY6Tid8gCQx3iZtm5odQ2KLvkdNXXi0r0J4sHa4o0bI5YTebiv2sZ2QkyH30d_DLhQ&__tn__=%2CO%2CP-R,29,0,positive,29
pfbid028GeQJoFkfqB7wFSSJeoRbzxMA5YRSwC1Ae3WdTMry6oo3RnpPSqajWq2mJpnAhPLl,NVIDIA AI,0,8,0,0,1,0,0,0,9,0,NVIDIA AI playground enables developers & researchers to experience #generativeai models directly from their browsers. These models can also be integrated into projects using APIs or run on Windows machines with RTX GPUs. Watch the video to learn more.  ,2023-08-12T01:54:30.519963,[],https://external.fcai19-7.fna.fbcdn.net/emg1/v/t13/1121251235069735033?url=https%3A%2F%2Fi.ytimg.com%2Fvi%2FgjoWSRoFEhQ%2Fmaxresdefault.jpg&fb_obo=1&utld=ytimg.com&stp=c0.5000x0.5000f_dst-jpg_flffffff_p500x261_q75&ccb=13-1&oh=06_AbHtZmiYENcL75v2JjyAI8opR3a64mHM0iD1FszRqnrSAg&oe=64E01CA0&_nc_sid=dbad39,https://www.facebook.com/NVIDIAAI/posts/pfbid028GeQJoFkfqB7wFSSJeoRbzxMA5YRSwC1Ae3WdTMry6oo3RnpPSqajWq2mJpnAhPLl?__cft__[0]=AZWx4nQEsKc9Zx3j7g0VWBg29q5P7MwhqaFfvbk4SMK4hEKCCbFU8CJrQDuRdWVxZ4cX5tGFQ0Vz8M_mgReQ8dNmrkfCusVAYKvIXkq28S-G_LD8_sDbE14JwL9qgKyruf9NdMMnNrVO9w8_3crLOhC5wVQPlKtiFd7-SFAkcalBT0veqsA1hnH_LqqVFk2Z22WyWInjwANUf_MUNGsEj0Zc&__tn__=%2CO%2CP-R,9,0,positive,9
pfbid0F4EsQSDfwrdV9EMyf9LWZPqLKw3dp2MKgAuBbdt6GKyfZyU9aGtYLjZPE6YNCViol,NVIDIA AI,15,18,0,0,1,0,0,0,19,1,"Don't miss NVIDIA founder and CEO Jensen Huang speak with VMware CEO Raghu Raghuram live at the #VMwareExplore General Session Keynote on August 22, 9am PDT in Las Vegas. Save the date. https://nvda.ws/45jsYR7",2023-08-12T01:54:30.578894,[],https://scontent.fcai19-7.fna.fbcdn.net/v/t39.30808-6/366930860_673785594785725_9220911515373176138_n.jpg?stp=dst-jpg_s960x960&_nc_cat=108&ccb=1-7&_nc_sid=730e14&_nc_ohc=WNJhMuLLMg0AX9t3rP5&_nc_ht=scontent.fcai19-7.fna&oh=00_AfBa1Rxhbs45JjGxPAsT4HcOxMKbsR0AW0Ri_GZNOVFHFA&oe=64E462A8,https://www.facebook.com/NVIDIAAI/posts/pfbid0F4EsQSDfwrdV9EMyf9LWZPqLKw3dp2MKgAuBbdt6GKyfZyU9aGtYLjZPE6YNCViol?__cft__[0]=AZWM-8cMdb6mwCp-AWFQuyBUW8gETNDaaHnMylSM0xoxzbp2gU0XkDyX-ZlONSRQ84xCK4PR6X-1g1q2ixPS0BkUng9MFgO1guaU7mIXWr9S2NDflPAKhqRPc5DRdhGJ5YnS2iLzTY_zHDgOKD5f7mWp3joCv3QzI_qsVgNn4DiA7-1D4VRdu5w9wi3aiNvE-lJWVvxP9lqAwkb-yyy9kKfd&__tn__=%2CO%2CP-R,34,0,positive,34
pfbid02yz1b7dmTV1QxXgFPBFK8QRMkxfJyc5NTdqZ8yLGRnH8nuETRrW13tp7TpFYZw2vDl,NVIDIA AI,3,14,3,0,1,0,0,0,18,1,"How can #AI improve your #3D models?From reconstruction to #GenerativeAI, FlexiCubes generates high-quality 3D triangle meshes with sharp features. #SIGGRAPH2023  Learn more: https://nvda.ws/47p3JOC",2023-08-12T01:54:30.637834,['blob:https://www.facebook.com/a28f08d5-2a41-4533-85f4-354fd6692e17'],https://scontent.fcai19-7.fna.fbcdn.net/v/t39.1997-6/105941685_953860581742966_1572841152382279834_n.png?stp=dst-png_p320x320&_nc_cat=1&ccb=1-7&_nc_sid=0572db&_nc_ohc=X59zfTVoW5oAX8qF1XC&_nc_ht=scontent.fcai19-7.fna&oh=00_AfBVH-avEJLjYxd1TGz8sEWeADWtISDBMOsIBQnA5Y8ALw&oe=64E3B642,https://www.facebook.com/NVIDIAAI/posts/pfbid02yz1b7dmTV1QxXgFPBFK8QRMkxfJyc5NTdqZ8yLGRnH8nuETRrW13tp7TpFYZw2vDl?__cft__[0]=AZWpAHhM516CYmxkDoQTc8tfh9xDLTJsUxLrQ_i8Yh7MpwwoawFrGOUQydjqaUivMWESyD4B3n2GxQ2NdwM1FJ1C2RSZsobYjx8AvGKnVs6TVHJtNgdJuJSuX5qBdcf511cHr65vU0Pnaa6GhdrARHvlJOixA5hIZssdKscRp5K0RUsR5A1GL53cLmRxPXtqQ7g9W4xs5bbKpsxbCUq2Ejcj&__tn__=%2CO%2CP-R,21,0,positive,21
pfbid02RA3Ms65WSzqYSh6vGojFSdWyKs4oxg1AMqqpdiPgZJoEbrREBN79B2cvsEERST3Dl,NVIDIA AI,0,9,0,0,1,0,0,0,10,2,"In this upcoming IDC webcast, ioin specialists from market leaders Red Hat, HPE and NVIDIA as they share their experiences about what works and what does not and how you too can jumpstart your AI journey. Register now. ",2023-08-11T01:10:00,[],https://external.fcai19-7.fna.fbcdn.net/emg1/v/t13/7183830087931129911?url=https%3A%2F%2Fimages.engage.redhat.com%2FEloquaImages%2Fclients%2FRedHat%2F%257Bfbdd4ce2-14da-4fa6-997c-0c261d3951cb%257D_image001_%25282%2529.png&fb_obo=1&utld=redhat.com&stp=c0.5000x0.5000f_dst-jpg_flffffff_p500x261_q75&ccb=13-1&oh=06_AbE6JUD4ZlP_pjVIgVpgnlbyJNNhkulv2kTyDCDQvxf2YA&oe=64E02F5A&_nc_sid=dbad39,https://www.facebook.com/NVIDIAAI/posts/pfbid02RA3Ms65WSzqYSh6vGojFSdWyKs4oxg1AMqqpdiPgZJoEbrREBN79B2cvsEERST3Dl?__cft__[0]=AZWcIk1_hz9NRneVdWDdRmf2ymsk3VVInEzzJdXNGDxNQhMyc2wiSusdhT2GTR1DnKSiQqMCmx9P5_K8K-ck8fbUaSoK1pVWgbrtYRwUpabmXvE5mJesLe6BtAGwF9kt5_WXBO8YyZXOT0Y3woQ5A--Dpfd8tuXql_hzkdSzw5AyNFwd5wnsNfq4-gfnwewMpmfXOBU4JZa7buW3c0KaNPGm&__tn__=%2CO%2CP-R,10,0,positive,10
pfbid02GoobwhDutyZTGDrYwAsWjTPx85yXS6DzKNzc57zAFuytJUG1R3ncSuh662VmeaXXl,NVIDIA AI,0,29,0,0,0,0,0,0,29,1,"Announcing a new Omniverse extension by #NVIDIAInception member Kaedim.Using #AI, users can generate 3D models from 2D images, and integrate models into Omniverse, bridging the gap between asset creation and in-scene deployment.Learn more > https://nvda.ws/3YstadT",2023-08-10T23:00:00,[],https://scontent.fcai19-7.fna.fbcdn.net/v/t39.30808-6/366838097_673335891497362_406063589798677947_n.jpg?stp=dst-jpg_p526x296&_nc_cat=100&ccb=1-7&_nc_sid=730e14&_nc_ohc=BxvW_-3jKeoAX88ElLo&_nc_oc=AQkcCfkJXGTWkbZOu56QnkAPiNpMRHq65E6m9eo_jqa4ke21p7QDcaAvdrrAfk_SSSM&_nc_ht=scontent.fcai19-7.fna&oh=00_AfDW60D-1PV5wTwSp8nnZjchiQrdxYCCckXJAaOjGyzQqg&oe=64E4015C,https://www.facebook.com/NVIDIAAI/posts/pfbid02GoobwhDutyZTGDrYwAsWjTPx85yXS6DzKNzc57zAFuytJUG1R3ncSuh662VmeaXXl?__cft__[0]=AZXCsZrft0vSODHCevkxEmVnpiOQsbSXroPWUlG4BIM1kFZRGQjqzUCfUbvvk05iwGDHu-g_pCKVvRqL7i5RiW-vT2M9hPi8D-hBvtSoBH5GSrbA9ABLlG6vF3fpJQufIRsVyA6rWp0cvFM0Z6581PvXwVxC1c2O0yL9B4-YSv7Z6Z0Eb7XnvGCmqx9DQfWuHkqaDQ2jRdH-zvfBwGKS0-YJ&__tn__=%2CO%2CP-R,29,0,positive,29
pfbid09yvEkFD3zHpXuY1T3NgBKj8akg79hEUYxhYooWZsLqnHU4htwzfrRWdJvcLBDB7pl,NVIDIA AI,0,7,0,0,1,0,0,0,8,0,Today is the last chance to win a seat at an upcoming NVIDIA Deep Learning Institute (DLI) Workshop by joining the NVIDIA Developer Program during #SIGGRAPH23.  Join now: ,2023-08-10T22:00:00,[],https://external.fcai19-7.fna.fbcdn.net/emg1/v/t13/13663536774047275994?url=https%3A%2F%2Fprod2-sprcdn-assets.sprinklr.com%2F50276%2F0468226d-05aa-47e5-ab3a-b12a22daadb2-888298465%2Fnvidia-training.jpg&fb_obo=1&utld=sprinklr.com&stp=c0.5000x0.5000f_dst-jpg_flffffff_p500x261_q75&ccb=13-1&oh=06_AbHE5u6nr_ou4tCraomlrveXwgVQkY-t1tFMDFggQlVXCw&oe=64E0806E&_nc_sid=dbad39,https://www.facebook.com/NVIDIAAI/posts/pfbid09yvEkFD3zHpXuY1T3NgBKj8akg79hEUYxhYooWZsLqnHU4htwzfrRWdJvcLBDB7pl?__cft__[0]=AZUwwCrqw-9hW4tjZTtodxFvVGVNQyYx9Ngr3tudAvlz7i2wfhwHAR0In1u17qXfnzkHsANmAoKgXin8zQOfNdUD-eCnu_IA1To4kp4sp-1SEXcL5SdMrokxq2908TejPJlVidyKy_9NhtFHliuSkyHFl1Dtr5Htxbc0KToP-exjyem2uPDk7f9kwB3TuA_sAJVMoCgTl6F78vRGI-73mpWz&__tn__=%2CO%2CP-R,8,0,positive,8
pfbid0NVWYfY2aEimWXV23gaSPSP6v5J2GGfprQSzgtK12cZkPoA99P4QjtmGGYtKpVntQl,NVIDIA AI,0,19,3,3,0,0,0,0,25,4,"How to better handle large, complex volumetric datasets? Learn about how NeuralVDB uses #AI enabled data compression technology - to reduce footprint by 100x - and allow you to interact and share datasets more efficiently. #SIGGRAPH2023 #NVIDIAResearch Research paper: https://nvda.ws/3qoT3PmNVIDIA at SIGGRAPH: https://nvda.ws/3YA6IzO",2023-08-10T20:10:00,['https://video.fcai19-7.fna.fbcdn.net/v/t42.1790-2/365461799_6181702048608210_1228031491738437470_n.mp4?_nc_cat=104&ccb=1-7&_nc_sid=985c63&efg=eyJybHIiOjU5NywicmxhIjo1MTIsInZlbmNvZGVfdGFnIjoic3ZlX3NkIn0%3D&_nc_ohc=4kUE1vK58BsAX9pz_Xw&rl=597&vabr=332&_nc_ht=video.fcai19-7.fna&oh=00_AfCMtqXrNwbdCipZuck5roXa1IW60WOzcHKrN_fq6WB5lw&oe=64E365BA'],https://scontent.fcai19-7.fna.fbcdn.net/v/t15.5256-10/363492061_620345413576198_5354630901382907913_n.jpg?stp=dst-jpg_s960x960&_nc_cat=108&ccb=1-7&_nc_sid=ad6a45&_nc_ohc=ep3lT0EOEHoAX9f2mxy&_nc_ht=scontent.fcai19-7.fna&oh=00_AfCFL5cb9i0XREwIx2I3hEWXYswOUQ6D0Wse2ZCg2xdsuA&oe=64E3730D,https://www.facebook.com/NVIDIAAI/posts/pfbid0NVWYfY2aEimWXV23gaSPSP6v5J2GGfprQSzgtK12cZkPoA99P4QjtmGGYtKpVntQl?__cft__[0]=AZXoK7RXohYfOU_CtU1YK1mB-tKPMj5NPVLccpF-qipYcj2bq4COftnlAFFy5_Y-gz5nRN7Z9O07yaMpwTc51mhA3hH2VAonCWOIBTb9hJ6PeME672DC_dUxsWgt0zfChMpEyQ_IXQuqvRAMgepi4Y3YPAPL0l5eIhQXfLY41_U6UbB2GMfVybWocL7cRdvTnoMQV9zfmMbWd3fdHDsXcWu6&__tn__=%2CO%2CP-R,25,0,positive,25
pfbid07VS7J7hDkp4rkAtGJUoZ46s6DnN9bkvudWbCfWZMx6Ga1XPj8vKyjbnCxMAj3EK7l,NVIDIA AI,0,8,0,0,1,0,0,0,9,1,"For #OpenUSD developers, building, profiling, and optimizing large #3D scenes can be a very complex process.ChatUSD is a large language model (LLM) agent for generating Python-USD code scripts from text and answering USD knowledge questions. #SIGGRAPH2023",2023-08-09T23:00:00,[],https://external.fcai19-7.fna.fbcdn.net/emg1/v/t13/2876678792928358982?url=https%3A%2F%2Fi.ytimg.com%2Fvi%2FGowdBDeNo2Q%2Fmaxresdefault.jpg&fb_obo=1&utld=ytimg.com&stp=c0.5000x0.5000f_dst-jpg_flffffff_p500x261_q75&ccb=13-1&oh=06_AbEzuIrhRqKZpbjPIojcs9EuQ3X8_LGHwrUIOwJFC5cTjA&oe=64DFFCC6&_nc_sid=dbad39,https://www.facebook.com/NVIDIAAI/posts/pfbid07VS7J7hDkp4rkAtGJUoZ46s6DnN9bkvudWbCfWZMx6Ga1XPj8vKyjbnCxMAj3EK7l?__cft__[0]=AZUSQcaqJuefeuYmcCuytOApgi9rmpAeZ48pZhgaGDgtJzDmfgNpRQnaUXzfnTVh6uNga4i7Nqhi4aZpyy3kjBH8zhOKfaMHf82McSykA36qmGO564g_4qk0oeXanlgp2wsmXLVbAv0IRnASKM5szKGr6yXuISijn05_bRI3-zFNcWW4p62eZqPsvW3xu2oHCSAIW-6LXwNg_DVc7Fe9M-64&__tn__=%2CO%2CP-R,9,0,positive,9
pfbid0k2Df65Jm48CtNtZv3tAhowjT86g5SK3uN6hmUKfMH8VkTiHnEkGaDeJAHcpbqq7ul,NVIDIA AI,0,23,0,0,0,0,0,0,23,1,"Professionals, teams, and creators can tap into the power of #AI to create high-quality audio and video effects, including expanded features for video editing, with NVIDIA Maxine. #SIGGRAPH2023",2023-08-09T22:00:00,[],https://external.fcai19-7.fna.fbcdn.net/emg1/v/t13/10092321760111086795?url=https%3A%2F%2Fblogs.nvidia.com%2Fwp-content%2Fuploads%2F2023%2F08%2FMaxine-Copy.png&fb_obo=1&utld=nvidia.com&stp=c0.5000x0.5000f_dst-jpg_flffffff_p500x261_q75&ccb=13-1&oh=06_AbFnUL7TemnZ0soF3p9yl1fQUefvEc247Eu4OxezfHhqJg&oe=64E08B57&_nc_sid=dbad39,https://www.facebook.com/NVIDIAAI/posts/pfbid0k2Df65Jm48CtNtZv3tAhowjT86g5SK3uN6hmUKfMH8VkTiHnEkGaDeJAHcpbqq7ul?__cft__[0]=AZXnthKUIs0PO-t4MCZzg0VcpnHS1dxRa_HsFsqkXx_mkGeaDvkVaf5u4tUYNdt9ZiXMHk4RZZIJHpO-TihVf62EpL_PijQNpp01Jhvcis2EUkS8LSt-_JwpOhtqtepyAStp83YGfJOWfurkzyf9UtsylxGhju_qif2a0d3WDVDnjd6nQ6JT0iY4nz0tnQveffHWfLrG2STizpiKcYbO9hAA&__tn__=%2CO%2CP-R,23,0,positive,23
pfbid0maeLceb3uXeHsKM2p7Mo5Mux3MApAwPjj1oqXmKPuZwZhF9d7T19c1Y9AB47zYs3l,NVIDIA AI,0,5,1,0,1,0,0,0,7,0,Join the Grandmaster Series for an exclusive look at how NVIDIA AI’s team of #machinelearning experts built a state-of-the-art recommender system to win Amazon.com's 2023 KDD Cup. Don't miss out. ,2023-08-09T21:00:00,[],https://external.fcai19-7.fna.fbcdn.net/emg1/v/t13/16816991663146949883?url=https%3A%2F%2Fi.ytimg.com%2Fvi%2FIECznzY_Ko4%2Fmaxresdefault.jpg&fb_obo=1&utld=ytimg.com&stp=c0.5000x0.5000f_dst-jpg_flffffff_p500x261_q75&ccb=13-1&oh=06_AbED0vrtYA0ErCWgcLNemZesh7jaza6ms8IW9VqWxHT3XA&oe=64E04FFC&_nc_sid=dbad39,https://www.facebook.com/NVIDIAAI/posts/pfbid0maeLceb3uXeHsKM2p7Mo5Mux3MApAwPjj1oqXmKPuZwZhF9d7T19c1Y9AB47zYs3l?__cft__[0]=AZVnmht4O0teHaTIXCQKcKXkji1gvCe8AWGUzgi5Rl18cDkOXH4b4KgA5-qon7wsOEz108XibCI2Db6MQpx4MI1p0oGbwQHizxNUekMRCd--8cHYUWSN1ldIh0eJuLr01w3zANtVDTK6SHMkChjQ5VOWHt5SEyVp0vLJJFfUw_AlZ9iLjfcdVqJrGc-nT-dosqwhkUxrDL35w0p-eDu41kp3&__tn__=%2CO%2CP-R,7,0,positive,7
pfbid034mQQ1B9uhkdMiSyHJ8oizVs4QdcAE56SMEd9BnjRLcGPDU8gJmP4axmYv1bbq9snl,NVIDIA AI,0,8,1,0,1,0,0,0,10,1,How can you transform sports videos into character motion?See how this #GenerativeAI system by #NVIDIAResearch can output realistic tennis action without expensive motion-capture data. #SIGGRAPH2023https://nvda.ws/3OwelTj,2023-08-09T20:01:00,['blob:https://www.facebook.com/e12eb4fa-4106-4220-8fd9-3857a91afed8'],,https://www.facebook.com/NVIDIAAI/posts/pfbid034mQQ1B9uhkdMiSyHJ8oizVs4QdcAE56SMEd9BnjRLcGPDU8gJmP4axmYv1bbq9snl?__cft__[0]=AZUSSLqf5WOOYiVVRCMHRtEeSz6697PIVCwEliIgp5OAsxIfssTSA4TOtVfBpXTImy23GcYj8-4MzFtMv7BGJqqxu69PSQApSJNHP0-aCideVcs-8zGbyek4-RWd2wU_nFc56ag7dXYBCAGFQ_W5xv38L0dXz4jh0KPq4d1iXHeGfjAd2tz1C4pwIV2-SJxzHj8-ex_3dUywYbBxOCz8ERxp&__tn__=%2CO%2CP-R,10,0,positive,10
pfbid0YbrnwfCYeoaP2GwcAEtpm5AHtbXFhoHd1RQB8Qfm2JPJodf7sJ4Cz8UEJimQYKYNl,NVIDIA AI,1,18,3,0,0,0,0,0,21,1,"Managing software stacks, versioning files and data, and porting those over to a different machine can be difficult. With NVIDIA AI Workbench, users can streamline access to NVIDIA #AI software and hardware, wherever they work: ",2023-08-09T19:00:00,[],https://external.fcai19-7.fna.fbcdn.net/emg1/v/t13/5759200051811799679?url=https%3A%2F%2Fdeveloper-blogs.nvidia.com%2Fwp-content%2Fuploads%2F2023%2F08%2FAI-Workbench-Gen-AI-models.png&fb_obo=1&utld=nvidia.com&stp=c0.5000x0.5000f_dst-jpg_flffffff_p500x261_q75&ccb=13-1&oh=06_AbFkuvh8badJyTzTwu5Emry8SuiuIcRZllOQ4WEtQv2ROA&oe=64E09E26&_nc_sid=dbad39,https://www.facebook.com/NVIDIAAI/posts/pfbid0YbrnwfCYeoaP2GwcAEtpm5AHtbXFhoHd1RQB8Qfm2JPJodf7sJ4Cz8UEJimQYKYNl?__cft__[0]=AZWkbNGPw9285aEjb564TvywfpTSeiwA-ekmUqoHCKnVA0fDFQdX2FKIx5zvnxyKNB6_KDi646SkECWrWfOj-vn6-zP-53lgI_aRXP9-euWw6DAIhieKu7JBRVCIRbmG1DSoelABkIz-2O3oLVIWuWBTpg8S2pUBDFFtgJwsmnABqh1g0fN5vOSxglVXrqji-N2sTkPzyWsWiiNfsx33_j06&__tn__=%2CO%2CP-R,22,0,positive,22
pfbid02dDeA7Numanc1aEM1s9bRMDCNUwgPyS75jcuxofgHmK2sVDEyieMLsZv4GVcb6jznl,NVIDIA AI,0,6,0,0,1,0,0,0,7,2,"In celebration of #SIGGRAPH23, we are hosting a giveaway for all new NVIDIA Developer Program sign-ups until August 10. Join now for a chance to win a ticket to one of our upcoming DLI workshops. ",2023-08-09T18:15:00,[],https://external.fcai19-7.fna.fbcdn.net/emg1/v/t13/15569659336516417127?url=https%3A%2F%2Fdeveloper.download.nvidia.com%2Fimages%2Fog-default.jpg&fb_obo=1&utld=nvidia.com&stp=c0.5000x0.5000f_dst-jpg_flffffff_p500x261_q75&ccb=13-1&oh=06_AbHeI8t8D8mQUxq2Dcm1Mklv_cmW8rK1zES32iXo3uHJuA&oe=64E09AAB&_nc_sid=dbad39,https://www.facebook.com/NVIDIAAI/posts/pfbid02dDeA7Numanc1aEM1s9bRMDCNUwgPyS75jcuxofgHmK2sVDEyieMLsZv4GVcb6jznl?__cft__[0]=AZVNJTUNhLUfarBrWp7mlI-QaNCLQyekKuR9HG0tt1AZPN51BslpsU9cTghu3KiGRFEOTqiqO_yaMnIVpksc8BRnS9ijj319Dudvpj5FmZldNFCK9y0Sf8vhxYSNef1p7ZHz7ESHOfzUMcBTbpXQyA7Cbrba7BvvUz43mw-h3XHjBcWmqHC2ayVvhlhHvPc9NbZ3yjQuGINzmnfpnhOQCoHY&__tn__=%2CO%2CP-R,7,0,positive,7
pfbid027ywFJZ98ndevRhMkhmwAMQYCRZGpzvxBTDCX2zwqQxVNCBCb8BRuYHmimGVCjTVXl,NVIDIA AI,0,15,2,0,2,0,0,0,19,1,Thank you SIGGRAPH and Real-Time Live. We greatly appreciate the award for  Best in Show for #SIGGRAPH2023 for our Text2Materials demo by the #NVIDIAResearch team. See the demo: https://nvda.ws/45mCIcC,2023-08-09T06:07:00,[],https://scontent.fcai19-7.fna.fbcdn.net/v/t39.30808-6/363431037_672320144932270_988220795565963971_n.jpg?stp=dst-jpg_s1080x2048&_nc_cat=100&ccb=1-7&_nc_sid=730e14&_nc_ohc=tyfzLTOg1zsAX_osWWx&_nc_ht=scontent.fcai19-7.fna&oh=00_AfDIBYt9TTR6Mo56C3aFUeU7Eiq2OzEqka0WajEnF2F6_Q&oe=64E42397,https://www.facebook.com/NVIDIAAI/posts/pfbid027ywFJZ98ndevRhMkhmwAMQYCRZGpzvxBTDCX2zwqQxVNCBCb8BRuYHmimGVCjTVXl?__cft__[0]=AZWxle9yw9vV7hwFek4sd4KIDhXV7C_BHLnCbVCLIKEPFcUDxdsnOCtGHzofwtgn60pM8IeOTf63qTMMYn7a8SUiCXVOPpOUlliRamZ82aCt6J4aAQ7L9Kp93vlSzwY2TBrR2EwkZAYE-4qSIOApchCW9NEKPa8BAMVd1719TxW7VrLSServEvFHdd2s56hzDG3fDm8Hz_2S8QV1IAKg8AKq&__tn__=%2CO%2CP-R,19,0,positive,19
pfbid0tkjb6p8NzUApDU2Cmd3Bn7S1yFDdcWahNPfvuTzvhEAfnc6fBQxPRpRdhpN6TC8Xl,NVIDIA AI,0,17,1,0,1,0,0,0,19,6,"Researchers will showcase #AI techniques to rapidly create and edit materials, accelerating 3D workflows. Check out the capabilities debuting in NVIDIA Picasso in the future and vote at Real-Time Live. nvda.ws/3QDB2r0#SIGGRAPH2023",2023-08-09T02:08:00,['blob:https://www.facebook.com/704b2e3f-e542-4c6b-905d-d792863a5a7e'],https://scontent.fcai19-7.fna.fbcdn.net/v/t15.5256-10/365497209_952756585963236_6700484542470781169_n.jpg?stp=dst-jpg_p180x540&_nc_cat=105&ccb=1-7&_nc_sid=ad6a45&_nc_ohc=EEJa_32HJJIAX_N4O48&_nc_ht=scontent.fcai19-7.fna&oh=00_AfD1-5VTce1SEUPLFAdBwxz8BYv-Np9z-xrFTwP1Rt4Z_w&oe=64E37A0E,https://www.facebook.com/NVIDIAAI/posts/pfbid0tkjb6p8NzUApDU2Cmd3Bn7S1yFDdcWahNPfvuTzvhEAfnc6fBQxPRpRdhpN6TC8Xl?__cft__[0]=AZVtMPg0Emy0opFGp9KbiarnUm3HRcL8pV3uUk_0v4V0Jh0BdjSE4fJx87HOKs4fBVZA0d2bN-jAJ1MTSDMiw8Xm88RCL4iNk9ea3CBijoVoX5Rqcr93kKZAflwITKOpBc8D35FVxjxkiVifsvot0LcbaPd-7d6S5U61HuD9cqsuiQvm9DhQmfRmoBR8hOBQA4HSkcw5iyma-rK79L1LY-mT&__tn__=%2CO%2CP-R,19,0,positive,19
pfbid02Jv7sFStPqBocYo6oTjxwCsikcsxBafnPyNRzQorU6S9mDokaSuM7n88vtCdpz6Bil,NVIDIA AI,0,18,3,2,0,0,0,0,23,2,"Shutterstock to develop generative #AI services using NVIDIA Picasso, including 360 HDRI generation for quicker 3D scene development. nvda.ws/45dZ67W#SIGGRAPH2023",2023-08-08T23:10:00,['blob:https://www.facebook.com/03f4fe9f-0502-4e36-b42e-da1d4fce35fe'],https://scontent.fcai19-7.fna.fbcdn.net/v/t15.5256-10/351184882_213691514658263_7906735540674598799_n.jpg?stp=dst-jpg_p180x540&_nc_cat=104&ccb=1-7&_nc_sid=ad6a45&_nc_ohc=9rfxWbFGg0oAX_P12mt&_nc_ht=scontent.fcai19-7.fna&oh=00_AfAjCUbJu3EDoL5GSxcXg_TZATfMOUQ2DjfOL_G0nJIGwg&oe=64E42142,https://www.facebook.com/NVIDIAAI/posts/pfbid02Jv7sFStPqBocYo6oTjxwCsikcsxBafnPyNRzQorU6S9mDokaSuM7n88vtCdpz6Bil?__cft__[0]=AZWivaqKYPyyrTBjNXBlO98LP1ogfLVWeFt5Hv7vErlOU92ta61IyGw-aQrnaBYMSsqUfjZtw93oq42za8a7fuoGCM5mGCw8Ovu-FT_wqjjHkGg24PxSpGHclGCnbW_Ebs5U1UKH3bkQYxfW1BtwljFCmgs2OApX48wnLDPxJttKeKix5f5ne3VW_ZZ25Ae250p4sIb5hS_915bkuhnkqxqx&__tn__=%2CO%2CP-R,23,0,positive,23
pfbid0YKoffsFgBeFRJ87VDJQ4bzDiWpXLcihrHstR6zJszrX7gDANYajiHyw2f7EBTpyFl,NVIDIA AI,2,15,2,0,1,0,0,0,18,2,Learn how Writer used NVIDIA NeMo to build powerful #LLMs at scale and help hundreds of companies create content. #SIGGRAPH2023,2023-08-08T22:00:00,[],https://external.fcai19-7.fna.fbcdn.net/emg1/v/t13/10455786637075552992?url=https%3A%2F%2Fblogs.nvidia.com%2Fwp-content%2Fuploads%2F2023%2F08%2FKV-for-Writer-x1280.jpg&fb_obo=1&utld=nvidia.com&stp=c0.5000x0.5000f_dst-jpg_flffffff_p500x261_q75&ccb=13-1&oh=06_AbFveWUpxigvkiV-_zMJX777k0UdhJA3KQMZCjw_KQqs7Q&oe=64E09BEC&_nc_sid=dbad39,https://www.facebook.com/NVIDIAAI/posts/pfbid0YKoffsFgBeFRJ87VDJQ4bzDiWpXLcihrHstR6zJszrX7gDANYajiHyw2f7EBTpyFl?__cft__[0]=AZVYjC4JBs3VKiyGpfSIESuYDMhE1U1MdlGPqBgmKU3_FFOI-bMHclN4g4ZQbT46pQrhRgW1QbH--eAt5oAAw801P1VeGYCHAQ9ZS_C4N8f2Gft4VZKZfqsaC1ZOWJwBLEKA8uBm2wpUgPpNM6cecb4tvYtJVyfAjaRykBqQviJEWMZxdJz0CzMHSvffkNx3gK5mmwyCS-qNEuhC-z9kp2ff&__tn__=%2CO%2CP-R,20,0,positive,20
pfbid0289SM3RSdPxZdbmTJb1iA4dSi2BhFkqVLHhZ5kcTDnwDqpu6XQnb7Hojc3wLdjv87l,NVIDIA AI,7,29,0,0,0,0,0,0,29,3,"Introducing NVIDIA NeMo Data Curator, a scalable data-curation tool that enables developers to curate trillion-token multilingual datasets for pre-training #LLMs.  #SIGGRAPH2023 https://nvda.ws/3YsGu1R",2023-08-08T21:30:00,[],https://scontent.fcai19-7.fna.fbcdn.net/v/t39.30808-6/366275140_672129204951364_1249199869588148780_n.jpg?stp=dst-jpg_p526x296&_nc_cat=102&ccb=1-7&_nc_sid=730e14&_nc_ohc=8qn2IHw9p24AX9EWH0p&_nc_ht=scontent.fcai19-7.fna&oh=00_AfAxFlzEFHT3o9gy5uAzS3WlplcvNEpemEfFSD_IXL8m-A&oe=64E3B65E https://static.xx.fbcdn.net/rsrc.php/v3/yw/r/8iuTX4LlGZO.png https://external.fcai19-7.fna.fbcdn.net/emg1/v/t13/17070584508939441270?url=https%3A%2F%2Fdeveloper-blogs.nvidia.com%2Fwp-content%2Fuploads%2F2023%2F08%2Fnemo-data-curator-featured.png&fb_obo=1&utld=nvidia.com&stp=c0.5000x0.5000f_dst-emg0_p98x98_q75&ccb=13-1&oh=06_AbFUP-s3hdjvnh9W3dH-Wdj_7_VNYeQM-k1X7sX528D5Zw&oe=64E076BD&_nc_sid=dbad39,https://www.facebook.com/NVIDIAAI/posts/pfbid0289SM3RSdPxZdbmTJb1iA4dSi2BhFkqVLHhZ5kcTDnwDqpu6XQnb7Hojc3wLdjv87l?__cft__[0]=AZU4g3WB90Pvu0kVPN4JtttnZLYhIEVKb48bt63qUJ0bvI5iNCFTkcUiCfxVrnU-cfNeXcgYZwKSC04wJRtzw7i049UtTE3vIoxigxnqG-cviGZeYnA9oSr7knmKWYoJCMST9azPyp7g5815FREO__sg8rIfWIdrl6OXik1Uu-RgrpBPA547yWo1ekqGfeDhpHq07ABY6z-nfi6G8P_i9NuA&__tn__=%2CO%2CP-R,36,0,positive,36
pfbid0LhKjUC1aaAt8QQTxM9efH1kuqaFF7KFg8sVkH2mT5qGEA1E2dVBSuGjUaHYMdCHpl,NVIDIA AI,0,20,0,0,0,0,0,0,20,1,Triton Management Service (TMS) enables large-scale #inference deployment with high performance and hardware utilization. It will soon be available exclusively with NVIDIA AI Enterprise. Learn more and sign up to be notified when available: https://nvda.ws/3rTc4cX #SIGGRAPH2023,2023-08-08T21:00:00,[],https://external.fcai19-7.fna.fbcdn.net/emg1/v/t13/3567283771513898073?url=https%3A%2F%2Fwww.nvidia.com%2Fcontent%2Fdam%2Fen-zz%2FSolutions%2Fai-data-science%2Fproducts%2Ftriton-management-service%2Ftriton-management-service-og-1200x630.jpg&fb_obo=1&utld=nvidia.com&stp=c0.5000x0.5000f_dst-jpg_flffffff_p500x261_q75&ccb=13-1&oh=06_AbEZy_uORvBTT0QUj51uLnTbdb1QZYSlTxajAt6McAfmqA&oe=64E00A8F&_nc_sid=dbad39,https://www.facebook.com/NVIDIAAI/posts/pfbid0LhKjUC1aaAt8QQTxM9efH1kuqaFF7KFg8sVkH2mT5qGEA1E2dVBSuGjUaHYMdCHpl?__cft__[0]=AZVllHfKE4_LQkEbTEb-Mp7SzrnYNlhJ_k9wRtThQ6zPLGy2mI93hJU787yqUL-CJAHBwitHZL9Ajmt0EJSmDe0N_b8yf6EUZ3NUd73eL5-fpb47_AxcctU4vlTE82ZOiAr6iQUNI1dB96dpYJPh3JeogVTcN7ld8a2QOuncZiex-C2e50EzMq-CdZS-L9Zfg4fR6BGwOif7aHNHn1yooqla&__tn__=%2CO%2CP-R,20,0,positive,20
pfbid02dN3taz2R4wAvaP2N6hYY7rkqYhQxzz8m8BzxgcB9z8hZSAzK5w5qtv3GzQQ9vZw4l,NVIDIA AI,1,21,3,0,0,0,0,0,24,3,"Announcing general availability for NVIDIA NeMo, an end-to-end framework that enables organizations to efficiently build, customize, and deploy #LLMs at scale - anywhere. #SIGGRAPH2023 https://nvda.ws/44V2bKs",2023-08-08T20:30:00,[],https://scontent.fcai19-7.fna.fbcdn.net/v/t39.30808-6/366290421_672097268287891_306151300426429554_n.jpg?stp=dst-jpg_s960x960&_nc_cat=101&ccb=1-7&_nc_sid=730e14&_nc_ohc=GpFosEeZ1R8AX_GnJIR&_nc_ht=scontent.fcai19-7.fna&oh=00_AfBjAVIdUR3Cybl0gqHJWfn2EQzIf6W-mQy2j1_IPctJDA&oe=64E31FF3,https://www.facebook.com/NVIDIAAI/posts/pfbid02dN3taz2R4wAvaP2N6hYY7rkqYhQxzz8m8BzxgcB9z8hZSAzK5w5qtv3GzQQ9vZw4l?__cft__[0]=AZV90qnTxO8tUKXoIQFo1IElJskUjeDqWJO9OUVgIMdjbC1WeNfSldXVqsfPl4SEQu-7KzNegzouTkuwaHVrPuzWbbW5un7v8efOo2Rdw_TYiKsSz5wYvdU65CZVeHN6lAxlv_-L8hNdiTVTxugYxXCoRcRWKX2c9ItoVTs5b7uhFa7PEQlv3XkBU0EeT_pULdFOTd4wzSugTc4ThNS3zClc&__tn__=%2CO%2CP-R,25,0,positive,25
pfbid0JFExSX6nmAHxLP941XiucemycR7FUpWbFxaez9ZUGQsqqUMn1AMBZQrWTg4nzgaFl,NVIDIA AI,52,797,0,0,0,0,0,0,797,51,"Today, NVIDIA and Hugging Face announced that #NVIDIADGX Cloud will integrate into the Hugging Face platform, empowering millions of developers with #generativeAI supercomputing for large language models and advanced #AI applications. #SIGGRAPH2023 Learn more now: https://nvda.ws/43Yb3xO",2023-08-08T20:00:00,[],https://scontent.fcai19-7.fna.fbcdn.net/v/t39.30808-6/366231460_672079961622955_419383214396687568_n.jpg?stp=dst-jpg_p526x296&_nc_cat=110&ccb=1-7&_nc_sid=730e14&_nc_ohc=Czhez6bTW4gAX9eIHsT&_nc_ht=scontent.fcai19-7.fna&oh=00_AfDSrw0CLvNCkOaJWuG9l7imFLznmuNzuCjXcBPbmOgyDg&oe=64E46874,https://www.facebook.com/NVIDIAAI/posts/pfbid0JFExSX6nmAHxLP941XiucemycR7FUpWbFxaez9ZUGQsqqUMn1AMBZQrWTg4nzgaFl?__cft__[0]=AZUWkgwgojrWyc9xVQDFY47ENfg9wwl9Y_ZmNAg7w1d7oPkP2b8X9oa-YdE7uTTYVgcCFXzEek40Tw_MgtcAPAhDJqrhUt_RHFMNLIUZtaVI_QbkfF_oq7Wq932ehXDguy9i2FVAFuI2xnWBasm0O0yIVlDP8MMJ8r88Uw5M4AmXXlM9U_WS5Rr5KLHos1Iydr3wy7GneV7gmeYlMkXovxsk&__tn__=%2CO%2CP-R,849,0,positive,849
pfbid0pssXLkmXKYcYAm75zhoWzqGX4wjYf8Y919hXH3dMZ2MADoHXZTCTvKjm9VYS6XSel,NVIDIA AI,28,385,0,0,0,0,0,0,385,7,"Announcing NVIDIA AI Workbench, a unified, easy-to-use toolkit for developers to quickly create, test, and customize pretrained #generativeai models and #LLMs on a PC or workstation — then scale them to virtually any data center, or cloud. #SIGGRAPH2023  https://nvda.ws/45jkuc9",2023-08-08T19:30:00,[],https://scontent.fcai19-7.fna.fbcdn.net/v/t39.30808-6/366349774_672064831624468_6722565802024860079_n.jpg?stp=dst-jpg_s960x960&_nc_cat=111&ccb=1-7&_nc_sid=730e14&_nc_ohc=2AwkWyRgLiAAX_a4vZR&_nc_ht=scontent.fcai19-7.fna&oh=00_AfDgMgTOcMjjF2DBlzfM2QrAcb5GRQquvNiE7F7xdEFfkQ&oe=64E3B9F0,https://www.facebook.com/NVIDIAAI/posts/pfbid0pssXLkmXKYcYAm75zhoWzqGX4wjYf8Y919hXH3dMZ2MADoHXZTCTvKjm9VYS6XSel?__cft__[0]=AZX1NemO2zKCTW8nfq0f6R4UgnJOwmCmVPxr9Dz2sRjNubSCMiyI9SEYAd68c8rjWDl2PHpYT1lnPLJT9LhUELspsFgf8h7tp-KdZIAEIVIAx3jazQ9koMczQEEztN-xdz4gaOZVLNDjydyWUMdo5diWe8HAh7JB4ISmo1K_fgEb5DEFDAL_i_KedV2CUlrC4O481kLQh0hQBZVM6DNc_Yyh&__tn__=%2CO%2CP-R,413,0,positive,413
pfbid0RrERe8MqMne1dUDHxVECvkerLEMeZvHEiGU7S3C8byBBo8c7iBZYXSteusMwSsjwl,NVIDIA AI,0,18,1,0,1,0,0,0,20,3,Work confidently knowing your #AI workloads are safe while your data is in use. Learn more about how confidential computing with NVIDIA H100 #GPUs enables unparalleled security for AI workloads. #confidentialcomputing https://nvda.ws/3Kv9TD5,2023-08-08T00:38:00,[],https://scontent.fcai19-7.fna.fbcdn.net/v/t39.30808-6/365757952_781346697331467_455935135868615315_n.jpg?_nc_cat=104&ccb=1-7&_nc_sid=730e14&_nc_ohc=L7QypRfnS3cAX-2uB7-&_nc_ht=scontent.fcai19-7.fna&oh=00_AfCi6Z-yzGoSH4eA_B9liSsIueclEr19hmaaa2lDZYAaHQ&oe=64E4749D,https://www.facebook.com/NVIDIAAI/posts/pfbid0RrERe8MqMne1dUDHxVECvkerLEMeZvHEiGU7S3C8byBBo8c7iBZYXSteusMwSsjwl?__cft__[0]=AZVavnO0jvWtx2w3AkvF_1fG1AxS2EfsShlpGZtpsSr1XAXs9DOXl9UGro8aATsYOGUXCo6JIfAvqAd_C6zRzYjJIVLZCt_xqAF-RDLw-wp1msvJZ8LPfBf72iEb6O-4KusEvISsoYcLQlUfxwporVFeuTu3O7nYo6WObRKSf_uybE3d3YBSmANeD9QTizC4knYadgJbOVz44Lioics6gIHCobl7QlnuF_1E-bSFaaNJDT_W5d8ZWnDTKvo6V4jcxRQ&__tn__=%2CO%2CP-R,20,0,positive,20
pfbid0K6AhNYrvWhsn8C41kb4ZVKMjws5cTUDaTjRdSckydKUTbt7bqcwaDd4E67akgRztl,NVIDIA AI,0,11,1,0,1,0,0,0,13,1,Leading retailers are leveraging #AI to deliver better shopping experiences—both in stores and online. Learn about the most important AI use cases in retail today: https://nvda.ws/3DS41Qh,2023-08-07T21:00:00,[],https://scontent.fcai19-7.fna.fbcdn.net/v/t39.30808-6/366315075_671490358348582_5271279439949583918_n.jpg?stp=dst-jpg_p526x296&_nc_cat=100&ccb=1-7&_nc_sid=730e14&_nc_ohc=2cZJ_aT8P_oAX9IikPx&_nc_ht=scontent.fcai19-7.fna&oh=00_AfCSB0eypHNsC3fwhuW4Swio7UeXzVDrPnw1P3iZYpuR-g&oe=64E4215F,https://www.facebook.com/NVIDIAAI/posts/pfbid0K6AhNYrvWhsn8C41kb4ZVKMjws5cTUDaTjRdSckydKUTbt7bqcwaDd4E67akgRztl?__cft__[0]=AZW2VcqSaia62GxiN-MYV-JqX1VV39K1Y_QFnUAoO4kPXHWWBun6ljsEd_Wol9eHoi_Yfs_vxN-hxIePBShkY7hJawNOHc6Ef8Cba1oU_o4ry-JEQ_A_GU9pMhc-XZ9W2RM4C_1IVkyajp4e3WqtBlj-wpJ9LxJdrCiEJrCO9BmzuKzdOqv64sjhni17WXsLsnyVF31evseQLXpF_Y0pHBYg&__tn__=%2CO%2CP-R,13,0,positive,13
pfbid02msMS9foWMVAs33g9ctLxbvsCiwuj8hrWyU31JwN7r3Jq7V9RsrvVkaumDo2RiWJpl,NVIDIA AI,0,17,1,0,1,0,0,0,19,2,"Come see how our researchers are conducting #AI-mediated 3D video conferencing across several displays, including a 3D Looking Glass holographic display.Experience this hand-on demo at #SIGGRAPH2023. NVIDIA Emerging Technology Booth #129",2023-08-07T18:16:00,['blob:https://www.facebook.com/3db9bfb5-6331-459f-9460-3a1b4c86e0d5'],https://scontent.fcai19-7.fna.fbcdn.net/v/t15.5256-10/351141072_6427659313976591_2161546359377793491_n.jpg?stp=dst-jpg_s960x960&_nc_cat=110&ccb=1-7&_nc_sid=ad6a45&_nc_ohc=ezegO9F3nysAX-gaYNm&_nc_ht=scontent.fcai19-7.fna&oh=00_AfDsSC27oBveu_C1bDnPEgkZqEtBW0h_fyZEi9yMRxnahQ&oe=64E42C92,https://www.facebook.com/NVIDIAAI/posts/pfbid02msMS9foWMVAs33g9ctLxbvsCiwuj8hrWyU31JwN7r3Jq7V9RsrvVkaumDo2RiWJpl?__cft__[0]=AZWCsMNIY6GKTt_mAghRiVOgukZ6_HBmP2WcoyoQYlYO2Pia_ryTYosg93eLTbeC5rNHZiRORwhI-UHSXFb4LYqYWcA1P2cdeGafc4JEyYPmiQ9QhQvb3zNUxkn0BYpuKOwb3Hkjf1B1uDiVAKrAUUx9OjQzxPDAtGap-C3uOxwP9FIyGviNgqDEZ8rlwv4lNY3ZAGNf8vpfEiOPHynDolwW&__tn__=%2CO%2CP-R,19,0,positive,19
pfbid02LRNt7NvKbbCCjEtF5VNrCovPgFhCncdWmTJDays3n52eHqYWaHhRhzbHhQhCzqs3l,NVIDIA AI,5,37,0,0,3,0,0,0,40,2,"Learn about #promptinjection vulnerabilities that the NVIDIA AI Red Team identified, and how you can design more secure #LLM enabled systems to avoid them yourself: https://nvda.ws/44UFndY",2023-08-05T00:00:00,[],https://scontent.fcai19-7.fna.fbcdn.net/v/t39.30808-6/364125477_669801988517419_2304699018344538498_n.jpg?stp=dst-jpg_p526x296&_nc_cat=108&ccb=1-7&_nc_sid=730e14&_nc_ohc=pTOY597EY8AAX9uz_mC&_nc_ht=scontent.fcai19-7.fna&oh=00_AfBe0qi3aJpr9VAJF6fic30ENQ5hQG1vMolnXt8YWluI9A&oe=64E4215B https://scontent.fcai19-7.fna.fbcdn.net/v/t39.1997-6/106702127_953852515077106_5584524183393874628_n.png?stp=dst-png_p403x403&_nc_cat=1&ccb=1-7&_nc_sid=0572db&_nc_ohc=9l7U00qSXcYAX_ALbh5&_nc_ht=scontent.fcai19-7.fna&oh=00_AfA8a9i_Selw39srPzhm_xpFg9Axpb4-0Ei4-sc6H-mmQw&oe=64E4364E,https://www.facebook.com/NVIDIAAI/posts/pfbid02LRNt7NvKbbCCjEtF5VNrCovPgFhCncdWmTJDays3n52eHqYWaHhRhzbHhQhCzqs3l?__cft__[0]=AZVtepN2BqnZS1FFwn6VA5uGcorylPr9snbsknIGrzy89D-dq6ht-O1PtVnKegCD_9s_9XrOmUHmCPV57DYiIs0qRkDlK5ZfN_elpHFq-szutk_8Mod7xV4Piu8JYRMH_mSuAwje2eSiyMMkBuqj4YjSu5wc0c77I6VMj0p5tGqJLwvT1tuwYAuA4b3BI6H2CszMUNE-4wvSvTYUQY7dvV9c&__tn__=%2CO%2CP-R,45,0,positive,45
pfbid037AeWWp5fDLpWrQw4FPnVspiPLRMpqg3B2ZdTGAKUprdUKQUVPpqdajrr3v6VCQpLl,NVIDIA AI,1,9,0,0,1,0,0,0,10,2, Explore new theories for #3D models to represent reality.   Combining NDFs in Microfacet theory creates a flexible reflectance model to simulate surfaces efficiently and accurately. #NVIDIAResearch #SIGGRAPH2023 https://nvda.ws/3OI8UBR,2023-08-04T22:00:00,['blob:https://www.facebook.com/a9c9196e-2150-4c5b-a4e7-be25342a3799'],https://scontent.fcai19-7.fna.fbcdn.net/v/t15.5256-10/351460764_2483549838477002_6689483207232437683_n.jpg?stp=dst-jpg_p960x960&_nc_cat=109&ccb=1-7&_nc_sid=ad6a45&_nc_ohc=EfHfCdWo8hoAX8vWTZJ&_nc_ht=scontent.fcai19-7.fna&oh=00_AfAHtYMtBnTh39F3IjpONQfCo6BpWV5o2bLphYGDBxntNw&oe=64E4621C,https://www.facebook.com/NVIDIAAI/posts/pfbid037AeWWp5fDLpWrQw4FPnVspiPLRMpqg3B2ZdTGAKUprdUKQUVPpqdajrr3v6VCQpLl?__cft__[0]=AZWBSuPb6SI8krGWPpb6z7PR3sj2t_O5UVyR732fy5yhMTsjcsA9NO5ItnYDG2fZX621rfZC_qdNk6yAPYSWKlj0G-qez0aTd70mg2lJb_5E0P4qTEXC_A2g7TsBoOXn7ngF1A0kiKz20ZkDrbekHQLDcBS4W020peG3ODPf7nMRHXCZJ5z1tokMo_MDI64hAp8eftFVArJ70L9I8Os7MSM4&__tn__=%2CO%2CP-R,11,0,positive,11
pfbid031w3StAH6WFh91ZZE8aCkv3dbT46RvpQ9PrPEess4NEXxPPPypMn6CFpBVMNSvvZzl,NVIDIA AI,0,15,1,0,1,0,0,0,17,1,"AI unleashes rapid advancements in computing capabilities, ultimately revolutionizing art, music, design, film, literature, and more.Attend #SIGGRAPH2023 to learn what impact #generativeAI may have for our future. https://nvda.ws/3DI55Gv",2023-08-04T21:00:00,['blob:https://www.facebook.com/dac78f32-27e4-4c38-8849-a6cba2a301cd'],https://scontent.fcai19-7.fna.fbcdn.net/v/t15.5256-10/355825892_1299688514242327_6425997228607189561_n.jpg?stp=dst-jpg_s960x960&_nc_cat=104&ccb=1-7&_nc_sid=ad6a45&_nc_ohc=KfTBLonhOAkAX-QVAA9&_nc_ht=scontent.fcai19-7.fna&oh=00_AfCTAXi94VGGr5JSSdQ3PjAI_E0G5j43WPeJGpkw_QZNbA&oe=64E47682,https://www.facebook.com/NVIDIAAI/posts/pfbid031w3StAH6WFh91ZZE8aCkv3dbT46RvpQ9PrPEess4NEXxPPPypMn6CFpBVMNSvvZzl?__cft__[0]=AZUscx5IT4mDjPHTehkDwf1ucQ0S0aCBNUc5U80A8Se-jk8D3oYvXjfV1Af65amo7AOyAnB-mbkmq2WemCGhS2oAlkvH6xo-UIz2a_gyAaldWgj_NFVWlyCjAeUANF3lF24dlT626OlUkd4gdAzkpuZwFdhOXzYnllWOj2yoz6mNwo-gzca4Xh6Y56jU6JN90ralA79EoGLWVerAbbjGA0hr&__tn__=%2CO%2CP-R,17,0,positive,17
pfbid0NxA64zBam6C1unaCXCgikXBVV7XvL2tj8Y1ykXL3knD7k5aymavJDWsjMhamjVQml,NVIDIA AI,1,9,0,0,1,0,0,0,10,1,"After the NVIDIA keynote, don’t miss the details on groundbreaking #GenerativeAI advancements shaping the future of computer graphics.Led by @richardkerris, VP of Developer Relations. NVIDIA #GenAI Theater at #SIGGRAPH2023 Aug. 8: 10 AM - 6PM; room 404B https://nvda.ws/45hlm0H",2023-08-04T20:10:00,['blob:https://www.facebook.com/c735f495-16f6-4aac-a666-bc25e68baa9e'],https://scontent.fcai19-7.fna.fbcdn.net/v/t15.5256-10/364234501_594210539575383_3502226320548289852_n.jpg?stp=dst-jpg_p960x960&_nc_cat=102&ccb=1-7&_nc_sid=ad6a45&_nc_ohc=NUeAuaXMT-4AX8KDzJ_&_nc_ht=scontent.fcai19-7.fna&oh=00_AfD0g6f311Cz2U5BbFe54_AJ4DxaYWqZwVcsYKuQuKssMQ&oe=64E344A3,https://www.facebook.com/NVIDIAAI/posts/pfbid0NxA64zBam6C1unaCXCgikXBVV7XvL2tj8Y1ykXL3knD7k5aymavJDWsjMhamjVQml?__cft__[0]=AZV6UcA1TFBJjooqwr4SL2RncnDcUnJdqeDLYby7WTvXwB5rxj1tlgXaiJ9KG3_Sb1Mmuh8EfdXu3vXfrV1NknzHu5Iw6xKJmP74AyBRBsSGRBUPMh_o9SUSsO916GXklAKwO_uD7_qq9wyip2cRLYCOzN_qus7whsKicvPaNdvAszMY_f1g2x9ByCNUrGZSdyhoW__bNisnVdHjZTdKS2ZO&__tn__=%2CO%2CP-R,11,0,positive,11
pfbid02nUX1yhBqSyNGQManuj8DexvV7x8Y4FVXycJfJsySeokxPDSwjbEqim7L4V9XZW3ml,NVIDIA AI,0,23,0,0,0,0,0,0,23,1,Develop your technical skills in generative AI and 3D virtual world creation with new NVIDIA Training workshops. See the latest courses: https://blogs.nvidia.com/.../generative-ai-and-3d.../...,2023-08-03T23:00:00,[],https://external.fcai19-7.fna.fbcdn.net/emg1/v/t13/440254997096656545?url=https%3A%2F%2Fblogs.nvidia.com%2Fwp-content%2Fuploads%2F2023%2F08%2Fgen-ai-final2.jpg&fb_obo=1&utld=nvidia.com&stp=c0.5000x0.5000f_dst-jpg_flffffff_p500x261_q75&ccb=13-1&oh=06_AbGcZURFeP5M4GCbhUaR03iViSuum870sSc6LBYZqMPGZA&oe=64E04F2B&_nc_sid=dbad39,https://www.facebook.com/NVIDIAAI/posts/pfbid02nUX1yhBqSyNGQManuj8DexvV7x8Y4FVXycJfJsySeokxPDSwjbEqim7L4V9XZW3ml?__cft__[0]=AZU301HIKxiQvczroP-E9UAgRdDCqh5R6CyS0-RVmBQHO3WA83eyBA61TAbDgdIksmQy72WVqV5BtafxxLtoQGa9HKhj6v_0SguJak0ZUStw7tzg68T1MCMU9RkIHE6qXNYbg1xLEa2X-Yw0qpt6CRBP-oeEgZN8NRqgxwH3EAlSZC9hrXAIbsiA8U7N0xk2JY47YFgI7N6v4prqXTNCrVuT&__tn__=%2CO%2CP-R,23,0,positive,23
pfbid02t2uZTCodqJmyDb6BxwM6MRxPiPHa3UWFRnumN5nGF9Cgdbgs1ur5iyv7VcBR9kVal,NVIDIA AI,0,31,0,0,2,0,0,0,33,2,NVIDIA HGX H100 systems are now available on Lambda Cloud with 8x H100 SXM GPU instances on-demand for only $2.59/hr/GPU. Launch an instance while they last: https://hubs.ly/Q01ZS8gG0Read the full announcement: https://hubs.ly/Q01ZSfC90,2023-08-03T21:05:00,[],https://scontent.fcai19-7.fna.fbcdn.net/v/t39.30808-6/364105011_684179163724817_3084195870535299485_n.jpg?stp=dst-jpg_p526x296&_nc_cat=100&ccb=1-7&_nc_sid=730e14&_nc_ohc=4aG1d7T_2m0AX9plFOP&_nc_ht=scontent.fcai19-7.fna&oh=00_AfB9hP69LQH_P7gm-Uk__GfQf3Y8GRO61zZH_zHWApdXgA&oe=64E4703E,https://www.facebook.com/NVIDIAAI/posts/pfbid02t2uZTCodqJmyDb6BxwM6MRxPiPHa3UWFRnumN5nGF9Cgdbgs1ur5iyv7VcBR9kVal?__cft__[0]=AZW0lyupk0t1cFKjM2W3dx98_S1Z4nQ2Rpme5y_23JbvzOmTSPFxYLaayEHiGPRYkiEFcjn67axvEjAX_vg8YtJjYikpPO2kCAx9hczleTxQt2ch8R3QvinqxrOuHTh0gW-wE5txtkfVBfMCzio0VFCQ84oQRAbmaY7s7aUpefhtkesghzolFuTuaUgh9ajxondMQ0wPtr93lHm43BHhzuwbFpFD910Y-d5TmxnGZ2DM_D_jH1TojmoK4wvGuQq-yeE&__tn__=%2CO%2CP-R,33,0,positive,33
pfbid0SFAc2grWKND7J9qdK26GyFZu2H69iMF4FvgFb14N6UWmQjVr1UDf6c34MLQGLFaLl,NVIDIA AI,0,19,0,0,0,0,0,0,19,3, Build #3D scenes from a single input view based on the latest #NVIDIAResearch paper accepted at #ICCV2023.  This 3D-aware #generativeAI model can build diverse and plausible views.research paper: https://nvda.ws/3YjeH40project page: https://nvda.ws/3OgKSfT,2023-08-03T00:10:00,['blob:https://www.facebook.com/5a356400-c8c5-4243-bcf3-21317aa3d411'],https://scontent.fcai19-7.fna.fbcdn.net/v/t15.5256-10/364195984_682198213290320_5611941577018489103_n.jpg?stp=dst-jpg_p180x540&_nc_cat=111&ccb=1-7&_nc_sid=ad6a45&_nc_ohc=pB-gazicxRQAX-9HWBk&_nc_ht=scontent.fcai19-7.fna&oh=00_AfAjROBL5PxXilALMUP0WhR8YoyfqywI8hHTnPM6kAFQzA&oe=64E2F48A,https://www.facebook.com/NVIDIAAI/posts/pfbid0SFAc2grWKND7J9qdK26GyFZu2H69iMF4FvgFb14N6UWmQjVr1UDf6c34MLQGLFaLl?__cft__[0]=AZV9ttLYaf-OA6eet-jXFSPYnHori21AdcAk9Y-S21vaimFl5dBQ2Y0K59VchyZCRAVXamG8y3JFiKbdU_l9_Hs-lJgpk5NepryE8k00KOSYNNznxFbNHgfBwDc-fmPw3vAP7rzBO_s-x4IoHQwZFLA3Q-TKTUyWGAjg4jo_wBV5JwyCNMihVQDzgZsLm8jhDsU5YyFeyBDr_GP2aNXhiwtv&__tn__=%2CO%2CP-R,19,0,positive,19
pfbid02sjDQ18u3biv9VgVJ1kRvGiR6EHgWsBc57MwDz91sopTV4qDDbAPY2YV1BUvRDB9Dl,NVIDIA AI,0,15,0,0,1,0,0,0,16,4,"To address the challenges of city planning, developers are creating AI software and #DigitalTwins using synthetic data and #OpenUSD. See how SmartCow built a license plate detection extension with #NVIDIAOmniverse Replicator in this blog. ",2023-08-02T22:20:00,[],https://external.fcai19-7.fna.fbcdn.net/emg1/v/t13/9686519700292404876?url=https%3A%2F%2Fdeveloper-blogs.nvidia.com%2Fwp-content%2Fuploads%2F2023%2F07%2Fcars-license-plates.jpg&fb_obo=1&utld=nvidia.com&stp=c0.5000x0.5000f_dst-jpg_flffffff_p500x261_q75&ccb=13-1&oh=06_AbFBAis3dpeED2uEydTMQ9wVfEW7B7d9jdNF5lDDQpgjhQ&oe=64E02054&_nc_sid=dbad39,https://www.facebook.com/NVIDIAAI/posts/pfbid02sjDQ18u3biv9VgVJ1kRvGiR6EHgWsBc57MwDz91sopTV4qDDbAPY2YV1BUvRDB9Dl?__cft__[0]=AZW2PmYBJKX20symKFwyHFMddHC1dEwCHt8yPhEPWox4Lp36_-PxVD4haedHf6mZ87mq2NnPSE6tprlLuXBq9V9CeP4HYhAt3kigSkxxULZDRzQ4EU1Gnti1Xr7-3YzsOIYfNIaydN6yErV9nLpbUWpAD5ZiHi4HSIt_c2JiAWa2o0d0-KUHB2ruUkD1qXZuLmx75QDemcQIVM4lgLbMHPjQ&__tn__=%2CO%2CP-R,16,0,positive,16
pfbid031SDDpf2bR4rsxaqUoxxUGZ8LAK7HaGJdEPzvmto9PEEpGh2b7rRJiSEzHFJbmnzol,NVIDIA AI,0,18,1,0,1,0,0,0,20,1,Lowe's Home Improvement is reinventing retail with NVIDIA Omniverse and #AI to build #digitaltwins of stores to optimize merchandising and improve associate productivity. Watch now to learn more: https://nvda.ws/3OiBMiy,2023-08-02T17:00:00,[],https://scontent.fcai19-7.fna.fbcdn.net/v/t39.30808-6/364041459_668488101982141_8648998953056951845_n.jpg?stp=dst-jpg_p526x296&_nc_cat=101&ccb=1-7&_nc_sid=730e14&_nc_ohc=8Knt3V2FkwAAX9lLzGO&_nc_ht=scontent.fcai19-7.fna&oh=00_AfCwHA5vw2jh96fo7YJLK3DM7Upr--En1jem9hqhN6tPrw&oe=64E33C48,https://www.facebook.com/NVIDIAAI/posts/pfbid031SDDpf2bR4rsxaqUoxxUGZ8LAK7HaGJdEPzvmto9PEEpGh2b7rRJiSEzHFJbmnzol?__cft__[0]=AZUpfaxtWUw3N8p1CkpbzVaOO3ku1wFsd8MTL3BkQdU2_pdzfDKS8iUvoHSYoaFWC3L90ulSPSv_Pa4FxYMLJ52txuhiqN2AWHZeg8u6zHvpicGhcXA6-xtwJZjRiG4yP2b6rRK0KoK9WM5vUXKDc2xrj-C9T5tHnhW9JeFp_KzHPpBXXFRUp0XnYjIqp7FezLFYPJpnKcJFSeS9BKpkGnY1&__tn__=%2CO%2CP-R,20,0,positive,20
pfbid02mqiRQdUtRiUQsCBmgEuviBb9SFyFEJYJv3uGmVXRBfHszwk2z9ZFm5R7vXgf9sSsl,NVIDIA AI,5,20,0,0,2,0,0,0,22,1,"  Recent advances in #robotics and #AI have opened exciting new avenues for teleoperation, the remote control of robots to complete tasks in a distant location.",2023-08-01T23:59:00,[],https://external.fcai19-7.fna.fbcdn.net/emg1/v/t13/8546064294862570753?url=https%3A%2F%2Fscx2.b-cdn.net%2Fgfx%2Fnews%2Fhires%2F2023%2Fa-computer-vision-base.jpg&fb_obo=1&utld=b-cdn.net&stp=c0.5000x0.5000f_dst-jpg_flffffff_p500x261_q75&ccb=13-1&oh=06_AbH2bJRWdOasgQ1S1_-QH2ARgAmy0nn-BNwfJnATKsEt5A&oe=64E06483&_nc_sid=dbad39,https://www.facebook.com/NVIDIAAI/posts/pfbid02mqiRQdUtRiUQsCBmgEuviBb9SFyFEJYJv3uGmVXRBfHszwk2z9ZFm5R7vXgf9sSsl?__cft__[0]=AZWDq1z4ummu_wZ4PPE7AAv0BqVykch7ozaruwYRfY5B5UA_bwu-hW0iOlCNMV5l0eH5awMfcFx6_H5opTGlepKRpZ2EbHOLImDj9uuf7SK_3sSUBTccN2zsctAzVVb9UQpWHt26fhP2pmdQXHjakiBx5EcTC40ixsM5LXTtEulAZidEdi4LOgsVHLDKNIn1ERgQWiA6CiKRYkZ2jEJFew_o&__tn__=%2CO%2CP-R,27,0,positive,27
pfbid02hgaWjuPQkFJG3RcEPVU1fTyHvNgkNpf2P1w9V6zu5XZP5ggCWLD4QVixXEi6n2QQl,NVIDIA AI,0,13,2,0,1,0,0,0,16,3,"Reduced-order  Kinematics: #NVIDIAResearch applies #ML to identify a nonlinear reduced model for physical motion. It is self-supervised, taking the energy function as input, and sampling it to explore the low-energy subspace.Learn more at #SIGGRAPH2023. https://nvda.ws/3rTgYa5",2023-08-01T21:05:00,['blob:https://www.facebook.com/59acd325-a5b8-42ba-bd17-ffe98fd6980e'],,https://www.facebook.com/NVIDIAAI/posts/pfbid02hgaWjuPQkFJG3RcEPVU1fTyHvNgkNpf2P1w9V6zu5XZP5ggCWLD4QVixXEi6n2QQl?__cft__[0]=AZXtcMWzohuk2ppLpdAUdLUrM3vU6TtBNlLFh2aCDEixHdNaCi--ovBHEoRwo2QmOv49SbbzzqofZm6G1zMdOpETN7pS1BbJP0axLlnzdsDiDjWHPI7HjAQUJ4dnEv6JKoFcCPTsxkAXI-kXvwPea3FtTazo5b17lU1E9VNiS8a4SLtiOkVTN_tBh1O0SJlkyapEVScTphNglLAskRhb62Vh&__tn__=%2CO%2CP-R,16,0,positive,16
pfbid0DJtkAMppREDt1CfRjV3RNP2cQnySDGGyuH96CVQAYYddvJgqxLzUsJX2xZZWr4N2l,NVIDIA AI,0,20,0,0,2,0,0,0,22,1,"Pixar, Adobe, Apple, Autodesk, and NVIDIA have formed the Alliance for #OpenUSD (AOUSD) to promote the standardization, development, evolution, and growth of PixarUSD technology to standardize the 3D ecosystem.Read the announcement: https://hubs.la/Q01ZxL7C0#aousd #openusd #opensource",2023-08-01T19:58:00,[],https://scontent.fcai19-7.fna.fbcdn.net/v/t45.1600-4/366059976_23856846723150159_3196434517464935134_n.jpg?stp=cp0_dst-jpg_p526x296_q75_spS444&_nc_cat=102&ccb=1-7&_nc_sid=67cdda&_nc_ohc=AiOxayaEb4QAX9XR8sI&_nc_ht=scontent.fcai19-7.fna&oh=00_AfAtLJTCV_-gt-QWyf3tIhayhPnhzky-P4n4tyIuO_fUIQ&oe=64E3B66D,https://www.facebook.com/NVIDIAAI/posts/pfbid0DJtkAMppREDt1CfRjV3RNP2cQnySDGGyuH96CVQAYYddvJgqxLzUsJX2xZZWr4N2l?__cft__[0]=AZWC1uSLGpjjkxPmAnKVQaLS4k8fwC522FdzSuKbP1yY10fZq3b31bQp5MOio8jiSh5RLzTTXMWLkGaTBazvJ7BSDWWjcMHEQiBCE7EegSRcKj9tI0dBhjyEnmhfJ74JHzPk2_MqHIJG4dJFAItlgojwFH837EV1mdAhJSFkl8UH6Vl1ieCb9ovyau7z2DfpGrddBZ0mb-ToXA9QXg2yEBpAgHzHn2PIV81wavPo6GxSNKbUuzDX4mqFPcIGl_PtvYs&__tn__=%2CO%2CP-R,22,0,positive,22
pfbid02nxFuDAtbFj6giFwHCYMA9MYQYz96VXPSNxj1y1PNvGAgUDuwrsnLfbkm4C1jATjol,NVIDIA AI,4,28,0,0,0,0,0,0,28,1,"Discover how #retailers can leverage #generativeAI, particularly in e-commerce content generation, marketing assets, customer service responses, and more. https://nvda.ws/3qcnWGE",2023-08-01T17:00:00,[],https://scontent.fcai19-7.fna.fbcdn.net/v/t39.30808-6/365102248_667903365373948_9057360881601802728_n.jpg?stp=dst-jpg_p526x296&_nc_cat=110&ccb=1-7&_nc_sid=730e14&_nc_ohc=r4y6J6M86GYAX97xint&_nc_ht=scontent.fcai19-7.fna&oh=00_AfB7BxQhXi5d37qAfqfQnwzmh0fgDCdw80bEmw0jho3nBg&oe=64E36CE4,https://www.facebook.com/NVIDIAAI/posts/pfbid02nxFuDAtbFj6giFwHCYMA9MYQYz96VXPSNxj1y1PNvGAgUDuwrsnLfbkm4C1jATjol?__cft__[0]=AZX5zXFOS-eSsU9zzG_Z6IpjpoRyGnEW7Sd_sMwN5gtUUQaDYHnkZ8t8hGnWi0yJQoA0fiYt60dTXvFBRjmp5n0upzwZkhq4yQwGiuMvoNx8PBdVZZzPuTx1q1XgSUOMuaDnu6H-yTo8BMCtnn7xJ8lK0KkyBf3OTq1Rcw6g3KZSDTsq1iN8goZUfIhKXslxp3y9gzJhC45X-3iZcXZdwAqx&__tn__=%2CO%2CP-R,32,0,positive,32
pfbid02cDejGznYTYy4BVQhksUJLfaE5ZLoM6byCZk8F4DPfEcHfPqptyCjtuyJqDZFccjQl,NVIDIA AI,0,12,0,0,1,0,0,0,13,1,"Test VR scenes faster with our VR Capture and Replay (VCR).  See how Enscape Part of Chaos teams use NVIDIA VCR to capture and replay complex #VR interactions, enabling automated tests.",2023-08-01T00:03:00,[],https://external.fcai19-7.fna.fbcdn.net/emg1/v/t13/8622993353588910298?url=https%3A%2F%2Fdeveloper-blogs.nvidia.com%2Fwp-content%2Fuploads%2F2023%2F07%2Fchaos-enscape-featured.jpg&fb_obo=1&utld=nvidia.com&stp=c0.5000x0.5000f_dst-jpg_flffffff_p500x261_q75&ccb=13-1&oh=06_AbGv_ZeVys3sZ4N7US6kYJhfvtQR4DZ7qdIj6reL6J4m6w&oe=64E00BA1&_nc_sid=dbad39,https://www.facebook.com/NVIDIAAI/posts/pfbid02cDejGznYTYy4BVQhksUJLfaE5ZLoM6byCZk8F4DPfEcHfPqptyCjtuyJqDZFccjQl?__cft__[0]=AZVmwNDQpYHh65ipgsSsO_zD5TRwfCl4m4l-9c2u05jObTu9988R5D_djW-u3H1wPHAAGEJefIwS-vg5YdzT2qmGVvaKlIvjVz1XKLXrEWKJ2qMBxcRX2GJtogq39pQU8E0NWXyZw2LNLJCiKusSWg__9c0d_fs_SeslfsDbqSQ2Saud-UlqsBLoas5wKacd_KrOTIPcJZ4F8yxUBBeFIZ9o&__tn__=%2CO%2CP-R,13,0,positive,13
pfbid0Yaz9KGoT4nEpFTeDyeXh1cExKtVrQnn6sBg3e51R9W1cr5j2Frpis2daeY7a68hHl,NVIDIA AI,0,36,0,0,2,0,0,0,38,9,"Don’t miss the Educator Day’s session at #SIGGRAPH2023 to learn how you can reimagine your curriculum with #OpenUSD and #NVIDIAOmniverse. August 7, 12:00–12:30 p.m. (PT) https://nvda.ws/3pVfs6M",2023-07-31T22:00:00,[],https://scontent.fcai19-7.fna.fbcdn.net/v/t39.30808-6/364027982_667481088749509_8374243750927087028_n.jpg?stp=dst-jpg_p526x296&_nc_cat=100&ccb=1-7&_nc_sid=730e14&_nc_ohc=7ILoQDVsGDkAX-Mh8oA&_nc_ht=scontent.fcai19-7.fna&oh=00_AfB9a9KN_aNevG2Ikqoz7tM8EzYQiQpsvejseiQm0YR7Gg&oe=64E34A25,https://www.facebook.com/NVIDIAAI/posts/pfbid0Yaz9KGoT4nEpFTeDyeXh1cExKtVrQnn6sBg3e51R9W1cr5j2Frpis2daeY7a68hHl?__cft__[0]=AZW91Ruowx_r-hQCNOTJGUSQau2KS4i7-oEni7ENgf5B2cPvt2MQaHzichrEpOUblgSejQJRkId3uXGuQFmO4-O7QJdTKqd4dh5nuwIFvF7m-bDXBfFXhrwmGp-946FuV_WZSy3dwTFWl1eaV7pCfla-AcKHDOWpMFobKr3d2z4FLc5Jy14zdaQ4vHiYE4NPNu88cE9Wrk0Q3oJ5s_sw9f12&__tn__=%2CO%2CP-R,38,0,positive,38
pfbid0iiyNuCewZsejB6Re8mjNmZjBBkppuvQyNHNVbRJBYt2NxRtjs68uVN4k5JwzCmmXl,NVIDIA AI,0,11,0,0,1,0,0,1,13,2,Interested in learning how to write your first #GraphNeuralNetwork? Take this training focused on enabling streamlined graph #AI workflows and capabilities.Watch on-demand: ,2023-07-28T23:00:00,[],https://external.fcai19-7.fna.fbcdn.net/emg1/v/t13/14082367444455994633?url=https%3A%2F%2Fprod2-sprcdn-assets.sprinklr.com%2F50276%2F565c40fc-ec2a-496f-bb42-b15a91cba85c-91159729%2Fgtcs23-dli-nvod-training-lab-2.png&fb_obo=1&utld=sprinklr.com&stp=c0.5000x0.5000f_dst-jpg_flffffff_p500x261_q75&ccb=13-1&oh=06_AbHq1fQvSX2bQo616ibvQhUiooONmpV1eF4AbvWrDcE80A&oe=64E04168&_nc_sid=dbad39,https://www.facebook.com/NVIDIAAI/posts/pfbid0iiyNuCewZsejB6Re8mjNmZjBBkppuvQyNHNVbRJBYt2NxRtjs68uVN4k5JwzCmmXl?__cft__[0]=AZW0DYj2RaAjOZEA1TYsLL5PBXYWU9cyUexDJbifrR3NvHSpSIIMLGhRHoQXVM7ICkWKt5LKYLhex82jBjoh79O3p9aEwRDXVepSGjJ4Ig3AOdKSTxq8heGNU9iVNtwzbDOd6NzRRB0xAJgE_UJCek7aHzBmfiS4q5cPC9M-elIqGvGCKE_fWuNWkrCfHx4XZlAV93iTrxldfzyXeeJ0bCic&__tn__=%2CO%2CP-R,13,0,positive,13
pfbid0eZwq3uxLf2dZxHSkFKavLdhsnDE5NbwR8Dd5SQreB16EBrMYg3cbwS3sN1c9DUvNl,NVIDIA AI,0,9,0,0,2,0,0,1,12,1,Did you know your image could maintain 16X more texels when compressed?#NVIDIAResearch technical paper: Neural texture compression can substantially increase the realism of 3D scenes… by capturing sharper detail than previous formats without taking up additional GPU memory.Learn more about neural compression of material textures at #SIGGRAPH2023.  https://nvda.ws/3OBcZb7,2023-07-28T21:03:00,['blob:https://www.facebook.com/b39caf87-9624-45ad-a77a-58acf198f3f0'],,https://www.facebook.com/NVIDIAAI/posts/pfbid0eZwq3uxLf2dZxHSkFKavLdhsnDE5NbwR8Dd5SQreB16EBrMYg3cbwS3sN1c9DUvNl?__cft__[0]=AZXiCUj8FbcbUZVrb-HpunXNrQjnAbGmTy29EHVR6Uk09ybaBkm8bbSQ7XJ4k7wjYw9EgUzzYyfy7puwetoHZVmP1Pt1wTuwRW0CONio8mH0yzwB0EAX7H2QcNJgQ4YzlhjyK6HYZbGoeJFKaDRmIlMwRyI2RsJTZ7b9T30LroMlkXigYf5OQNxK7C7H7di_41CV2tDtmFxywbMocM1KlKuw&__tn__=%2CO%2CP-R,12,0,positive,12
pfbid0gh8nrXJ7reZF3uJzfmjZ2AbDszUcQjz5bgM1F6PDn1KKVC6t7iLYRWyFmdp28bBHl,NVIDIA AI,2,13,0,0,1,0,0,1,15,1,Save the date for our founder and CEO Jensen Huang's special keynote at #SIGGRAPH 2023 on August 8. https://nvda.ws/3q9R3KH,2023-07-28T00:35:00,['blob:https://www.facebook.com/f48dae80-f1d5-4393-b289-853f71856bdc'],https://scontent.fcai19-7.fna.fbcdn.net/v/t15.5256-10/362560788_1032710431431678_8748697467984934605_n.jpg?stp=dst-jpg_p960x960&_nc_cat=107&ccb=1-7&_nc_sid=ad6a45&_nc_ohc=_6IvxVb7VwIAX9cSDyu&_nc_ht=scontent.fcai19-7.fna&oh=00_AfAtVkKNgflatGwqRMr6_-HiDpsXD4ttrxOg1do4K3pivw&oe=64E3CF90,https://www.facebook.com/NVIDIAAI/posts/pfbid0gh8nrXJ7reZF3uJzfmjZ2AbDszUcQjz5bgM1F6PDn1KKVC6t7iLYRWyFmdp28bBHl?__cft__[0]=AZW9nz51IEOVnFOxvWTBrTRotBo4CWelfkXlIPXiFoek72O9Qy9R0HbGfDoYxAL-WgixLxr9qG0L_Dqs2TQEYtpRnh0friHntpZbwP4HPipHLEGbazpuxAYbzulrpJCaqE028EDT6Ub2dzSO7R7LfHFarFRaN-UE3ruSdTRqrnhJeN8jnjtGFNzmBarbbmI9b_dRLvSzsgqCL9TrxJpTIf7IH9P1azILeZUC9BOGLQT4s5_8ekDgmkBbqANgpGfU2LM&__tn__=%2CO%2CP-R,17,0,positive,17
pfbid032t5uFYJcFB2BvA8ajmug12EepWz4g4fv22E19Z73wrxH3ac6GYD3bwor1rTmSrPYl,NVIDIA AI,1,25,0,0,0,0,0,0,25,1,"Learn how HPE and NVIDIA are collaborating to offer customers a complete, end-to-end AI software stack. ",2023-07-28T00:00:00,[],https://external.fcai19-7.fna.fbcdn.net/emg1/v/t13/11616724453298500307?url=https%3A%2F%2Fcommunity.hpe.com%2Ft5%2Fimage%2Fserverpage%2Fimage-id%2F136197i0422993221B71DBD%3Fv%3Dv2&fb_obo=1&utld=hpe.com&stp=c0.5000x0.5000f_dst-jpg_flffffff_p500x261_q75&ccb=13-1&oh=06_AbHd5cstlMJzBJeUxpY__5uLYfyxiJh1F23Us6CvCfmZWw&oe=64E07DA5&_nc_sid=dbad39,https://www.facebook.com/NVIDIAAI/posts/pfbid032t5uFYJcFB2BvA8ajmug12EepWz4g4fv22E19Z73wrxH3ac6GYD3bwor1rTmSrPYl?__cft__[0]=AZW-t-6WKCxCYiCTDwaTKaHCt58HcNWfV2teTVgsfcT9bGO8zC1wuMNcehi0OyG6zKw0idRRDqQRtuosT2bdeyyzQrhlw5VzyrLt9y_HSMRByXL9bmJvVexX9uUr70WiRGb_lDit923vh6_U_qOMRyCs1f5WGsnQSEKeV_BQ2kA5I_7Ay2fk6HjZm3PXiY1p4xzYWi0D5ne3iOxOWU4OVRIj&__tn__=%2CO%2CP-R,26,0,positive,26
pfbid02Pj3QNJ7tjDBv4MfSz32gQP6vPVcNs81e9jtziiDQojXdrLFBPWDk6Z2CtJZM9gxel,NVIDIA AI,1,9,0,0,1,0,0,1,11,1,Dive into Generative AI at #SIGGRAPH2023. Join top #AI visionaries to see how new discoveries in neural rendering and 3D generation are being adopted to advance visual experiences and accelerate the content-creation processes.  #GenAI Theater: Aug. 8 Room 404B  https://nvda.ws/3DyBBek,2023-07-27T22:01:00,['blob:https://www.facebook.com/8dc72bce-988b-4d00-9549-09a1ecb4dc65'],,https://www.facebook.com/NVIDIAAI/posts/pfbid02Pj3QNJ7tjDBv4MfSz32gQP6vPVcNs81e9jtziiDQojXdrLFBPWDk6Z2CtJZM9gxel?__cft__[0]=AZWzKtNIQiIOWgzux1M_-T2_VpzD_Bgru9Pv8bb8eWAVgpYUmVN73wj3XRii4ZIjHpJxucxoUNqBbcaf6DCCiZBDv0d3a2PwUlbwwSz4c96D8rhUPhPdzZVR4gKVYNbHfLoxipT_X_WMAGT64IQNWZ9bzek8V82c1YOKlRGyrbSD2ArIJCJ1JvBJ87PfJQL2QACCx4jlgxx5yY-Y5-cnPnFO&__tn__=%2CO%2CP-R,12,0,positive,12
pfbid035WymBGw5xc599YyJvhXaT2KxTtKLuwE2iFvw7PPV5wHYRWsBvG5k5vW18VmTMW4Pl,NVIDIA AI,0,18,0,0,2,0,0,0,20,0,Why #VisionTransformers (ViTs) are critical for #computervision applications? Read the blog to learn how ViTs are improving the accuracy and robustness of your #visionAI apps with #NVIDIATAO. https://nvda.ws/3QcNb66,2023-07-27T20:08:00,['blob:https://www.facebook.com/6c4398cf-8f44-4eba-9f7a-8c38fe0210e9'],https://scontent.fcai19-7.fna.fbcdn.net/v/t15.5256-10/362325366_794613588875504_466279896255194399_n.jpg?stp=dst-jpg_p180x540&_nc_cat=111&ccb=1-7&_nc_sid=ad6a45&_nc_ohc=QTl8421myusAX-kjLkO&_nc_ht=scontent.fcai19-7.fna&oh=00_AfAaPmawyqIVDsxT7A-iNRllTsAviq31OU5XP-ux8A5EGQ&oe=64E36CB7,https://www.facebook.com/NVIDIAAI/posts/pfbid035WymBGw5xc599YyJvhXaT2KxTtKLuwE2iFvw7PPV5wHYRWsBvG5k5vW18VmTMW4Pl?__cft__[0]=AZVKznz84kl41O5F0cbPzKwCRVvFzWBlrC5hZgrtFzQiFAJCkbMbGik7RHsjHTQUCRrk_QNrNdTXh9Wc8LMtGO9s-_PQRWKAmLup_BhbmrGRa0hM_Ls48-QQkQ6AiRUf_LbQGPO_WvFUjWEInMQ0Yk_XvK6NDYVfRuCIuma_75X8awVvN6dlvEaE5RDldedXZcpmJzfX17Yzv4qekyQTxDHwYRwkLrdxnaNlz7q9Rj2q6niukGjClhe1EuXVgquqRIc&__tn__=%2CO%2CP-R,20,0,positive,20
pfbid0xL8D3gNPxywWoALzJUfCibMYzq8SM14sj4wCTYa2cZCn66ci75etSFs5z8ViLCvFl,NVIDIA AI,1,12,0,0,1,0,0,1,14,2,How can accurate stable high-resolution weather forecasts be generated in mere seconds?See how machine learning-based weather prediction can complement traditional numerical weather prediction models and enable better estimation of the risk of low-probability high-impact extreme weather.   ,2023-07-27T19:52:00,[],https://external.fcai19-7.fna.fbcdn.net/emg1/v/t13/4842006209645627740?url=https%3A%2F%2Fdeveloper-blogs.nvidia.com%2Fwp-content%2Fuploads%2F2023%2F07%2FSpherical_Fourier_Neural-500x282.gif&fb_obo=1&utld=nvidia.com&stp=c0.5000x0.5000f_dst-jpg_flffffff_p500x261_q75&ccb=13-1&oh=06_AbEbqGJ-LpEyywGmESref5RSsTQvsrD-jK7qPY2NgeMxTg&oe=64E09DBD&_nc_sid=dbad39,https://www.facebook.com/NVIDIAAI/posts/pfbid0xL8D3gNPxywWoALzJUfCibMYzq8SM14sj4wCTYa2cZCn66ci75etSFs5z8ViLCvFl?__cft__[0]=AZUChYqwl5go-GDVvRkFqCZrlfnGludr3K5twrOu7HdtDcF9pIBsnKdmgsVMNbZs4iIewk1q8wYlAE4a2586Y-16L0PS-ioR4lns8FZJ_No1yukhAEiJvGqwb_0DmUPotRcsz7u22EcB4V2Qe5CJMR1phd6GeX6_rEKX7nKRsQ-9ejmjuBqenvirgkVd7YKIPCTL8WnsLDMnxkBbCmLHH9r9&__tn__=%2CO%2CP-R,15,0,positive,15
pfbid02vfN4Qtmv11nKcwWomjPg8iMdYjDq17x7ampXNxGxhiq6843kTz3ZZexZqBWjs9wVl,NVIDIA AI,9,32,3,0,0,0,0,0,35,2,"Today, ServiceNow, NVIDIA, and Accenture announced the launch of AI Lighthouse, a first-of-its-kind program designed to fast-track the development and adoption of enterprise generative #AI capabilities. AI Lighthouse will assist pioneering customers across industries in the design, development, and implementation of new #generativeAI use cases. Learn more now: https://nvda.ws/43KrJZx",2023-07-26T23:30:00,[],https://scontent.fcai19-7.fna.fbcdn.net/v/t39.30808-6/363803869_664679955696289_4729842303263802731_n.jpg?stp=dst-jpg_p526x296&_nc_cat=109&ccb=1-7&_nc_sid=730e14&_nc_ohc=wM_iwDPOy5sAX_swNtS&_nc_ht=scontent.fcai19-7.fna&oh=00_AfD_NWYqdAqgIl8whDgPX4uHg4sydnqQ66opp0lUK4BGVA&oe=64E35C18 https://static.xx.fbcdn.net/rsrc.php/v3/y9/r/Z-dbClQDXLv.png,https://www.facebook.com/NVIDIAAI/posts/pfbid02vfN4Qtmv11nKcwWomjPg8iMdYjDq17x7ampXNxGxhiq6843kTz3ZZexZqBWjs9wVl?__cft__[0]=AZXDl4rB0wHHZ4M878aaEucoUdjzll1vnCZv-PZYmmOun5Seb2DyoVy2CQVLJQ5iZnb6ThEs3qDN218hPx-_Q9QQGWo9WZ5pkBa9KeQbGPReqyIUES5x1F8bfC_aWVjjy1YDHQ0SnMCJ7I06m_4o0UM3T_iKZdN2nRF2MiU-c9vqho8BuPnTO1OIUH30x-L7DTdr3db8J5l6Wa-jpcwxRZ_e&__tn__=%2CO%2CP-R,44,0,positive,44
pfbid0VNTL3t5Ha7aUM2RwwkvgEmBUdqW9ui5HyWE758AcgJDdBwsHa8ih6TAMtsKBbu3Nl,NVIDIA AI,2,10,2,0,2,0,0,0,14,1," Just released: #NVIDIAKaolin v0.14.0Accelerate 3D deep learning research, debug your custom renderer interactively in a Jupyter notebook, and conveniently manage batched mesh attributes with a SurfaceMesh container, within the Kaolin #Pytorch library.Github: https://nvda.ws/3YaJmjZ",2023-07-26T20:11:00,['blob:https://www.facebook.com/1a7c8d67-2600-4587-a350-54818fef7022'],,https://www.facebook.com/NVIDIAAI/posts/pfbid0VNTL3t5Ha7aUM2RwwkvgEmBUdqW9ui5HyWE758AcgJDdBwsHa8ih6TAMtsKBbu3Nl?__cft__[0]=AZUSUiBMb5mKx_W9cj15Lv3AF3LXOqMNegJUMs6kmntwVA0d7-qr9tEogfDtlzoV7ZQ8atvMNeNxle55KYI7eEGo3d8UTqKVZUMxu4whFAwi88K8B7J8ov48b8vGzReyrRXEbPGiCir-rLu94aw9aNFmNHA52_ZyMOpPv6yEXn2SNbTqYCYLUV5tdV4wrjlj1F6D2QCk7P5NZ_6yN1sMVZi1i2rvUXc0Q9eV22lY-aTrTg&__tn__=%2CO%2CP-R,16,0,positive,16
pfbid02rgGwqHPuQbuR2ReTxCCAp6chLooHLyhbmUBn5v1v7z8FasjBGmzJCTqh5w55NTpRl,NVIDIA AI,1,33,0,0,0,0,0,0,33,2,"Train protein models to speed drug discovery, forecast financial trends and optimize portfolios, build recommender systems, intelligent #generativeAI chatbots, and AI factories with #NVIDIADGX Cloud an #AI supercomputer in the cloud that's accessible from a web browser. Learn more. ",2023-07-26T17:00:00,['https://video.fcai19-7.fna.fbcdn.net/v/t42.4659-2/362368948_6572281896199282_6526310089304479948_n.mp4?_nc_cat=104&ccb=1-7&_nc_sid=73e57b&_nc_ohc=KOPqCyxlT3AAX9KMjEi&_nc_ht=video.fcai19-7.fna&oh=00_AfCf_s04mJo2uQhecodu-b9pws2y2XgTC8kh2Vx0h8ewZA&oe=64DECD3F'],https://external.fcai19-7.fna.fbcdn.net/emg1/v/t13/10523927338851667656?url=https%3A%2F%2Fblogs.nvidia.com%2Fwp-content%2Fuploads%2F2023%2F07%2Fdgx-cloud-key-visual.jpg&fb_obo=1&utld=nvidia.com&stp=c0.5000x0.5000f_dst-jpg_flffffff_p500x261_q75&ccb=13-1&oh=06_AbHjVJnDy25UxMKAbhY6ytd0EPKwJbULcJvXAfVMDL_LcA&oe=64E00602&_nc_sid=dbad39 https://external.fcai19-7.fna.fbcdn.net/emg1/v/t13/16539584175338635161?url=https%3A%2F%2Fmedia.tenor.co%2Fu6LXOuXGKlEAAAAC%2Fcomputing-confused.gif%3Ft%3DAAYBZCaTCM8FCBlUkQ5h8A%26c%3DVjFfZmFjZWJvb2s%26itemid%3D17278992&fb_obo=1&utld=tenor.co&stp=dst-jpg_flffffff_q75_s960x960&ccb=13-1&oh=06_AbHNBrQmEGMpR1O5ZQGDRdPs7xx7ZbGoXdOjA8Q_TzzN8w&oe=64E097F7&_nc_sid=75c735,https://www.facebook.com/NVIDIAAI/posts/pfbid02rgGwqHPuQbuR2ReTxCCAp6chLooHLyhbmUBn5v1v7z8FasjBGmzJCTqh5w55NTpRl?__cft__[0]=AZV99DQKPKXoM_gZko99MgM6UVonkkdSux4gASH-x-cH8L43ncqlWuGIxj8MFZV461BYluCJWKEdZDaHu5Y_Lo-DOHsgdGMtPJEHMW7cTQyDWFrRzwPcWXWaxikFUUHBeew1ZMpAIDmq2zUnAt21b9VmhCAcIl2waBZGJEbHHU4BMFmnNNbkbr2IiPkHkg5J-DlarMwkNvwtHlnXomyQ2yX_&__tn__=%2CO%2CP-R,34,0,positive,34
pfbid0FohrKrxsbX6gZv2ECWPMqeyvu5NLzaTAfetTWD3AYUHts75J2Vn1SVD267EJdZaVl,NVIDIA AI,2,15,2,0,0,0,0,1,18,4,"Intelligent stores harness the power of AI in autonomous shopping, asset protection, store analytics, and inventory management. Discover how AI can power frictionless shopping experiences. https://nvda.ws/3pTQtRj",2023-07-26T02:00:00,[],https://scontent.fcai19-7.fna.fbcdn.net/v/t39.30808-6/363379903_664195109078107_5261735579154829334_n.jpg?stp=dst-jpg_p526x296&_nc_cat=104&ccb=1-7&_nc_sid=730e14&_nc_ohc=iemyzSIx7WQAX8MhMgL&_nc_ht=scontent.fcai19-7.fna&oh=00_AfDAGIVZ0idvjlIx_E0UixfRmL_4jp9iD_lnSrI0JsHK4Q&oe=64E3F214,https://www.facebook.com/NVIDIAAI/posts/pfbid0FohrKrxsbX6gZv2ECWPMqeyvu5NLzaTAfetTWD3AYUHts75J2Vn1SVD267EJdZaVl?__cft__[0]=AZU7D8rH-Fi7CITFOVq7XVrqkIgGTeB_pDfe4StB7U9UYNIL8lIWOWafJ-NTVQpqRH6LXLyHwXbCKhUvr5IT6xztR9-NhueTaeFJPd76lsJwU4i9s8rCX8i2usZe4fK-717spNUCsdwn3F_suR6VLc1DALZpy-RancSAHTX4501uqQ4VBZbs6VKii-BkGopikmg1PplGWCPgZzCpbf-7ExzG&__tn__=%2CO%2CP-R,20,0,positive,20
pfbid02k81HUMmYzAK3ackfgRcBiTVsfS6B7jDuzcGahjL7y5svvGPYSx9JvDrNvvgauH4Wl,NVIDIA AI,2,10,0,0,1,0,0,2,13,1,"The open-source #NVIDIATAO 5.0 for #AI training and optimization is now available, putting the power of state-of-the-art #VisionTransformers in the hands of every developer on any device — at the edge or in the cloud. Learn more. https://nvda.ws/3OuwDFt",2023-07-25T20:39:00,['blob:https://www.facebook.com/3237f7e3-5de5-4d34-a8ae-9b96fc4660ac'],https://scontent.fcai19-7.fna.fbcdn.net/v/t15.5256-10/363457902_249170067910116_5305814906891688990_n.jpg?stp=dst-jpg_p960x960&_nc_cat=105&ccb=1-7&_nc_sid=ad6a45&_nc_ohc=ktpBf-0Hy74AX9Ktaq_&_nc_ht=scontent.fcai19-7.fna&oh=00_AfCOsLSc3gFWfCGpVqGicpgy1kpnG1E-eXJPx5bmHzPFTQ&oe=64E2CC8F,https://www.facebook.com/NVIDIAAI/posts/pfbid02k81HUMmYzAK3ackfgRcBiTVsfS6B7jDuzcGahjL7y5svvGPYSx9JvDrNvvgauH4Wl?__cft__[0]=AZXSVjdEHqsjouLKaMJl_4u-xk_JENxUS-Dkl271vGgjE0y-9ncv-2TsRt1LTYpNUVHTHAIBapUaHR1EsGFd1hxJ0mjxsgTYhoCEdC_vP_ACWS-fN6j0qwkF16MxZDTdHstEHBC7eWDsDJylANOiuDHWFd0_2FEMwwpLfY2K7hHRGhlvu9Xi1iC_w2wPWw5-5VrNrRTskrJTJ1QN8jAtzQLKmfFf0r9izzJbkBaAO2pFKMnpusk_ZRLNRooFGVZa1m0&__tn__=%2CO%2CP-R,15,0,positive,15
pfbid0ydb8ZitfUBQ2Rhdm1zuBMYS6TCyYd3K8cDRZwRhVJQnTTAuXFSRdCfK8kf6KtSM2l,NVIDIA AI,3,19,2,0,0,0,0,0,21,1,"Opportunities met innovation at this year's #MSInspire. Did you miss it? If you did, we have you covered with all our sessions in one location. Our Expert-led Q&A, interviews, and featured breakout sessions are all here for you right now: https://nvda.ws/3PQpUqr #NVIDIAonAzure",2023-07-25T19:00:00,[],https://scontent.fcai19-7.fna.fbcdn.net/v/t39.30808-6/361589761_664046739092944_1444220041599554113_n.jpg?stp=dst-jpg_p180x540&_nc_cat=109&ccb=1-7&_nc_sid=730e14&_nc_ohc=31tvQt6_ObAAX_3VAPR&_nc_ht=scontent.fcai19-7.fna&oh=00_AfBj0GAJ7sGdd7wwhgN8wJald_NRsogR2OS_ZQZNP1EP7w&oe=64E316B6,https://www.facebook.com/NVIDIAAI/posts/pfbid0ydb8ZitfUBQ2Rhdm1zuBMYS6TCyYd3K8cDRZwRhVJQnTTAuXFSRdCfK8kf6KtSM2l?__cft__[0]=AZVYup7mlCSZ_FrWRHqyfldlRUjsSrbbjB9QZJ-NmXCKbe-3MEGkGf1EXDcpKXi4VFhqWmJX7r-xI_QueJE2HRUfwmcNiyGwlxgaLzObRreg470tn_jm3OugSm6vfeCHU1_Zcx11A8fuflLVonsCVUPH9Bb8eE__ErI4cLCrJ9wJL7vxyJynbLk9FDns-I7aZe6WwxF6nalzhW7pjrF7O5Vt&__tn__=%2CO%2CP-R,24,0,positive,24
pfbid02rDxP9Cs7q85aRJ4dNdHbGhmgpvX2AuV3qBwaACAGFLXarcx1MvA4Hp4o6bRmnCeBl,NVIDIA AI,0,5,0,0,1,0,0,1,7,7,"To manage renewable energy at scale, NVIDIA and its ecosystem partners are using AI to optimize solar and wind farms, simulate climate and weather, maintain power grids, advance carbon capture, and power fusion breakthroughs. https://nvda.ws/3Y9AfQk",2023-07-25T17:58:00,[],https://scontent.fcai19-7.fna.fbcdn.net/v/t39.30808-6/361580343_664016285762656_2241200916308145843_n.jpg?stp=dst-jpg_p526x296&_nc_cat=101&ccb=1-7&_nc_sid=730e14&_nc_ohc=WWJFKLEJi68AX8Jd706&_nc_ht=scontent.fcai19-7.fna&oh=00_AfCSprNYrtH76HItArDyOGTOvGvWQaiAr2VKaOS4jmmILg&oe=64E39272,https://www.facebook.com/NVIDIAAI/posts/pfbid02rDxP9Cs7q85aRJ4dNdHbGhmgpvX2AuV3qBwaACAGFLXarcx1MvA4Hp4o6bRmnCeBl?__cft__[0]=AZUXhEBJlwSuPRaAFNLYh4Uc2TdQknNxnKsFh3wpLf2zdYncfUTqvXVg9nbclJSIDqkb46VneBNCF61gqqZ6WyT4fu59KJNnOkpHo-eRUWdgqNiRxmjGpx5uFMOwjVSNnyZ2yjJEvBW5gm3p6kaYAP2u7N91srOzZn4rQfi_Dv7SfU3EBFIM-0plZk5roOzsQTjHOcY6UwztDCiO1tzN-dzc&__tn__=%2CO%2CP-R,7,0,positive,7
pfbid0hg9G7YuaJmxe1kyL8KegaX5htxd7h7ZDdMCWH368JqkrtwkZhsNxS5F9VwCWXVJHl,NVIDIA AI,0,9,1,0,1,0,0,0,11,2,NVIDIAs Jonathan Cohen sat down with #DataCloudNow at #SnowflakeSummit to discuss the future of #generativeAI and MLOps.Check out the full interview: ,2023-07-25T01:00:00,[],https://external.fcai19-7.fna.fbcdn.net/emg1/v/t13/5631835369366296538?url=https%3A%2F%2Fi.ytimg.com%2Fvi%2FprEJZq9pacU%2Fmaxresdefault.jpg&fb_obo=1&utld=ytimg.com&stp=c0.5000x0.5000f_dst-jpg_flffffff_p500x261_q75&ccb=13-1&oh=06_AbG4hJjFC7VbIo2nfQG5VhlnOxEme6xBnFyoL7wdaz1Q4A&oe=64E01E7D&_nc_sid=dbad39,https://www.facebook.com/NVIDIAAI/posts/pfbid0hg9G7YuaJmxe1kyL8KegaX5htxd7h7ZDdMCWH368JqkrtwkZhsNxS5F9VwCWXVJHl?__cft__[0]=AZXebC65kgPnIWGxCTKamxbExttxA8jImkzsM1OJxNxWmEt2wTpX4jvrMY_bY5bnKZ-kC6Dx1ekyBMsmMxcQoySnkNT6JbIwxky4Fplbv-ReoZJQt0hEfGdarR1b0jEUwNna98smvjbVyvjYm-9Q5_GizmD-nFx0n8Xq4othLWR9drfb1NyzdVEKlsUiwZ2mLbvV6CrdvRl1s5LEOdJI80D_&__tn__=%2CO%2CP-R,11,0,positive,11
pfbid02PDLWFAqCDArBXX5yz17ZABuR1UzPCRighM4KaVQunEtrd6Gzjt5NFf8ZYYV2QHAil,NVIDIA AI,9,29,7,0,0,0,0,0,36,3,"Is your 3D character phasing, glitching, or clipping through objects? This #NVIDIAResearch #AI approach takes physics-based character motion generation… and teaches the character how to realistically interact with objects and their environment.Get more details to how these characters interact with their world at #SIGGRAPH2023. https://nvda.ws/43ExeZx",2023-07-24T21:40:00,['blob:https://www.facebook.com/51fbec21-749f-4a87-a74d-a853d1e67e37'],https://scontent.fcai19-7.fna.fbcdn.net/v/t15.5256-10/362499865_1222795778383148_4207506003840494308_n.jpg?stp=dst-jpg_p960x960&_nc_cat=104&ccb=1-7&_nc_sid=ad6a45&_nc_ohc=uSzWJyu5oqEAX9wqipP&_nc_ht=scontent.fcai19-7.fna&oh=00_AfC3KB7_PNwhOnVrPYOuWWTPozTPMguj-8_fYV_jFD45rA&oe=64E34C13 https://static.xx.fbcdn.net/rsrc.php/v3/y9/r/Z-dbClQDXLv.png,https://www.facebook.com/NVIDIAAI/posts/pfbid02PDLWFAqCDArBXX5yz17ZABuR1UzPCRighM4KaVQunEtrd6Gzjt5NFf8ZYYV2QHAil?__cft__[0]=AZUlgSFd_JQvpABkXy2a2dM4nI7GUwXF-N9RlxsLfwc09EPQinh2bIKV2XmQZEuJ6RbzXQRhu0fhSfCTXekZrl7dyfAYFyxxWy-ipZm3kT8N-qG7Uvekjana21O3TqZ_xbnuQWs_h-ygLjoez8-P7GjG7-YHURZMD0tKF6T5c-RZROsmxBpMwf2o-jEq_BXXxFTMlzCQQsnJZYK_bf7W9pyx&__tn__=%2CO%2CP-R,45,0,positive,45
pfbid05XkCMuNjUzDRVn4WVFjqNHBq9dSjZrzoC8831nSZ9LH4e5mUXdBE6YvsTHieiapGl,NVIDIA AI,1,11,2,0,1,0,0,0,14,2,Happy Friday  we are hosting an Ask Me Anything (#AMA) on July 26th on the latest features in the #CUDA 12 release. Our engineers will be on-line live to answer any of your questions. Sign up here:  https://nvda.ws/3O2UaMv Also reply below and let us know if you have any topics you want to us to consider for a future AMA.,2023-07-21T21:10:00,[],https://scontent.fcai19-7.fna.fbcdn.net/v/t39.30808-6/362596487_661873615976923_787893429728013827_n.jpg?stp=dst-jpg_p526x296&_nc_cat=109&ccb=1-7&_nc_sid=730e14&_nc_ohc=IqVHN4TbnLkAX8Txd2v&_nc_ht=scontent.fcai19-7.fna&oh=00_AfD82JkJGKyeuRnseB28bZjPUEaN8W-WAeZ6WVS7PVMccg&oe=64E2DDCB,https://www.facebook.com/NVIDIAAI/posts/pfbid05XkCMuNjUzDRVn4WVFjqNHBq9dSjZrzoC8831nSZ9LH4e5mUXdBE6YvsTHieiapGl?__cft__[0]=AZUdLFpySRSEt_lqQIA8Wj2rukRfKBI_JjAyJXdqZBckP_68DpxZ8n0r3NHEqecPtpaCE0Jb24MjUdH70dY9R-7yKV1VQ8izjVkpRGezDjYKcrH9yNiVdnyyMcX174xDcq_CeI37ac090QpFANO6gjnTKXQfp6SAu-jUZCO7x1r6LQgCWmyZkXIDW95L5_NL2Rq_idQZaPMtyxkt7-0SloVm&__tn__=%2CO%2CP-R,15,0,positive,15
pfbid0Z4BMdjjLEL95P2DbxtP77fsgB4GywagTUAj7ceVRTJnvV83zZSNWUB9fDSiWnKLul,NVIDIA AI,4,18,0,0,2,0,0,0,20,1,Technical Walkthrough: Learn how to effectively leverage large language models #LLMs and federated learning to tackle various downstream #NLP tasks while preserving data privacy and achieving optimal model performance.Read more: ,2023-07-21T20:32:00,[],https://external.fcai19-7.fna.fbcdn.net/emg1/v/t13/10005010653831011588?url=https%3A%2F%2Fdeveloper-blogs.nvidia.com%2Fwp-content%2Fuploads%2F2023%2F06%2Fllm-graphic.jpg&fb_obo=1&utld=nvidia.com&stp=c0.5000x0.5000f_dst-jpg_flffffff_p500x261_q75&ccb=13-1&oh=06_AbFq9qrrTREkd4Pa5WSXge8e8RE9MYGsLtwwiwlZQ4Xv9w&oe=64E00589&_nc_sid=dbad39,https://www.facebook.com/NVIDIAAI/posts/pfbid0Z4BMdjjLEL95P2DbxtP77fsgB4GywagTUAj7ceVRTJnvV83zZSNWUB9fDSiWnKLul?__cft__[0]=AZUpVUAPHtxIGb2oO1ptsAHTdtEiAz8QwpoqN1AeaLWQkbsopSWtHgoq88m5I5adxtCvPlF4M3oWZzAYzRp7BDZ_9yWjTdkzQtxKqT0HUihy2UKAoWlP1dnHZtDH8U-SGA9TaAWcLEJTHRNWNLu50HI7NbwgF5sOBwCik3Mf5Ce54djr71mrcAzEz94f3WlWchIwZM_yD6mSZbSPV1vWM0eA&__tn__=%2CO%2CP-R,24,0,positive,24
pfbid02eQ1MkFNgk3AkDq5kv8bwDtEv2wTm74mFgabrn8AonXhuyEqBR1WXubaqTsqpAnYzl,NVIDIA AI,5,23,0,0,0,0,0,0,23,1,"Startups are racing to reinvent their workflows with #GenAI and #LLMs.Learn how #NVIDIAInception members, Canva and Splash, use #GenAI and our NVIDIA NeMo framework to accelerate application-building. Join our webinar on July 26 at 11:00 AM SGT Register: https://nvda.ws/3O18THB",2023-07-21T05:00:00,[],https://scontent.fcai19-7.fna.fbcdn.net/v/t39.30808-6/362619469_661484276015857_3361909374551545818_n.jpg?stp=dst-jpg_p526x296&_nc_cat=108&ccb=1-7&_nc_sid=730e14&_nc_ohc=ryJ_9oTv_wkAX9zrjG5&_nc_ht=scontent.fcai19-7.fna&oh=00_AfBl1zW2IlpJ2wYV-JqwV67Xq62wHO212z-7O-iKJ5PLSw&oe=64E2EE5A,https://www.facebook.com/NVIDIAAI/posts/pfbid02eQ1MkFNgk3AkDq5kv8bwDtEv2wTm74mFgabrn8AonXhuyEqBR1WXubaqTsqpAnYzl?__cft__[0]=AZXtXpVmXGTMRfvJMXklSKj_Hv5WVtLRdOyHQqlE-A1zKtUfgrpSALRCImo2GC_0tHG32zTxUVFrm9fukXFEcH7ooTxzVqL6FdJKsLdm0XPXV5_udNs23mL4jYoNePfiFKM-aq1dDvk_jBcLj9Ytmy3UNUAU7Qz3AyP9aXKCIDZRvJ_pP6QRUgS5awm43eWv6hBS4Sr4FD0wakdE4VFpfX4c&__tn__=%2CO%2CP-R,28,0,positive,28
pfbid0iHRBKn3gL6jcCsWafZYTg5Ec8rTaDRyxZY6mxkSUhBoBSiSsPfYBM97d4sC2P9htl,NVIDIA AI,2,18,0,0,1,0,0,1,20,2,"The global retail industry has a $100 billion shrink problem. Learn about the retail loss prevention AI workflow, where developers can quickly build and deploy applications designed to prevent theft. https://nvda.ws/3pQmNUT",2023-07-20T23:00:00,[],https://scontent.fcai19-7.fna.fbcdn.net/v/t39.30808-6/360098710_661365776027707_722885136328952915_n.jpg?stp=dst-jpg_p526x296&_nc_cat=109&ccb=1-7&_nc_sid=730e14&_nc_ohc=P-L8HCrAjEoAX_B7ECH&_nc_ht=scontent.fcai19-7.fna&oh=00_AfB8QpBlEi8yHRAwRf630vL9EkKOWF6Aw-XJwb8ETM7OSA&oe=64E2DA77,https://www.facebook.com/NVIDIAAI/posts/pfbid0iHRBKn3gL6jcCsWafZYTg5Ec8rTaDRyxZY6mxkSUhBoBSiSsPfYBM97d4sC2P9htl?__cft__[0]=AZW7Tl9IXnwZgG_mhqtxnw2fqBNmfI7KssFBxsndBrp-WIFKE5QD32ZEDHX0J-bITXje2sBW3q_nJC80zGJ8dbDi0CpNxQAaovc8dD405JObceht0wstXDvUrrDvZ1GCflCUmX9SFKWqozFoAcPwCYLvh-LgZ5vJnPPrq1oN4aX1yfn44V53YwFGpythl49cRnVRaejcBqgjcVN1vytYhNag&__tn__=%2CO%2CP-R,22,0,positive,22
pfbid02JgFRdi31vsGjyCMm6ZKYW4k83t5cTESuA8eFaxUq6dJxhsrr1v4eK7d2U2GMbULFl,NVIDIA AI,1,23,0,0,0,0,0,0,23,1,"Watch Infosys , Quantiphi TalkMap , and NVIDIA  on-demand to learn how #telecommunication companies are using #AI to improve operational efficiency and enhance customer engagement. https://nvda.ws/3YfWV1L",2023-07-20T22:00:00,[],https://scontent.fcai19-7.fna.fbcdn.net/v/t39.30808-6/362244422_661346809362937_162630966436718237_n.jpg?stp=dst-jpg_s960x960&_nc_cat=110&ccb=1-7&_nc_sid=730e14&_nc_ohc=GncsXlklAUsAX9Al-tP&_nc_ht=scontent.fcai19-7.fna&oh=00_AfD87xWRRC4rrnNkq38rArWotWwT2aGk2aTirD-IjqmRag&oe=64E3A1CA,https://www.facebook.com/NVIDIAAI/posts/pfbid02JgFRdi31vsGjyCMm6ZKYW4k83t5cTESuA8eFaxUq6dJxhsrr1v4eK7d2U2GMbULFl?__cft__[0]=AZWIm4lMQw2cDRGGahKJDQqIrg7AaFlWJxldtKMfarxSWZp2Y8Yh1aIZ8QHt_QMzP8BclyLC19MejexGxLb7D3nylY2MCMia-37AT4b2hlaVeu3kAT7RoaKL3u5wnF4kAhljmxESIJXXi6GR71EyscWo4U-aLkgjyRgNmsUVg4g1UJDiTmadlAqn5__5Q_vBg1QTToq-O50QhgWlb9PeZCM7&__tn__=%2CO%2CP-R,24,0,positive,24
pfbid027rBX8AZ8sih5Rrdg4s6didVTdM1JZpTHwB6d4EMzj4yfyhHjcLbT2UUAPhhXDJ5jl,NVIDIA AI,0,13,0,0,1,0,0,1,15,1,"Modeling complex relationships within #timeseries data? Our newest guide includes a notebook and covers the benefits of using interaction terms, along with how to effectively implement them in your linear models. #datascience #forecasting ",2023-07-20T21:01:00,[],https://external.fcai19-7.fna.fbcdn.net/emg1/v/t13/2879831853083592816?url=https%3A%2F%2Fdeveloper-blogs.nvidia.com%2Fwp-content%2Fuploads%2F2023%2F07%2Foffice-people-graphic.png&fb_obo=1&utld=nvidia.com&stp=c0.5000x0.5000f_dst-jpg_flffffff_p500x261_q75&ccb=13-1&oh=06_AbH9H19EHWm_iodPX7ZSt_cpWVAp1ID0yPxaytAZWYW6-g&oe=64E07C48&_nc_sid=dbad39,https://www.facebook.com/NVIDIAAI/posts/pfbid027rBX8AZ8sih5Rrdg4s6didVTdM1JZpTHwB6d4EMzj4yfyhHjcLbT2UUAPhhXDJ5jl?__cft__[0]=AZVf-c5kZLPmi_7Qu9lqHoD6Kt74bgKiMK4hNOBs9k8FFAr1QEAvDFeSfoevEAVBaQ5NlP6leKKFdUnjsn7SlTN2y4BcH3xJgxsV-q0zFTQZsxyBNTN1tSTEAI1LGe4wdhA6tyl_nqY-duk1Q5Ib6QBssCPPs3w65gRQ-dQii2PA2uyWv205VXJqnBrJmq7dnL3qNd1Rc80IABubKl0oE53X&__tn__=%2CO%2CP-R,15,0,positive,15
pfbid0ie4N7KLBddFweh9VvbnkTp4QopyqS1oKuadSc9j5UASdQD3HeU4noD2ucSc1kjiNl,NVIDIA AI,4,29,3,0,0,0,0,0,32,5,"On July 26 4-5 p.m. CEST, watch our technical overview of the GPU inference pipeline. Offering a complete, reproducible demo of how one can take a Pytorch model, compile with TensorRT and inference in production in Triton. Register now > https://nvda.ws/3pXJNS3",2023-07-19T23:00:00,[],https://scontent.fcai19-7.fna.fbcdn.net/v/t39.30808-6/362219459_660835742747377_8761806791427540753_n.jpg?stp=dst-jpg_s960x960&_nc_cat=105&ccb=1-7&_nc_sid=730e14&_nc_ohc=X7hoeTCP9T0AX9zoa9y&_nc_ht=scontent.fcai19-7.fna&oh=00_AfCL4dgim4s7w4_gz6zQ4t6af1kUDn85txqnjZbmbEGLNg&oe=64E40E26,https://www.facebook.com/NVIDIAAI/posts/pfbid0ie4N7KLBddFweh9VvbnkTp4QopyqS1oKuadSc9j5UASdQD3HeU4noD2ucSc1kjiNl?__cft__[0]=AZVDyD3keMLMxD_qQb6sf6ugeiL8rOJUF6sfIz6LshTtaPIVnj8OoGXKUkEgAdE4ih4TUXvXK7rMXhdaRnqzQVqp7IZUJevG2BOuyDkyAKZSdOcQay38g07AX0xxffLmbyy4jp3A4Bxjs3c7N0u2vW8E7S6ioh1YlluyuDUtb7WxgJn8Gnns8kZ-O2ppNZ-zqYXYQQ8kLakIbO87dcKzZc6C&__tn__=%2CO%2CP-R,36,0,positive,36
pfbid02mC36uUTYJHVXUcsLkghyta7hXGZRpJbZ6FWCCGnTLFyYNTJc5wGZaAuZkrpvf47Bl,NVIDIA AI,0,17,1,0,0,0,0,1,19,2,"Pose estimation in #computervision helps us better understand neural activity.  Read how DALI is being used in #deeplearning to more precisely track natural movement for giving insights into health, intelligence, and interaction: ",2023-07-19T22:02:00,[],https://external.fcai19-7.fna.fbcdn.net/emg1/v/t13/6260145794110019246?url=https%3A%2F%2Fdeveloper-blogs.nvidia.com%2Fwp-content%2Fuploads%2F2023%2F07%2FLightning-Pose-mouse.gif&fb_obo=1&utld=nvidia.com&stp=c0.5000x0.5000f_dst-jpg_flffffff_p500x261_q75&ccb=13-1&oh=06_AbGJqppFp6z3VOBl-dJEYA6Uul_37SRgShbFrINmB8TnOA&oe=64E00395&_nc_sid=dbad39,https://www.facebook.com/NVIDIAAI/posts/pfbid02mC36uUTYJHVXUcsLkghyta7hXGZRpJbZ6FWCCGnTLFyYNTJc5wGZaAuZkrpvf47Bl?__cft__[0]=AZUrxsVlERebhDsYUIZ8sg5UujxgKVRX0Pv7fkznq08aqFq9SBXwQII66-wRhJQfnavdJgdkKBDIxEXw5yXIFPbKAP8inB3E2DSuA0jyMc67Is_0Zso96OYKS5s6WCcv6Bcq_o7dDpgrXhP1V4AvRgzjxH_LQKOrBwQA4lJLM102ZrCbzKtvWJj25MHSVGmUuXd9IjxiXxxtOHQ31OD_lAeq&__tn__=%2CO%2CP-R,19,0,positive,19
pfbid0EMWCBc4dpq7nWzC3eEiZWM1A5ERWUzBGEE2n9rKXP5Uxvt7gnvKnmneV6nbe8RYYl,NVIDIA AI,0,13,0,0,1,0,0,1,15,0," Congratulations to the winners of the  Amazon KDD Cup 2023 for all three tracks: NVIDIA-Merlin team members Chris Deotte, Benedikt Schifferer, Jean-Francois Puget, Kazuki Onodera, and Gilberto Titericz. ",2023-07-18T00:00:00,[],https://external.fcai19-7.fna.fbcdn.net/emg1/v/t13/12519567001816994598?url=https%3A%2F%2Fdiscourse.aicrowd.com%2Fuploads%2Fdefault%2Foptimized%2F3X%2Fb%2F1%2Fb16da8570e4afdccc811d9e54c261369a40eda73_2_1024x536.jpeg&fb_obo=1&utld=aicrowd.com&stp=c0.5000x0.5000f_dst-jpg_flffffff_p500x261_q75&ccb=13-1&oh=06_AbEH2ExUPFLIgy1df7eOpy1NMPU3VJ2aUtHn80h0BQKu9Q&oe=64E05A51&_nc_sid=dbad39,https://www.facebook.com/NVIDIAAI/posts/pfbid0EMWCBc4dpq7nWzC3eEiZWM1A5ERWUzBGEE2n9rKXP5Uxvt7gnvKnmneV6nbe8RYYl?__cft__[0]=AZU4LuQhY7Lela3kbQiD5N0vY8XlWU2HzKpGll-UQEs7t9G5OCnDTHSmw1hhuFSErWRjClHr7LxlXh4EdEJHGSD_0qTV2UFHni7MWo5BVU98mjcXBU2qXsdIoOBkzEfre9Q_fjt40eFYULnKXrP43hnY6odbo-hVga6n2w72Y9tbwhedfSVtB5ZOGTWPdbX6dGTjebOXZkibxoXiIvm_Wxu-&__tn__=%2CO%2CP-R,15,0,positive,15
pfbid0eqEceHcndKJn97h4mHcbFzkMbAuJHiKn2sEsoBqKstdnXVCMrPbFnW1JzjLBGom8l,NVIDIA AI,0,11,0,0,1,0,0,1,13,0,"Join our upcoming Ask Me Anything session to connect with experts behind the latest NVIDIA #CUDA Toolkit 12 release. Learn about the new features, use cases, and applications.  July 26 at 9 a.m. Pacific #AMA ",2023-07-18T00:00:00,[],https://external.fcai19-7.fna.fbcdn.net/emg1/v/t13/13435397952077567092?url=https%3A%2F%2Fprod2-sprcdn-assets.sprinklr.com%2F50276%2F104152c2-a7c7-4730-ac4f-bf295da7e8c6-1729760866%2Fsocial-ama-cuda-12-1200x628.jpg&fb_obo=1&utld=sprinklr.com&stp=c0.5000x0.5000f_dst-jpg_flffffff_p500x261_q75&ccb=13-1&oh=06_AbHC8bqigosIFUKlEWlIYv_9udI0xbZRvjhkaqhVmhp7gw&oe=64E05369&_nc_sid=dbad39,https://www.facebook.com/NVIDIAAI/posts/pfbid0eqEceHcndKJn97h4mHcbFzkMbAuJHiKn2sEsoBqKstdnXVCMrPbFnW1JzjLBGom8l?__cft__[0]=AZVsRugbBoTQi20FlVwg7RcyG_jIgKX9m-zfF6bvW8PzsbQ15hs_IKKVk3dBRNv4TfzdI-zcdOwSvxMI2GvxchcibXFssglRBNvXD3prC6pYzBGlDWAveB95f0-bvYdZNJwYGsoZ4FYjH_behtMdnM3PYsufFDrGe6nIwZM-_pXr7NTLxChdqRfRhYv2i7Kydsu-UMh7vVDCJsmYqK_A-klY&__tn__=%2CO%2CP-R,13,0,positive,13
pfbid024H7vm9DYXQ9Rk8PrrKdUipqJ2THqjwswPRGHpGL7i3EEwKGtSb9QXVJWJ2jmBTCQl,NVIDIA AI,1,18,3,0,0,0,0,0,21,1,Four ways #retailers can leverage #generativeAI to drive revenue and productivity. https://nvda.ws/3NXaqOV,2023-07-17T00:00:00,[],https://scontent.fcai19-7.fna.fbcdn.net/v/t39.30808-6/359833281_659776276186657_9183294488871858524_n.jpg?stp=dst-jpg_p526x296&_nc_cat=102&ccb=1-7&_nc_sid=730e14&_nc_ohc=6qNLwvE_GT8AX-VlRjm&_nc_ht=scontent.fcai19-7.fna&oh=00_AfAaJy01jU-AT2DEBq-6XDpj8CNePCwlZ2u0ab_eMMspZA&oe=64E443CE https://static.xx.fbcdn.net/rsrc.php/v3/y9/r/Z-dbClQDXLv.png,https://www.facebook.com/NVIDIAAI/posts/pfbid024H7vm9DYXQ9Rk8PrrKdUipqJ2THqjwswPRGHpGL7i3EEwKGtSb9QXVJWJ2jmBTCQl?__cft__[0]=AZWitHZW8fe1i3A29JpxSWNvWNWH6dupN-sYiOFY5iK159KpRHLY2hmGsDDD3pw69DhFXs-YQ4pdj2zUybilwpT-dx3qr06m59LgWo1ZT3BUnFCTjOm8PlNwKR4iqUyFlZrIh345OTZZx0SkJsyg4EJzwFsVKEkUmmpYKOXDDEo1ck89OtVN3lMyz4UgOIABECPDOUjcQLO8NAMp_jnwBv4H&__tn__=%2CO%2CP-R,22,0,positive,22
pfbid02iWxZKgja1sdmLWDu41EBSRrEi4RqyyGufijEvDx1LDKuVYidyoxAbaD4JgMbbxhal,NVIDIA AI,0,11,1,0,1,0,0,0,13,1,"Check out our latest blog to learn more about #generativeai and see how it is increasing productivity, automating tasks, and unlocking new opportunities across every industry. https://nvda.ws/44Q2oOA",2023-07-17T00:00:00,[],https://scontent.fcai19-7.fna.fbcdn.net/v/t39.30808-6/359824722_659755639522054_735898591364950702_n.jpg?stp=dst-jpg_p180x540&_nc_cat=104&ccb=1-7&_nc_sid=730e14&_nc_ohc=IPn1NqcO_w4AX-yfwFD&_nc_ht=scontent.fcai19-7.fna&oh=00_AfDji12cmG_mehM9PZI-j6x-5QXJKvrlEDSVll3h8pMQLw&oe=64E3AB3F,https://www.facebook.com/NVIDIAAI/posts/pfbid02iWxZKgja1sdmLWDu41EBSRrEi4RqyyGufijEvDx1LDKuVYidyoxAbaD4JgMbbxhal?__cft__[0]=AZUxmD3DG1o9zVuTTtOkhJhtC-xg0GALsUYRIzv4e0keQQDaNe_PHwCi9A_bPXHeLPb0t_ZfaC8rD1Gk3ITdSkBclhxIFAMKBilKvtKo--2wsdgtmd3IogqHkAltq49sosxIDb70gD5wjfNDHbnQ80gM4UFBn5EPFeQ7_-VkuxC0SL1wlf5jukQ_STBKtCHz6oylbIHFbZIB3QbilRkB6DGX&__tn__=%2CO%2CP-R,13,0,positive,13
pfbid0MUySv98UUKKqoC8se5puij18spgrLkc9ieZJp7n8dhPBNodvQhpXSG12S2J7pps2l,NVIDIA AI,0,23,0,0,0,0,0,0,23,1,Discover how the power of AI and NVIDIA's cutting-edge technology can drive unprecedented business growth and fuel your digital transformation journey. Join us at Microsoft Inspire to witness the future of accelerated computing. #MSInspire #NVIDIAonAzureJoin us: https://nvda.ws/44G3hcH,2023-07-17T00:00:00,['blob:https://www.facebook.com/d871e498-2655-4aed-a67d-39277688af3f'],https://scontent.fcai19-7.fna.fbcdn.net/v/t15.5256-10/361130633_144998988615745_5089901162742914268_n.jpg?stp=dst-jpg_p180x540&_nc_cat=106&ccb=1-7&_nc_sid=ad6a45&_nc_ohc=r6Ad2MW3XxgAX9M5tYJ&_nc_ht=scontent.fcai19-7.fna&oh=00_AfCvLRCjaqOawKblhUzQomhrp3I_PcabGhtcT0u7kbFc1w&oe=64E3BF45,https://www.facebook.com/NVIDIAAI/posts/pfbid0MUySv98UUKKqoC8se5puij18spgrLkc9ieZJp7n8dhPBNodvQhpXSG12S2J7pps2l?__cft__[0]=AZV_23Crf8oYQKNCDrZP95vT3NRf7qBWeClj0EEKQ216HLNToyJUoedpiRS37h-P3BCQPVNRUS9INyazG5TMzTPW1GzRVBU6xIKg2nnxizWVaf7kdx3qY9U60skgFfFQUn8ixvkggyGXtqSecsPB-JaxsIhoF0XWp1yoQnZeoQirtd8F_XECbY_zrdPzC9SpnKeDE9ZQK8HOZf8MILEswGaT&__tn__=%2CO%2CP-R,23,0,positive,23
pfbid0MKFhr6xXqw6QJzLAekMr6faanHpK6u1ADdjX7yLiYNbtipfNtRuULMuvZgQm7v3Fl,NVIDIA AI,0,16,0,0,1,0,0,1,18,0,"Join this webinar tomorrow to get a breakdown of how our genomics tools are being used in actual research! Dr. Tychele Turner from the Washington University School of Medicine will touch on areas where such tools benefit best from GPU-based acceleration, including her lab’s use of NVIDIA® Parabricks®. Register: https://nvda.ws/3NI8bQP",2023-07-16T00:00:00,[],https://scontent.fcai19-7.fna.fbcdn.net/v/t39.30808-6/360132226_659086846255600_7981120846583077900_n.jpg?stp=dst-jpg_p526x296&_nc_cat=101&ccb=1-7&_nc_sid=730e14&_nc_ohc=wco-xpzaf0IAX9KKWL_&_nc_ht=scontent.fcai19-7.fna&oh=00_AfAZVutj5CqetXrPSF0vqK9xMkUuP4ODAEPEQ_BKhIv4RA&oe=64E36FC1,https://www.facebook.com/NVIDIAAI/posts/pfbid0MKFhr6xXqw6QJzLAekMr6faanHpK6u1ADdjX7yLiYNbtipfNtRuULMuvZgQm7v3Fl?__cft__[0]=AZWLLw95ST3QeZjCsS8PQvEkzAjgz4u-Tjztly_97Eo5QmQzaHxj5eF0L2L2mw11_BWvrKiS9WKXK-qV3I0KfRQsFJRO6tF3N47kRbue2J1wMA-z73J5tAwG6-QaMCSs5lWfV80_oIejJOKIaAKM6Izh__qsDBoehLe2B5AdXutuekTyA2cE6Sv6mGX96mhr4CoMLGZUlpT70swhtNwOKBGe&__tn__=%2CO%2CP-R,18,0,positive,18
pfbid036kHxiP8pLzo5vC6zDbRdP2DTVUwnffnRkwDQocm6TdTuPaEWiseJ9Bn8bMpJvQn9l,NVIDIA AI,5,26,0,0,2,0,0,0,28,2,"Energy companies such as AVEVA, Siemens Energy, and Vestas are automating industrial equipment and processes with physically-accurate digital twins. Learn how AI helps maximize site production, reduce unplanned downtime, and lower costs. https://nvda.ws/3JXcncS",2023-07-15T00:00:00,[],https://scontent.fcai19-7.fna.fbcdn.net/v/t39.30808-6/360089951_657985756365709_7990644523771909010_n.jpg?stp=dst-jpg_s960x960&_nc_cat=101&ccb=1-7&_nc_sid=730e14&_nc_ohc=Jh7AO1Rl6_4AX_E4owy&_nc_ht=scontent.fcai19-7.fna&oh=00_AfAwFlbcvsmDOtIQniga91iwXPrvoZ04w3LJC38RlUXcQg&oe=64E2D685,https://www.facebook.com/NVIDIAAI/posts/pfbid036kHxiP8pLzo5vC6zDbRdP2DTVUwnffnRkwDQocm6TdTuPaEWiseJ9Bn8bMpJvQn9l?__cft__[0]=AZWzNDhrr2DeiwsZaEIGYS91RDDBy4fErPwIJjVFA60N6mfsQpzn8Hsai8XqVev1c10B61K2z7Swf-BEi7FBLfwt1wZ91d71t0yMVYAsJ8fFNs-Q8jp2haOcf5Vo2WqzeNWAvBQXTUOJ3gPKvmr0MXigegldfF1ZTbbx0kjnLEJE26c4F2zuva0n1AfyCn4npJCDOV29I-aAFkpxmBcu6kVd&__tn__=%2CO%2CP-R,33,0,positive,33
pfbid0y77vCQxeJ7R8F97s6DSHbF93rzEjyBmt1S7Amgtwn2a8UTXzxfZoCk1efTEq98f3l,NVIDIA AI,18,57,8,0,0,0,0,0,65,1,Watch the Retail Edge Computing 101 webinar to get an introduction to edge computing from the leader in AI and accelerated computing. https://nvda.ws/43mghD7,2023-07-14T00:00:00,[],https://scontent.fcai19-7.fna.fbcdn.net/v/t39.30808-6/359812221_657390963091855_5672775622957987881_n.jpg?stp=dst-jpg_p526x296&_nc_cat=103&ccb=1-7&_nc_sid=730e14&_nc_ohc=TJqgRJ8hHoMAX_QywLO&_nc_ht=scontent.fcai19-7.fna&oh=00_AfAuqwSwLjFT3Mpy-GSfBEFjw2zdJVcfJ_PTUZDTUF2HTQ&oe=64E3A682,https://www.facebook.com/NVIDIAAI/posts/pfbid0y77vCQxeJ7R8F97s6DSHbF93rzEjyBmt1S7Amgtwn2a8UTXzxfZoCk1efTEq98f3l?__cft__[0]=AZWyMthmF0-0OjuLNwY6XM2CK20UVgkNTmDOtxMNWq4OdV3diQCPh1GeRyBN2Nc6hYdPiEMXoL-XO__9eRgXc7b2bgjTWOKlkHosCepgHPpiHLsctopHXnffJx_KB9ldNQsdDMQzWN5hl9NwMvTKsspD2SJawDwuhNmyLrNEW7E8ZwYUBZt6gisuJSx-T0aaoXhASh9copIneuoup3PPBrV2&__tn__=%2CO%2CP-R,83,0,positive,83
pfbid0N5vMym1Fi5e2vZjE1kL4JPuxr2LLV9ejrwqppgBPbFRyHYnZkB8ViWkaAHySNR4Nl,NVIDIA AI,3,21,0,0,0,0,0,0,21,1,"Companies worldwide are leveraging edge AI for the real-time insights they need to make faster, more informed decisions - and the difference is real. Lenovo's eBook describes how edge AI solutions like those developed by Lenovo + NVIDIA are enabling success in industries such as retail and restaurants, smart spaces and security, manufacturing, healthcare, energy, and telecommunications. Access it now: https://lnv.gy/43qHd4C#TheDataCentered #ThinkInnovation",2023-07-13T00:00:00,[],https://scontent.fcai19-7.fna.fbcdn.net/v/t39.30808-6/359761168_677101877768026_2600124324584356409_n.jpg?stp=dst-jpg_s960x960&_nc_cat=101&ccb=1-7&_nc_sid=730e14&_nc_ohc=cChdBltjmnQAX9hGZsQ&_nc_ht=scontent.fcai19-7.fna&oh=00_AfCIYuque3B9LEL-WXkLqNkIXshjj2D-Zm50qmxsRdiXww&oe=64E44C71,https://www.facebook.com/NVIDIAAI/posts/pfbid0N5vMym1Fi5e2vZjE1kL4JPuxr2LLV9ejrwqppgBPbFRyHYnZkB8ViWkaAHySNR4Nl?__cft__[0]=AZV_T7bufqnCos0Jbfh5ngDcDqRGep92gLbK2rckoXomyulCQX01W2_AG6ed4rvlD7_jGtUYCBJq43eG70u__L57mxqTQG4iUmBMTDRVFK4ShGdHAbm99l9El5sxvm2sW0B8U-B3-VkdFcIP_pSquoiJCrvpeezi1vXbCkJ60_-lt73AGBHrmoXOiuAN-AGsLci912n81Kyk95p35mjLbSQVhpn7WmRSIhtsZqzmHAPKJ4bPFcyJpJIyGX04kkIlet0&__tn__=%2CO%2CP-R,24,0,positive,24
pfbid0uoZkkw9ww7cJiH4TAyqLirjUU4LiRffpcuzCFhBihpLp6rzznY85fwMGzSmYCw9Wl,NVIDIA AI,0,12,0,0,1,0,0,1,14,9,"GenAI is impacting every industry today - from renewable energy forecasting to drug discovery, and more. Read our blog to learn about the business requirements for putting #generativeAI into practice: AI expertise, tons of data, and accelerated computing. https://blogs.nvidia.com/.../generative-ai-for.../...",2023-07-13T00:00:00,[],https://scontent.fcai19-7.fna.fbcdn.net/v/t39.30808-6/359828477_657242433106708_8252266160176983705_n.jpg?stp=dst-jpg_p526x296&_nc_cat=107&ccb=1-7&_nc_sid=730e14&_nc_ohc=Fw4VxSgEuqAAX9TbiN6&_nc_ht=scontent.fcai19-7.fna&oh=00_AfB4SdlO49GqODN1g0SZq_Tzk_VJr5atghn4r49kDafpbA&oe=64E2B179,https://www.facebook.com/NVIDIAAI/posts/pfbid0uoZkkw9ww7cJiH4TAyqLirjUU4LiRffpcuzCFhBihpLp6rzznY85fwMGzSmYCw9Wl?__cft__[0]=AZWcsNIdRQbNbmunKczIPhMqa_iKEkLlxDZWlAP7x_SjACCQmC-pe0lhY48vCfVWA1hkoyMPfjvS3gUiq7FouJcvWZdcJrFmGyqJXrbcfS4qTD_98aF65O9PJgi5Qu_8QCsGQ09ZCjYMspLZOOBeF9fZhEbyPIx0uLyF0ou39zICBd40r3WsSPf13yKG8KurpQA_MgXUnP5E94g3qPddXBtb&__tn__=%2CO%2CP-R,14,0,positive,14
pfbid0GfBGAuVszABwShfDLGpuQ2HyXJi21htVa9jT8oBDYtBLMyUukB6Cfq4c5hkkR9rBl,NVIDIA AI,2,27,0,0,0,0,0,0,27,1,"Get ready to take your AI practice to the next level. Join us at Microsoft Inspire to learn how NVIDIA and Microsoft are making AI accessible and efficient with powerful toolkits, infrastructure, and support. Don't miss this chance to transform your business with generative AI. #MSInspire #NVIDIAonAzureRegister and join us: https://nvda.ws/44rG25Q",2023-07-13T00:00:00,[],https://scontent.fcai19-7.fna.fbcdn.net/v/t39.30808-6/358694146_657218209775797_5888704102871430807_n.jpg?stp=dst-jpg_p180x540&_nc_cat=108&ccb=1-7&_nc_sid=730e14&_nc_ohc=6OhicVfj4lMAX_kICer&_nc_ht=scontent.fcai19-7.fna&oh=00_AfCR2UXDkAPemqp_7gACf_mykYEhgbzS1gzq1yCl5yW9qQ&oe=64E3C7B7,https://www.facebook.com/NVIDIAAI/posts/pfbid0GfBGAuVszABwShfDLGpuQ2HyXJi21htVa9jT8oBDYtBLMyUukB6Cfq4c5hkkR9rBl?__cft__[0]=AZVZ9sRh2rnPbC6N6mSV70oZfhmDDLaPY8Eidov2v6uexfJ8097wr7XGKZMvqiJ_u23n1FfTJEOAiJ3L0g-MkEqN64MGq3OXXXv9EHgfF3y9uVy4Ef8I7viTseY4Bthg5tsjFHs0Aoi6NfspOFFLTFUtwyBapRmfghpvBIdf0-GFBFAAt0T-uC5ZOyg9EXZYsG7ac68gZ2nbAj8sJcqXGVWc&__tn__=%2CO%2CP-R,29,0,positive,29
pfbid038LU1oS8btXWxEfiEYMJJYmyJTuinaFHtawQkJdPLALz8bWLCSbj1rgMQtdoQkmvEl,NVIDIA AI,5,50,7,0,0,0,0,0,57,2,AiFi provides the most flexible AI platform that enables retailers to affordably deploy and scale autonomous shopping solutions across their businesses. https://nvda.ws/3XSheSv,2023-07-13T00:00:00,[],https://scontent.fcai19-7.fna.fbcdn.net/v/t39.30808-6/360101665_656828636481421_7339838943305651603_n.jpg?stp=dst-jpg_p526x296&_nc_cat=103&ccb=1-7&_nc_sid=730e14&_nc_ohc=xnylXNuMWH8AX89ADO2&_nc_ht=scontent.fcai19-7.fna&oh=00_AfDBNCq3Y-9eyuGvYhQRZUVwQij7tYnHnLbKDk1DZbIQfA&oe=64E38C3D https://scontent.fcai19-7.fna.fbcdn.net/v/t39.1997-6/65980576_1154163204707673_6858598039070703616_n.png?stp=cp0_dst-png_s110x80&_nc_cat=1&ccb=1-7&_nc_sid=ac3552&_nc_ohc=CWFscBaFhIMAX-hMpzh&_nc_ht=scontent.fcai19-7.fna&oh=00_AfDFM8Uk4aitt_Y5FAVwlO5NC21tFVj6lT6shAAIJ2PQ0A&oe=64E3EB09,https://www.facebook.com/NVIDIAAI/posts/pfbid038LU1oS8btXWxEfiEYMJJYmyJTuinaFHtawQkJdPLALz8bWLCSbj1rgMQtdoQkmvEl?__cft__[0]=AZUD5Pja96OLLyBrumh4cVIsaaOseY5lldnLIYTuCp79r0MHKyqbFCVbiuD5klIgLGPyoTT81YwkbqF03z5wAcrJYOUHAmVXkDFtZfu9xeClOoPl3D3tw9BFcwEgqN0tQ6h_lfJzV7ahZwv1JaWKHha9n6aDQYIqIQWQcnQTPr-6OMX5K_UbnzsOgjgnGgsW7kUqZn34xiOxmM8AK9Cs9kwL&__tn__=%2CO%2CP-R,62,0,positive,62
pfbid02QhW9qqgGrS6ggXDMYcbo6xdM1myEM5WwYqVgCHnqhqvJvKFoRb4kDvbjEursgSNml,NVIDIA AI,0,11,0,0,1,0,0,1,13,1,"At #SIGGRAPH2023, witness the capabilities of our latest Text2Material #generativeAI for interactive physically based rendering, generation, and editing on foundation models connected to #NVIDIAOmniverse.",2023-07-12T00:00:00,[],https://external.fcai19-7.fna.fbcdn.net/emg1/v/t13/16496805632531345302?url=https%3A%2F%2Fprod2-sprcdn-assets.sprinklr.com%2F50276%2Fbcbd5441-cc0b-4600-a637-79e2707a2e0d-35965104%2FScreenshot_2023-07-12_080459.jpg&fb_obo=1&utld=sprinklr.com&stp=c0.5000x0.5000f_dst-jpg_flffffff_p500x261_q75&ccb=13-1&oh=06_AbGc7mPW-q8aOeq_ATNQaSAJ2kNW7kpRm0Rhb9byKAPHBA&oe=64E057D8&_nc_sid=dbad39 https://scontent.fcai19-7.fna.fbcdn.net/v/t39.1997-6/64706043_1115326111985571_1183620470549774336_n.png?stp=cp0_dst-png_s110x80&_nc_cat=1&ccb=1-7&_nc_sid=ac3552&_nc_ohc=omGhNacwSnQAX_6_GMD&_nc_ht=scontent.fcai19-7.fna&oh=00_AfBI_jIaNyJo8De9zZqpGz1H0k-MOZtU-sHNVFwMO2jdWQ&oe=64E4493B,https://www.facebook.com/NVIDIAAI/posts/pfbid02QhW9qqgGrS6ggXDMYcbo6xdM1myEM5WwYqVgCHnqhqvJvKFoRb4kDvbjEursgSNml?__cft__[0]=AZVZzN2RG0ZYa3EBB13lESztNWaMyTWhYjFIVc3fp50gnp0xr2Uv1C-PZES2UmoEfzD9WhZNIENCk-xXejEhX6YRFXszsMmVoYJ_hxVnfOlEAqnlTYZ7sbPxwurERfYzuIT_enk9PYtNeNXDbgPDbwt7UHXPIOGj-DWIwHtnCox5ep8nbRGB7TRPqJ8fcCyn0rza2su0_KnL-jk7Tv7whFIx&__tn__=%2CO%2CP-R,13,0,positive,13
pfbid02GkxuzRbmkyYeJBNRu6kdURdQ6zLJtKXzX91GfsZWXd2iiFMnsJ6jJmM2bLn5KhEul,NVIDIA AI,0,10,1,0,1,0,0,0,12,1,"The Future is Personalized: The Power of AI Recommender Systems in Crafting Tailored Experiences [Part 1]The digital landscape is evolving at a rapid pace, and Artificial Intelligence (AI) is leading the charge. One of the game-changing applications of AI is recommender systems, which have become integral to the modern digital economy. These systems sift through extensive data sets, analyzing user preferences, behaviors, and more to generate customized recommendations.I explored the fascinating world of AI recommender systems in-depth. In particular, these systems are being utilized to enhance customer engagement, improve decision-making processes, and increase the efficiency of services across multiple sectors. From curating playlists to assisting in healthcare diagnoses, and guiding investment decisions, recommender systems are leaving an indelible mark.by Ronald van Loon |Learn more about NVIDIA's triumph at the KDD Cup and how GPU-accelerated recommender systems are transforming the digital landscape: https://bit.ly/3O8Bk7Q #NVIDIAPartner NVIDIA NVIDIA AI #AI #RecommenderSystems #DigitalEconomy #CustomerEngagement #Innovation #ArtificialIntelligence #CloudComputing #Technology Cc: Sally Eaves | CXO SPICE | psb_dc |",2023-07-12T00:00:00,[],https://scontent.fcai19-7.fna.fbcdn.net/v/t39.30808-6/347599721_685870956885897_7199880134129315815_n.jpg?stp=dst-jpg_s960x960&_nc_cat=106&ccb=1-7&_nc_sid=730e14&_nc_ohc=2f1-wmwLg_UAX8fLWOu&_nc_ht=scontent.fcai19-7.fna&oh=00_AfBw3vFniLmf4pvVRCscGYbLx3hl6M6hbn0gorneUeifEA&oe=64E3FA84,https://www.facebook.com/NVIDIAAI/posts/pfbid02GkxuzRbmkyYeJBNRu6kdURdQ6zLJtKXzX91GfsZWXd2iiFMnsJ6jJmM2bLn5KhEul?__cft__[0]=AZVlvgSPZJiaIV7Vilzm-OYySZ13jbhRyJDcr6rTTsCgxWNU7N_9amaOYq8nKyrtWOvlQmlFosxrCCQ92kyVS5l4vftH7ZkvoRZJR2z8Se5tjn2QNmGqTzw_Z8WSRcEOLmyeRmDQL5CAVO-IPtsMWZw3h1c_3NkgVhxgkBriCqiNREY6wDr4Ka-toEYYMSjKFE1UTJC_XSaNUGuE1ywp2viKgFfSyThybxCVI6RvfopfKqZFqe0AHJdqMXcikZXC810&__tn__=%2CO%2CP-R,12,0,positive,12
pfbid02SuwBTQtLTSxzUpLRdp42Pz5aK2nqriDnq1u3NDuAnNdkiZkTS8Uzp19sGzywmaEbl,NVIDIA AI,2,22,4,0,2,0,0,0,28,1,Congrats to NVIDIA AI’s machine learning experts who won all three tasks in the 2023 Amazon KDD Cup competition to build state-of-the-art recommendation systems. #recsys ,2023-07-12T00:00:00,[],https://external.fcai19-7.fna.fbcdn.net/emg1/v/t13/14615482063012829366?url=https%3A%2F%2Fblogs.nvidia.com%2Fwp-content%2Fuploads%2F2023%2F07%2FKDD-Cup-win-KV-scaled.jpg&fb_obo=1&utld=nvidia.com&stp=c0.5000x0.5000f_dst-jpg_flffffff_p500x261_q75&ccb=13-1&oh=06_AbHC--44yUb-JRKHCnYjtMH4p4-U7xoJaeVGPxT_l4rDyQ&oe=64E00875&_nc_sid=dbad39,https://www.facebook.com/NVIDIAAI/posts/pfbid02SuwBTQtLTSxzUpLRdp42Pz5aK2nqriDnq1u3NDuAnNdkiZkTS8Uzp19sGzywmaEbl?__cft__[0]=AZXFm31ZBwbnBvIsknBDrDES4DCTYlpGfLLXxyo5x5FOsYAfizw9TJhOk038yBbXkUaFLvPDvCbGTwjE5TdwjaXqlKFAsUIGsSV-nX-lMu0kRm4DfBZI5Kn_GStpOyzZ0mzBnIC1V3nojFGLTsmq0gXbhIBeAfL7sT_BLVFWU9G6GQkghIeKdMQmvbqcHUvdJoIFMu1BnvPESkpj4Rd-JW7I&__tn__=%2CO%2CP-R,30,0,positive,30
pfbid02BDn5ANvbRW7p8BgcqcEod3KBhFGFV2VipkepjVyMWubX8dR3tHEhVwacjRuqfhKSl,NVIDIA AI,0,24,0,0,0,0,0,0,24,2,Ready to unlock the power of AI to solve complex problems and drive business growth? Join our live expert-led panel as they answer your questions and reveal how NVIDIA AI solutions on Azure Cloud can revolutionize your customers' processes. #MSInspire #NVIDIAonAzureRegister and tune in: https://nvda.ws/46z6YT7,2023-07-10T00:00:00,[],https://scontent.fcai19-7.fna.fbcdn.net/v/t39.30808-6/359703859_655600716604213_5040215904345489113_n.jpg?stp=dst-jpg_p180x540&_nc_cat=105&ccb=1-7&_nc_sid=730e14&_nc_ohc=UzxfY78JYR4AX_zMPrr&_nc_ht=scontent.fcai19-7.fna&oh=00_AfBg3ZVBQntRVVWovRa7Sw2-gJyw5r5wBwLw1u6VcI2E0g&oe=64E35EF7,https://www.facebook.com/NVIDIAAI/posts/pfbid02BDn5ANvbRW7p8BgcqcEod3KBhFGFV2VipkepjVyMWubX8dR3tHEhVwacjRuqfhKSl?__cft__[0]=AZXCsEeaMifH5T4N7tKBThgiHiTaoQMkQoVX27JAhkEjw188YNYFjKNxOmjHwbnY2nFdcoLhhSFZ_Gn9jk_ntM1k_d0UxWAB0OmB68YwCcn3ZN2SlHwn2MYJDlw89-wUZ2X4Cl19uwoY8SYT6tEN_DUU-0dcadlA98K6rQiC_N-NYGHOVlv2ezh5-zz7Iwg7oiOlDoKCriMoyXEWogbnrzAb&__tn__=%2CO%2CP-R,24,0,positive,24
pfbid0j2q9YhK696eHxVAeY3dmp6eZdRZvVnLMeo8KUCjnreAgXvVABdt1aMeH646i753l,NVIDIA AI,0,30,3,0,0,0,0,0,33,3,"Want another chance to learn about #AI and connect with NVIDIA experts? Get insights during live speaker-hosted #GTC23 session replays on Deep Learning Demystified and Speech AI Demystified. You'll have the opportunity to get your questions answered with a live Q&A or exchange ideas with peers in real-time. It's all happening July 11-12, 2023 online. https://nvda.ws/3CWo2EW",2023-07-10T00:00:00,[],https://scontent.fcai19-7.fna.fbcdn.net/v/t39.30808-6/359034163_655580826606202_6268071415676152666_n.jpg?stp=dst-jpg_p526x296&_nc_cat=101&ccb=1-7&_nc_sid=730e14&_nc_ohc=ZDiDXvbMshEAX8twFQD&_nc_ht=scontent.fcai19-7.fna&oh=00_AfB44oBVe9fgiKRt42dTs64qD9wu7qKfn-7HorCahTe8fQ&oe=64E2A0EC,https://www.facebook.com/NVIDIAAI/posts/pfbid0j2q9YhK696eHxVAeY3dmp6eZdRZvVnLMeo8KUCjnreAgXvVABdt1aMeH646i753l?__cft__[0]=AZV1RqDRWgZa_yyG3iCcKvd3KathxnBOdGhR9mT2YNUlUamZmFU0eu0mBHH5uYnfOzgorKfBEapp-knJNoUb06AEN21DJF42FdNJI4iDjxAae5UWsQcTB07Os5dDBYsgIGXzwA9Ub77CPV4CVzT6kcSCvcnrTJvaW6A2o-5IsBp03WGXQ9LpJy5XbNTtTQtGKwVN-HhYjDRPADaBShDBNnv-&__tn__=%2CO%2CP-R,33,0,positive,33
pfbid02EbUw9ZQj4bUkKTVWzDa47Pt3Cw4JTetMykVqepyYJahqzKZERKT4dtk2Wevn7WW6l,NVIDIA AI,0,15,1,0,2,0,0,0,18,2,The application deadline for NVIDIA and Bridge to Turkiye’s Disaster Response Innovation and Education Grant has been extended to July 21 at 6 PM PT! Turkey-based researchers and educators working to enable a disaster-resilient future are invited to apply.  https://nvda.ws/3oWVs2Q,2023-07-08T00:00:00,[],https://scontent.fcai19-7.fna.fbcdn.net/v/t39.30808-6/358373157_653744026789882_986248468100713347_n.jpg?stp=dst-jpg_p180x540&_nc_cat=100&ccb=1-7&_nc_sid=730e14&_nc_ohc=LJaxNWbwuywAX9WqcCa&_nc_ht=scontent.fcai19-7.fna&oh=00_AfAzJM80dIWec0zL-gXIjAIe6BPK1xYwf_ylQaDKBMyWkg&oe=64E41583,https://www.facebook.com/NVIDIAAI/posts/pfbid02EbUw9ZQj4bUkKTVWzDa47Pt3Cw4JTetMykVqepyYJahqzKZERKT4dtk2Wevn7WW6l?__cft__[0]=AZU97ROalaBuNBYUgkNhfk3semjJIAEz9hlRrv7JKsYy_HY-vh1O2RynJGfXPdoh-cpvvQKSwcfahYGuFUHh0Ydo0UFmrAxvX8nGROyPImh1hQq-sRSo1XtKWiWrZ-rJdcJOhchUeyCYrmQ9ois9N2ACVL-1KuOa7rkMWVIcOWS5H9tb2lf8z1bgAKhmNCg2wdEcV1h8kMnQkBRgKGLKs1R2&__tn__=%2CO%2CP-R,18,0,positive,18
pfbid02z8kJJcWKuoPrUzL27qDqnpTnYCxZtqQntK8C1e5PBaAKgGN1oYwebR4uCjegh5Z1l,NVIDIA AI,1,26,0,0,0,0,0,0,26,1,"Join us at #MSInspire, where opportunities meet innovation. Discover groundbreaking strategies at our featured NVIDIA breakout session, engage directly with experts in our live Q&A, and explore AI's game-changing role in advertising with Seth Juarez of Microsoft and Stephan Pretorius of WPP. Let's collectively shape the future of digital transformation. Don't miss out.Register to join us: https://nvda.ws/3O4fiDm",2023-07-06T00:00:00,[],https://scontent.fcai19-7.fna.fbcdn.net/v/t39.30808-6/357479187_653071810190437_6628277901815024434_n.jpg?stp=dst-jpg_p180x540&_nc_cat=111&ccb=1-7&_nc_sid=730e14&_nc_ohc=B7fIQeKRqq8AX94dvsB&_nc_ht=scontent.fcai19-7.fna&oh=00_AfCS30O89Sdflpm4gCJEhYZZIJGRIM7aQY0ectYCsRBv5g&oe=64E36671,https://www.facebook.com/NVIDIAAI/posts/pfbid02z8kJJcWKuoPrUzL27qDqnpTnYCxZtqQntK8C1e5PBaAKgGN1oYwebR4uCjegh5Z1l?__cft__[0]=AZVA-6YdKVqpoZDSrSFrrblZpKA2fnUOW4xg-l6ePutWiJQPowUDwN0IqsD6lInrM-qamTWsWbRgHCvz8Zw4cVMSIzXHwXXX7Sld3_z3r7iEEDpvKjYALQi0QHzvXkK50Zzt8z1RTebM9YxYR19waLsHPOp5jaTgBVxe9xo4A_kuaOGa9jV9uddnczbe4_l5Yh70F1B_XZ7dh-k_c_FpZT8b&__tn__=%2CO%2CP-R,27,0,positive,27
pfbid021tyBWmUe92phVGTvVptDty474aodxxrvTuZnoJNEsFJtWvtyNLsarfQNFWzu6U5Sl,NVIDIA AI,5,39,0,0,0,0,0,0,39,2,"Explore the evolution of #SpeechAI, optimized techniques and SDKs for deploying in real-world scenarios, and the latest breakthroughs that will impact future applications in the live speaker-hosted #GTC23 session replay. Connect with NVIDIA experts and get your questions answered in a live Q&A on July 12 at 10 a.m. PDT online. Register free: https://nvda.ws/3Xt32iu",2023-07-06T00:00:00,[],https://scontent.fcai19-7.fna.fbcdn.net/v/t39.30808-6/358694108_652956993535252_5862961756123161415_n.jpg?stp=dst-jpg_p526x296&_nc_cat=107&ccb=1-7&_nc_sid=730e14&_nc_ohc=So1NwoNWCuoAX9ga8TV&_nc_ht=scontent.fcai19-7.fna&oh=00_AfAH3tGkav4t8VbYW6xIiDMbK8aiwcP37iBpJSosTWACgw&oe=64E3F6BE,https://www.facebook.com/NVIDIAAI/posts/pfbid021tyBWmUe92phVGTvVptDty474aodxxrvTuZnoJNEsFJtWvtyNLsarfQNFWzu6U5Sl?__cft__[0]=AZUqTmNnXjgjJ-0EUf8nR6fTM0iP3fH9x-cpLCLlO4bC4PZpAl65LsR5OMy9BTqpoD3cQNF9sv9tdklb8cu5E19nqXABix2KssSJ0oevFYcWZ7CiW0OkuAwj9PUIwgRz_GxrkmkS1S-JKejE5MskNq_H6UKVHqlP5Xy5BnGzVznsBAAvs9hvRD4Q82KzCJn4kFTY47snDV-gm0BfdA8RHIkN&__tn__=%2CO%2CP-R,44,0,positive,44
pfbid031cayBujBcNUzychegDFJ4EGYjj25T1KidwbJvtvc5kWPmKazQGEqw33XAvTgfez9l,NVIDIA AI,1,24,0,0,0,0,0,0,24,1,Join us to ask the NVIDIA CUDA® team about the use cases and applications of the new features introduced in the #CUDA Toolkit 12 in this #AMA on July 26th. ,2023-07-03T00:00:00,[],https://external.fcai19-7.fna.fbcdn.net/emg1/v/t13/8001148448528175790?url=https%3A%2F%2Fprod2-sprcdn-assets.sprinklr.com%2F50276%2F63259141-14fc-4550-9cee-33038a1f330d-1729760866%2Fsocial-ama-cuda-12-1200x628.jpg&fb_obo=1&utld=sprinklr.com&stp=c0.5000x0.5000f_dst-jpg_flffffff_p500x261_q75&ccb=13-1&oh=06_AbGKKaHkMjHAyZ9S1QFONFSvSij3vi95FH9CkDH045DZMw&oe=64DFFF3A&_nc_sid=dbad39,https://www.facebook.com/NVIDIAAI/posts/pfbid031cayBujBcNUzychegDFJ4EGYjj25T1KidwbJvtvc5kWPmKazQGEqw33XAvTgfez9l?__cft__[0]=AZX5WJdpSjfO2KswWVBDPr0VCySYXE87a8WV4g3Q5Sqta5BR2L_iOI3OHJiUzPzW4p3Asl0qCWGoeuWcL-Om5hgsySfMfmDpu_dcbbMSitpfgKqoSNTMjl1FnQLW5qA9H8jab3UetNRvvJws2-YMWIHN8FjzUGw15S0R5S9pW96DPyTvLdjajHJO0ImJu3zAQ9JIP4Z9diHUV3DboX9Ql9W5&__tn__=%2CO%2CP-R,25,0,positive,25
pfbid036Jr6XAHL35edxeo3tK8jnjDVLN9ncFD2yLLwoxF17CnuXeCuWfm23uweEJn9ZGWql,NVIDIA AI,4,14,0,0,1,0,0,1,16,3,"Cyberattacks cost an average of $5.97 million for financial organizations, with 277 days typically spent to identify and contain the breach. Learn how NVIDIA Morpheus enables enterprises to implement AI-based cybersecurity. https://nvda.ws/46s8QNw",2023-07-01T00:00:00,[],https://scontent.fcai19-7.fna.fbcdn.net/v/t39.30808-6/356630086_649177573913194_773610153561557252_n.jpg?stp=dst-jpg_p526x296&_nc_cat=111&ccb=1-7&_nc_sid=730e14&_nc_ohc=xm_HCv30zm0AX_p8dba&_nc_ht=scontent.fcai19-7.fna&oh=00_AfDsIrKlzDlcegikvw3jd5SuAN6kLrL4bzHs1yHYVFMsVg&oe=64E2CD53,https://www.facebook.com/NVIDIAAI/posts/pfbid036Jr6XAHL35edxeo3tK8jnjDVLN9ncFD2yLLwoxF17CnuXeCuWfm23uweEJn9ZGWql?__cft__[0]=AZVNGA0E1SINVW22lX5heOrRQg-X_6QhyqqrV6IO7Z880n3TuKS7B3wM_9p6pDaxNRS_ejq6SFcvfChE2z72svxJe4KqY1wKR6A2bPvF8hUWtnrPD5q-yEE4rvIozA5aru6c_Izqd_5CNuUXP8TQKPFm-KdpeBU8JpdvdsmkP5n1d9qEAmMtiaDXNbvdwC3Q0AmhlRiYWJPx078VRydhXKA0&__tn__=%2CO%2CP-R,20,0,positive,20
pfbid0PKtcgZ1qLrMd7Xh46Vb6aF2TTeR9LE4UC1A6oktNJNQB1C43Kb8CtkA4QMyKLK8xl,NVIDIA AI,1,19,0,0,0,0,0,0,19,1,Elevate your team's skills with customized training plan opportunities with NVIDIA Training. Created by NVIDIA experts and taught by NVIDIA-certified instructors who bring real-world experience and deep technical domain expertise to every learning experience.  Explore the catalog: https://nvda.ws/3XABzvG #Training,2023-06-30T00:00:00,[],https://external.fcai19-7.fna.fbcdn.net/emg1/v/t13/18240037636785863895?url=https%3A%2F%2Fprod2-sprcdn-assets.sprinklr.com%2F50276%2Ff4abf866-5145-482c-ac62-5095c426ba43-915839006%2Fnv-training-enterprise-social-.png&fb_obo=1&utld=sprinklr.com&stp=c0.5000x0.5000f_dst-jpg_flffffff_p500x261_q75&ccb=13-1&oh=06_AbHvjGGXHoCGnSK-CcjPznBfTeTgsmKXmBG2xf_1bb6dCw&oe=64E073A9&_nc_sid=dbad39,https://www.facebook.com/NVIDIAAI/posts/pfbid0PKtcgZ1qLrMd7Xh46Vb6aF2TTeR9LE4UC1A6oktNJNQB1C43Kb8CtkA4QMyKLK8xl?__cft__[0]=AZXxvsXJW71t9NfgUWZ4HVQUOupbQflKn9nRhn2EEB6NgYmCEgMOyWOGt72L-qXGdN4ZVDKRNOVc1jDVr7k8lEvfKvHTPv_HlfX7uLW8Cvgzv5WRrc74BC-cErYXu5J0YxfPTEUbp3GqedgpH8ABKbHzzNny7zgYXSAXbalO9tfDRkUZokYjpUlYSwI_tPZR5IDB58bzrLJztg06l2P88llX&__tn__=%2CO%2CP-R,20,0,positive,20
pfbid02hrQcdNxE955hJVRHsWZy6AJoai8pGam3UENDH5UEsQiFmkqrBd4ficcBDr6btFDRl,NVIDIA AI,2,25,0,0,0,0,0,0,25,1,Learn how to use NVIDIA Triton Inference Server to serve models seamlessly within your Python code and environment using the new #PyTriton interface in our latest blog. https://nvda.ws/3PD9ba5,2023-06-30T00:00:00,['blob:https://www.facebook.com/e8fc0377-2882-4e2a-b015-cec809fba9b6'],,https://www.facebook.com/NVIDIAAI/posts/pfbid02hrQcdNxE955hJVRHsWZy6AJoai8pGam3UENDH5UEsQiFmkqrBd4ficcBDr6btFDRl?__cft__[0]=AZUy3BRMqcMx1w20CxrRIgQA6hnLiB8fHwhEr61sR0KV_jwnB0aE5kIs2bI_tGoxQyINhqqC6dtA24WYMktap2Ht6DWCg3uQTX6VYudVSnDd3NILjB4aal_hxQtbK_cvrWbZct4BGmLKymx022lCDouy4lgaafUOlZ5jqAzUQufMW9866Ov-tD5SO_xxUy7BI_cgqMJdr4jXyoWNwhaWCae0&__tn__=%2CO%2CP-R,27,0,positive,27
pfbid0pUcLob1XaTKoiLFu75SaCuegZjYrKdD8283zYe7Y6KGQDXULWZvKYfvCWYHgPJ5tl,NVIDIA AI,0,33,5,0,0,0,0,0,38,4,"Hey, educators. The Deep Learning Institute (DLI) Teaching Kits are now available as Canvas learning management system (LMS) courses. Check out the new accessibility features that offer a seamless integration option for incorporating inclusive #AI and GPU computing in coursework. https://nvda.ws/3pweT2L",2023-06-30T00:00:00,[],https://scontent.fcai19-7.fna.fbcdn.net/v/t39.30808-6/356428027_649020583928893_6418648219503438369_n.jpg?stp=dst-jpg_p180x540&_nc_cat=101&ccb=1-7&_nc_sid=730e14&_nc_ohc=eCw3mkP3J_AAX9CUY7a&_nc_ht=scontent.fcai19-7.fna&oh=00_AfAT-sQ_Jkdh1JE5-4pAMIKla0iNyAQK8K7cOaYNy-8zKg&oe=64E3EB12,https://www.facebook.com/NVIDIAAI/posts/pfbid0pUcLob1XaTKoiLFu75SaCuegZjYrKdD8283zYe7Y6KGQDXULWZvKYfvCWYHgPJ5tl?__cft__[0]=AZU24TUSNT9YXEoqWpdUDItZ5n9ruiN7Pp4nBO9og_av_NDqvjFetxkNkajjYhbKcMuO8wpOBoykgXpsv36Nk0EdaPIRtJJJrcBSjZoJGjG8t5o_lDBN1OSpmCtXxTw9aL4YhbRtk7zRIIyXMuHQimA2GMWepwO-sO12UTgdL7Btl3Q3ZY3xbFJllVI3JWNMgVhpuT4JTLmSV-3TScAx2iVx&__tn__=%2CO%2CP-R,38,0,positive,38
pfbid025EVMqtsHD6egJ2rW3VDRD6NFNvuYu6bmzm4UZCKLq7X5EqRxRZMDfAgvjSBxcpQXl,NVIDIA AI,0,24,2,0,0,0,0,0,26,1,"What is deep learning and how does it relate to #AI? Join us on Tuesday, July 11 at 10 a.m. PDT for the live speaker-hosted #GTC23 session replay to learn how deep neural networks are trained to perform tasks with super-human accuracy, and how your organization can deliver breakthrough results with AI. Get your #deeplearning questions answered and register free today: https://nvda.ws/3Xt32iu",2023-06-29T00:00:00,[],https://scontent.fcai19-7.fna.fbcdn.net/v/t39.30808-6/357377963_648582403972711_3649432167891551586_n.jpg?stp=dst-jpg_p526x296&_nc_cat=101&ccb=1-7&_nc_sid=730e14&_nc_ohc=6-pjAgkqZ-0AX9EtZLH&_nc_ht=scontent.fcai19-7.fna&oh=00_AfC0pv4ywJ3z53F5COaGO6sUY4NZmm26jjc12aLmRjWW4g&oe=64E4657E,https://www.facebook.com/NVIDIAAI/posts/pfbid025EVMqtsHD6egJ2rW3VDRD6NFNvuYu6bmzm4UZCKLq7X5EqRxRZMDfAgvjSBxcpQXl?__cft__[0]=AZUdJR2LhBUP7oGL9ujHHGl5yojmQhv3RQDV_zdHyEI9Rj121e0YNjX4rgpqI8uDMA0sr2rsC0chTnYEqPJMH3RrZeSfJh3Z3MqZePVRL0gCTURchwmJd2hSUMnaZkzA6Y5WoIUgCT5Lf2g0yXngpFWIcT_6nTcEqgLBW-AO1ORwRjmrsN6DYd1D_xVAN60x8zDpecuGsc8zZLq7b6v12RRT&__tn__=%2CO%2CP-R,26,0,positive,26
pfbid02pCZA4aAVg8AgwLLGhTf3xMMHXVSB5Lcd4m3ntrtoDhAHfBHzRMS2sMXf5PF7KAZdl,NVIDIA AI,0,14,1,0,1,0,0,0,16,0,The quick-service #restaurant industry is undergoing an accelerated technological transformation. Discover how NVIDIA is empowering the industry with innovative #AI solutions. ,2023-06-29T00:00:00,[],https://external.fcai19-7.fna.fbcdn.net/emg1/v/t13/6074579360302425204?url=https%3A%2F%2Fwww.nvidia.com%2Fcontent%2Fdam%2Fen-zz%2FSolutions%2Findustries%2Frestaurants%2Fnvidia-restaurant-industry.jpg&fb_obo=1&utld=nvidia.com&stp=c0.5000x0.5000f_dst-jpg_flffffff_p500x261_q75&ccb=13-1&oh=06_AbFEWxJiSctpI6s4WK22LessZrdmTiK2w2pSJMwYh2qEQw&oe=64E05235&_nc_sid=dbad39,https://www.facebook.com/NVIDIAAI/posts/pfbid02pCZA4aAVg8AgwLLGhTf3xMMHXVSB5Lcd4m3ntrtoDhAHfBHzRMS2sMXf5PF7KAZdl?__cft__[0]=AZUTehjVfTSVv1RK9D494eDL2qKGnMSxSbTl5bFoJn7RYSmc9049vshB5uwWVnTuBHxoQHWr-PDATk4bes8kgoLrxGikR8PrFxaKv2KdubuBhI_lY7KCoh6nDrU1fIPVxlPw-3ofX83Rb-9NHrF5tHebANQ3CmMcnTuR4fEP-blqH0en7z8lvpJladu0ZW_opNFpIx5Rj5eMQ-YQYLQzPoV9&__tn__=%2CO%2CP-R,16,0,positive,16
pfbid05TABidKJLFdCnYRa9r4FpGZhBFaPyTQc2uBy4K65XVN73pDbShu7KjDffPNa6VPnl,NVIDIA AI,1,16,1,0,1,0,0,0,18,2,"Curious about the role of digital twins in the energy sector? Join Guy Gueritz, Regional Energy Industry Sales Leader at NVIDIA, at IIoT World Energy Day on June 28 to explore transformative capabilities. Register now. https://nvda.ws/3CQO90c",2023-06-29T00:00:00,[],https://scontent.fcai19-7.fna.fbcdn.net/v/t39.30808-6/356643035_648063710691247_105708356215217331_n.jpg?stp=dst-jpg_p526x296&_nc_cat=102&ccb=1-7&_nc_sid=730e14&_nc_ohc=tRDykr5I2F4AX_PhIjb&_nc_ht=scontent.fcai19-7.fna&oh=00_AfD1jOh28E_CC1vZHZBQBVDD8zQ2H98Ozqz9AyzkbmHckA&oe=64E31321,https://www.facebook.com/NVIDIAAI/posts/pfbid05TABidKJLFdCnYRa9r4FpGZhBFaPyTQc2uBy4K65XVN73pDbShu7KjDffPNa6VPnl?__cft__[0]=AZW7ZKgIAIFVw2lQ5pPIoU2Wogn8qbh7l79i0__IBPHt24razBqU3zz_Qe425v6rEY0qVmHl6hk-I2CZejs6UbjifosEsgmrleU5Rxucra5Xm7CzOlq2WH_s5DYf-Ahbq-gsoNDOM2fGYj620SqWswxE9V0-VFQAMBia1F8L_eACArRq0aD2fg-RnqdGzPx8VwoB0h-Y3nnTNdFS16t9nbhq&__tn__=%2CO%2CP-R,19,0,positive,19
pfbid02AFCxsPyLXXeYLVmMqzBRHPymRrjfMQKVHJkPVKEWqVDyZL8rCKfaA4gfhigW8K6vl,NVIDIA AI,1,23,0,0,0,0,0,0,23,3,"Embark on a journey to a self-driving future and discover the roadblocks to mass adoption and the game-changing impact of emerging technologies. In this HPCwire article, we navigate the exponential market growth, ethical dilemmas, connectivity needs, and infrastructure enhancements in the autonomous vehicle industry. #MakeAIYourReality #AzureHPCAI #NVIDIAonAzure Read it now: https://nvda.ws/3JUKv9B",2023-06-28T00:00:00,[],https://scontent.fcai19-7.fna.fbcdn.net/v/t39.30808-6/355726036_647963360701282_8492575143741979598_n.jpg?stp=dst-jpg_p180x540&_nc_cat=103&ccb=1-7&_nc_sid=730e14&_nc_ohc=z8qQ1nqEfmoAX_RzRK7&_nc_ht=scontent.fcai19-7.fna&oh=00_AfD2Hnl2mbtY0o58xf7fps0tDrbInSkkVEqS_8g81N0nIA&oe=64E44558,https://www.facebook.com/NVIDIAAI/posts/pfbid02AFCxsPyLXXeYLVmMqzBRHPymRrjfMQKVHJkPVKEWqVDyZL8rCKfaA4gfhigW8K6vl?__cft__[0]=AZXqJdI5uK8P-Ard6o_p21TRfDMg0H7kdnenpnIUSz4KgaBt2sZglmQOtiGFhjOwFDZZ7sPw2ioF-5Unm1mzeZHI2wZlrwaRzMpU3bKW2jlq-nZlHv2wzmWYsqk340ULPR0Jhw59VvF2TR326UTIZErca9UqF-FOv-Uo5-f6tBN3WCpONjbXA_0YrPManfPp1aVNE-JGy7wy-7tNF81d6Fqh&__tn__=%2CO%2CP-R,24,0,positive,24
pfbid0F7JE87MMwNKYVZjjukniwhtzCJhcYKkWLHysH6FaWEiQ2XrG6gwbxmgZkve4mGvQl,NVIDIA AI,0,18,0,0,1,0,0,0,19,0,"How are #generativeAI and accelerated computing already transforming every industry?Our VP Manuvir Das, joined MIT Tech Review editor-in-chief Mat Honan at MIT Future Compute to discuss. Learn about #genAI’s impact to organizations: https://nvda.ws/3Xv8Gkf",2023-06-28T00:00:00,[],https://scontent.fcai19-7.fna.fbcdn.net/v/t39.30808-6/355709591_647933404037611_7982221648068803699_n.jpg?stp=dst-jpg_p526x296&_nc_cat=102&ccb=1-7&_nc_sid=730e14&_nc_ohc=4JQlIfBAWHIAX9h3QS9&_nc_ht=scontent.fcai19-7.fna&oh=00_AfBkMf4r2cE-xa8DzXCHkRhlwtep_FiWzTGkZxYHgkZX4Q&oe=64E3989E,https://www.facebook.com/NVIDIAAI/posts/pfbid0F7JE87MMwNKYVZjjukniwhtzCJhcYKkWLHysH6FaWEiQ2XrG6gwbxmgZkve4mGvQl?__cft__[0]=AZWhNEsUFN2LpKbVwKt8Zra5CQwespVnVKmRjAqdWwxwxPFlzQUiY9gaFAFiKkjAn8BRR76Gne3_kc3IpYXln7PTgzn_jtsuXRB5cfLYATQoevFjq-1Ht1bsG5fAY7m5Qgh4CKOv3LaPEBANxlt_z7S9v7n0yCj7kkkdSBYSkfnLJ3WradPqr5mclar64ifQ5PiwoRtQCvDc14U1t7_xakWJ&__tn__=%2CO%2CP-R,19,0,positive,19
pfbid0xFyWVygxgoCL6vP1nt2D4ww8p4LKxMvPZPgkfHi56BhX7Q84oxkPo4o31BJbk4Qpl,NVIDIA AI,0,51,4,0,0,0,0,0,55,4,"In MLPerf Training v3.0, the NVIDIA #AI platform powered by the NVIDIA H100 Tensor Core #GPU set new performance records, achieving both the highest performance on a per-accelerator basis and delivering the fastest time to train on every benchmark at scale. Learn more: https://nvda.ws/3NnvHB4",2023-06-28T00:00:00,[],https://scontent.fcai19-7.fna.fbcdn.net/v/t39.30808-6/356843958_751635363635934_3134017694121246089_n.jpg?stp=dst-jpg_p180x540&_nc_cat=100&ccb=1-7&_nc_sid=730e14&_nc_ohc=Pi4yI-wriEUAX-BGUxp&_nc_ht=scontent.fcai19-7.fna&oh=00_AfBRhW6ZCWTVcf_uZu2kEcBr4vGPYThx4SEjWf7X5z4usg&oe=64E44020,https://www.facebook.com/NVIDIAAI/posts/pfbid0xFyWVygxgoCL6vP1nt2D4ww8p4LKxMvPZPgkfHi56BhX7Q84oxkPo4o31BJbk4Qpl?__cft__[0]=AZUM5d4nVXzyQZtLMz3o4to_feW6uzOeVKlksWxzFnO7A4VK5Y-6PXTxoKeZ5Fpa8qpzjvrpZ3AbupgwDey4wTQc42kDD4cLlbPZW5WBQ3HOwBYPigsNt0MkwsDYbxmm70JitItHNhoaL4uv7WhoicT7kMaE0gJ3HaaWnEVR9zq7ulWX8BIvZ7useE9P84gRGgCeHMr2X_5kjFeg1jW0dkip9zftKB6bAqoDEwmFz9B0CPDUDOcEdVcMT__NDtV4Zj8&__tn__=%2CO%2CP-R,55,0,positive,55
pfbid02xHB9gDjRJtcWHx4UrKow9S4sJiMzBcFrBgnmByBCPHXEB7syezfYJpNnUuGJYqu5l,NVIDIA AI,0,19,0,0,1,0,0,0,20,1,"Join speakers from our most popular #GTC23 sessions as they host replays for an opportunity to network, learn, share ideas, and get your questions answered—live. Don't miss the first series on #AI fundamentals, starting on July 11, 2023. Learn more and register free today  https://nvda.ws/3piUvCr",2023-06-28T00:00:00,[],https://scontent.fcai19-7.fna.fbcdn.net/v/t39.30808-6/356828187_279759107937426_2841833133051030120_n.jpg?stp=dst-jpg_p526x296&_nc_cat=102&ccb=1-7&_nc_sid=730e14&_nc_ohc=Cy8jCmyMxmIAX8Gshzq&_nc_ht=scontent.fcai19-7.fna&oh=00_AfDKSlZFDHjOoUg8uyzW6yDqkFQNuT_jvr0qRG7RMoLbnw&oe=64E44083,https://www.facebook.com/NVIDIAAI/posts/pfbid02xHB9gDjRJtcWHx4UrKow9S4sJiMzBcFrBgnmByBCPHXEB7syezfYJpNnUuGJYqu5l?__cft__[0]=AZXzOflLbjZbQSlTklGj1v6IrJNTqmcI8FTU3jcZU9r-M8XbnE9H8QtpnYzBG4pzxB6i8NcSO2li-lzJqDBqqBP2rUZwUMVzcIxmUMrHeBjbx66wWwIvnayDIEI5bLARb4QwmSJuR3mSCLZzaINq0wlQBXqlPyqwtXYRhPhFVvA_ZRvtmvQLVrnkIRCEgEFk-MnaUm6lMkAYRtmqKnNKH-lNq0KYkPTidMeWbkpkwDHquuDnujWf6nRU8asB3rolLc4&__tn__=%2CO%2CP-R,20,0,positive,20
pfbid02ypjBaQcca8fwbbS4wu5ALxwCXAAozya6RY4jocHBtWJtHNt92tkTUoMzLaQ3i3Fpl,NVIDIA AI,4,16,0,0,1,0,0,0,17,2,Cut your single-cell analysis time to a fraction of what it used to be with the rapids-singlecell library. Dive into how you can get insights faster and collaborate more easily with physicians and biologists in real time. https://nvda.ws/3CVXSlD,2023-06-28T00:00:00,[],https://scontent.fcai19-7.fna.fbcdn.net/v/t39.30808-6/356865411_647264144104537_2327788279839997315_n.jpg?stp=dst-jpg_p180x540&_nc_cat=100&ccb=1-7&_nc_sid=730e14&_nc_ohc=aH77E9IyJkcAX8slhTr&_nc_ht=scontent.fcai19-7.fna&oh=00_AfDHXPNpLqftY7LV2yf33GVC3qptPMAOL6YVdkY2d6yPYw&oe=64E445BD,https://www.facebook.com/NVIDIAAI/posts/pfbid02ypjBaQcca8fwbbS4wu5ALxwCXAAozya6RY4jocHBtWJtHNt92tkTUoMzLaQ3i3Fpl?__cft__[0]=AZX7imJHogM0h-kXSaPHCa6-VidBQ6T49NR7S1bO61ulJjVAjG_G3JrHDz7NfrlmggH7zApvKuqdmz2yHev02G8BE2TvqOT5pgpL_G0t_OqOsq-iZgimd7SCBlRT5otxWTmWlCQMgC1gSWVpTCG7OoI9VTaSNadKf7lI54Zzpw5WGywE7xezb-AEJgl6P2zgqegcK75lovHUthZCga6CFF1T&__tn__=%2CO%2CP-R,21,0,positive,21
pfbid02wLnj3HseyoHcCNMS7vRHgXLq4bukZJp8vHUSSRpbXPE7KAAunwAcKyaYmkN31a5Al,NVIDIA AI,1,28,0,0,0,0,0,0,28,1,See how customers are using the NVIDIA AI Enterprise software suite on the secure and governed Snowflake Inc. platform to develop cost-effective AI-powered applications using their valuable data. #generativeai #snowflakesummit2023 ,2023-06-27T00:00:00,[],https://external.fcai19-7.fna.fbcdn.net/emg1/v/t13/7795427892813005889?url=https%3A%2F%2Fdeveloper-blogs.nvidia.com%2Fwp-content%2Fuploads%2F2023%2F03%2FProduction-AI-Workflows-GTC.jpg&fb_obo=1&utld=nvidia.com&stp=c0.5000x0.5000f_dst-jpg_flffffff_p500x261_q75&ccb=13-1&oh=06_AbFWnzX1gCwc2eH7aw6sb6lAnNE0lCGt3a_YUJtmz8YPDA&oe=64E077AE&_nc_sid=dbad39,https://www.facebook.com/NVIDIAAI/posts/pfbid02wLnj3HseyoHcCNMS7vRHgXLq4bukZJp8vHUSSRpbXPE7KAAunwAcKyaYmkN31a5Al?__cft__[0]=AZXuTooSeY5bfBlmEvkdgbQpZjMsr8MvonQ8qNtOkcIhBjcz7CRyQyk-rJCXQBzkoGrFRVYF-ORd1lb6ESbbJD0cXPCRVxP3U-X9h2vWObxJ-kCP-amEHWKHadITwnvSsW9TGUPNZ57nXF_oUJbgKY2oxBAFertq_U0N3NyTahEsXCGg9iVkw2WDJUypjneTHaa3Ymg0gGMIDHxJpdXs1PXe&__tn__=%2CO%2CP-R,29,0,positive,29
pfbid02U8GNYhJ6VDWjMg1YvWEnu7KtniraXzkDapX6MW9yks4Seu8jYrr5c2bXtueZJC9Nl,NVIDIA AI,0,21,0,0,0,0,0,0,21,4,Watch this video to see how Kroger is reimagining the store shopping experience with #simulation and #digitaltwins to determine the best customer shopping experience and provide fast and easy checkout. https://nvda.ws/42TOLg0,2023-06-27T00:00:00,[],https://scontent.fcai19-7.fna.fbcdn.net/v/t39.30808-6/355331943_647186880778930_8008284401803086804_n.jpg?stp=dst-jpg_p526x296&_nc_cat=102&ccb=1-7&_nc_sid=730e14&_nc_ohc=DsNrP74cqV8AX9ZObhS&_nc_oc=AQmLwZv1zf1R1YxbArmS1LLjhDhdBsaqL1r1i20--1x2UObW6P-B1swn4WYSGauAMiM&_nc_ht=scontent.fcai19-7.fna&oh=00_AfCdv_QxQQ2WPvMo0jxw2Aj9Mq0J64sKTtOmP9AFJxjSAg&oe=64E395C0,https://www.facebook.com/NVIDIAAI/posts/pfbid02U8GNYhJ6VDWjMg1YvWEnu7KtniraXzkDapX6MW9yks4Seu8jYrr5c2bXtueZJC9Nl?__cft__[0]=AZX5blKtyxmS4pyeKWh8KI1dHqMjZmMYpy7Pr6zS23dklGMYRzzDeBzexElWhGE7yECiuR0zpfsnfRFff9hTZEBlBXsvjeZBvRPECtjGvnACg-ghQYd5sunA-o9953X2MuDOsha42ItlsbKAhDtFBfnNI_ECxOCx6tUAi55YUBZFlG7rTp0VeC6FRnRKa0-ctsp-SSRZ-pNKsFot9xqvpLzn&__tn__=%2CO%2CP-R,21,0,positive,21
pfbid0w2LJpGDuX4yzifXagcqirm9k8iTRzbLeCbB8uN2wWQyiFyFZM33dmuLEmoZzUhr5l,NVIDIA AI,1,10,1,0,1,0,0,0,12,1,"Learn more about CoreWeave's Tensorizer, a tool for fast PyTorch module, model, and tensor serialization and deserialization, and its comparison to other models utilizing the powerful NVIDIA A100 and A40 GPUs. https://nvda.ws/44hmcKp",2023-06-27T00:00:00,[],https://scontent.fcai19-7.fna.fbcdn.net/v/t39.30808-6/356700011_647158417448443_7431340401947299452_n.jpg?stp=dst-jpg_s720x720&_nc_cat=105&ccb=1-7&_nc_sid=730e14&_nc_ohc=l5vVSeYp8t4AX8kN3XI&_nc_ht=scontent.fcai19-7.fna&oh=00_AfCpuahZXfPUebvbnqQATnRXsRRL4bUvnY1BLmq7WB_DrA&oe=64E48D5A,https://www.facebook.com/NVIDIAAI/posts/pfbid0w2LJpGDuX4yzifXagcqirm9k8iTRzbLeCbB8uN2wWQyiFyFZM33dmuLEmoZzUhr5l?__cft__[0]=AZXN5Fkue7asmFO-W97sAZfJK3r3D1M0Z17OvJRATWlR8OdLloQvGyLmfvRE7nuEjdQyhTpt2tArq6sLf3RxTTath6Blfu9_h5oOeKDH3JnIPDVoAEzHNGVK7Lk3sKOMgO-z5GzFOypD48DH7NVih4QrKn84Ys2j5UdoO4lF5W07j2WhOjaD6G88LBOByHezB20h4wHcwpLRGl1glAV4quaL&__tn__=%2CO%2CP-R,13,0,positive,13
pfbid0RrT6QXsPDXH8CNyxD5gxdLMfEY919CqDQjdeXDZJuQEqAw3pibWhJwgHaFS6Pedbl,NVIDIA AI,6,52,7,0,0,0,0,0,59,9,How can you use ChatGPT and GPT-4 to build an AI-powered extension for #NVIDIAOmniverse?Get your questions answered by our experts at our upcoming Ask Me Anything #AMA. Wed. June 28 at 9 a.m. Pacific.   Register now.  https://nvda.ws/3NwO5r4,2023-06-27T00:00:00,[],https://scontent.fcai19-7.fna.fbcdn.net/v/t39.30808-6/355308116_647143134116638_2773181821068950601_n.jpg?stp=dst-jpg_p526x296&_nc_cat=108&ccb=1-7&_nc_sid=730e14&_nc_ohc=rzGZ7HrM5x0AX_fiBT5&_nc_ht=scontent.fcai19-7.fna&oh=00_AfCmi-GSLFnT220mDZFqt7w4xODwKnNZuUfQlJr3O6NGxQ&oe=64E30748,https://www.facebook.com/NVIDIAAI/posts/pfbid0RrT6QXsPDXH8CNyxD5gxdLMfEY919CqDQjdeXDZJuQEqAw3pibWhJwgHaFS6Pedbl?__cft__[0]=AZVY-84GQfofDqOqBNxOciGBF42VUcQ72mU_9dyvt1a_XV9y0beX15jhRudhukm-Z7ywuvX0qDlUEyt-srjpoac2R1-gO1Fd-NWAkTj_CLVa9wLZU1g8db-xk0Lh0w6L6zHjJrG2fKB5JUVBMUtKAqWvWv_d1X3ruDMUGdqEKA48dh9_-p9sn-Y6M8RDoxhNnAKimdh81zqWEzqTWjYwFzDA&__tn__=%2CO%2CP-R,65,0,positive,65
pfbid02hpYw7w84MhgD1TPoATy8UamsrrLov5CFjSUAzNNsRWXyvAaY9UguvX9APDHHxNTRl,NVIDIA AI,25,12,2,0,1,0,0,0,15,2,See how #NVIDIA and Snowflake Inc. are helping businesses harness their proprietary data for #generativeAI applications to better serve their users and customers. #snowflakesummit2023https://nvda.ws/3pnUME0,2023-06-27T00:00:00,[],https://scontent.fcai19-7.fna.fbcdn.net/v/t39.30808-6/356624984_646708344160117_8430081658614010573_n.jpg?stp=dst-jpg_p526x296&_nc_cat=100&ccb=1-7&_nc_sid=730e14&_nc_ohc=cbtRrzHv0pAAX9plXhG&_nc_ht=scontent.fcai19-7.fna&oh=00_AfA11duA9pjkhIP-YJm43oUt6GphBoDA-hW256ugeeNJAg&oe=64E2EF8C,https://www.facebook.com/NVIDIAAI/posts/pfbid02hpYw7w84MhgD1TPoATy8UamsrrLov5CFjSUAzNNsRWXyvAaY9UguvX9APDHHxNTRl?__cft__[0]=AZWdKzlLYBampCnF9pkTxry-Zx8lLiGplqQHOmrgEZpBqUkYZ_EmYJSfSZ1moPCclNTXdn8WAh77icSoLflx87t4fmdHcUXVOk8BN9SlpKxXDkayzzRqeYrG89r-86jXoqUVA5F-OsrUfMjgqR7L5g0ta7e6WveglJ6YVcb5YkZvWxiRRkNWqEF5sfBWKX2Qo0IzKZZJVxm6m9O_e5SY7J-F&__tn__=%2CO%2CP-R,40,0,positive,40
pfbid02wbe9fcsuQ5dvJdF6HEhmzed9f1ZTut415hERmKXKzjRzcYgYAFL3TPbgtFoQ4c9jl,NVIDIA AI,0,14,0,1,1,0,0,0,16,2,Get smarter on the tech revolutionizing the way we view and interpret spoken language and sound. Dive deeper into how #speechrecognition is powering Cochl's assistive #soundAI technology development. ,2023-06-26T00:00:00,[],https://external.fcai19-7.fna.fbcdn.net/emg1/v/t13/12323327333650100467?url=https%3A%2F%2Fdeveloper-blogs.nvidia.com%2Fwp-content%2Fuploads%2F2023%2F06%2Fspeech-ai-spotlight-ar-glasses-featured.jpeg&fb_obo=1&utld=nvidia.com&stp=c0.5000x0.5000f_dst-jpg_flffffff_p500x261_q75&ccb=13-1&oh=06_AbHiSLZwpZ1O68-uLrISa9zo0M0RTA5CqIYq2zi26qq_KA&oe=64E05229&_nc_sid=dbad39,https://www.facebook.com/NVIDIAAI/posts/pfbid02wbe9fcsuQ5dvJdF6HEhmzed9f1ZTut415hERmKXKzjRzcYgYAFL3TPbgtFoQ4c9jl?__cft__[0]=AZUhJ3FT2yUpUS14BHdOYot1PTiCyyszqh4e616nB_TkoTvWOjtyEKziklb5-JyDmKDwJgsU5s0_5fQEHpRUgVMQT1BLUyKPUEHGCKqRuuv4cmrw5L1WjbrO-fIQNkKc7-WkJdzwxnNFbVM0j8YfKKOSeRy9TqXHuv4xWqiBTDUvJxB7pSZljexxROVP0Qc7H4uF9IjVAS8NU30dmeD2FG7q&__tn__=%2CO%2CP-R,16,0,positive,16
pfbid037fNNkswHXwikAUrgueH8HWZqJRiLjhNRmfHPiJAaMAduUtGPd3aPCZKt1636dbXjl,NVIDIA AI,1,13,0,0,1,0,0,0,14,1,Encina is helping build a circular economy by recycling end-of-life plastics into reusable chemicals. Learn how Encina achieved a 506x speedup for a large-scale virtual reactor simulation on a single Microsoft Azure VM powered by NVIDIA #GPUs. https://nvda.ws/3NtLwpM,2023-06-26T00:00:00,[],https://scontent.fcai19-7.fna.fbcdn.net/v/t39.30808-6/355161400_646607577503527_7144193750450550586_n.jpg?stp=dst-jpg_p180x540&_nc_cat=101&ccb=1-7&_nc_sid=730e14&_nc_ohc=sJDKUUBqa5sAX8pDBE9&_nc_ht=scontent.fcai19-7.fna&oh=00_AfB-EhX_kiSmIOdiVoqw-GGRWhg78_oT7VZs49UlSCg-Ow&oe=64E2EAB5,https://www.facebook.com/NVIDIAAI/posts/pfbid037fNNkswHXwikAUrgueH8HWZqJRiLjhNRmfHPiJAaMAduUtGPd3aPCZKt1636dbXjl?__cft__[0]=AZWx5U0HIKpbvIGKOHNDSvnC0i9v9i3QCZNGkP4xR6mCz_i4CRT-lXVwf4dI8PaqPYAtYwIOS83sd0RbbELTNtfHpVJ5SqQNOZl3e6-8Z6eR5aXH2unTlZDresNc25FCpEypqPp47Q3CwH2H3bIolmMgWwaUNvUsZaiA7hmFhOvDQbMNtjLWvZZ1f_s7DTZcu0efauNzbCGcDXQ685Dr4hYh&__tn__=%2CO%2CP-R,15,0,positive,15
pfbid02wqqcsCdhvfbQauEJ9q5Hst1Hk6GQy5YqDXLcniixm96bgyx8NspHbYu4wXDnNAL4l,NVIDIA AI,4,25,2,0,0,0,0,0,27,1,"Improve 3D graphics rendering, animation, and ray tracing capabilities with NVIDIA A10 tensor core GPUs on Oracle (OCI) Compute GPU instances. Read the walkthrough. https://nvda.ws/3CO0diH",2023-06-26T00:00:00,[],https://scontent.fcai19-7.fna.fbcdn.net/v/t39.30808-6/355120064_646582604172691_4064602198761240099_n.jpg?stp=dst-jpg_s960x960&_nc_cat=111&ccb=1-7&_nc_sid=730e14&_nc_ohc=gMcW10AM8QoAX_KWybN&_nc_ht=scontent.fcai19-7.fna&oh=00_AfBur3blE3m7jJFAie5zIaK6ayBJSb_Oxc9m7pV9cQeE4A&oe=64E47227,https://www.facebook.com/NVIDIAAI/posts/pfbid02wqqcsCdhvfbQauEJ9q5Hst1Hk6GQy5YqDXLcniixm96bgyx8NspHbYu4wXDnNAL4l?__cft__[0]=AZXS-5CZsDRG2sp7Z8wDLLbofL85X4H2tHJnKj-owanlaMSlMnhB0xy8cWSYOJxGjnyii1qnEC46DdTwumDtDEeL7jrxl0LMBR-MIQFV6NpWJRAS7OYsMq44pPY_fLPN_ueaikctGUy10dUKxGKNfoya_dk7KcbZxJ1RUwsBnglvbEuJsmd-UBl97o9nzR3ygpeB2PE8OtVd9f3pRlCUj-QI&__tn__=%2CO%2CP-R,31,0,positive,31
pfbid079zbioiEfh6tFEC9MNVzFtgRKfwQ5H5z6FSpNFybBN6sLSKukeUrB3cKkm6N7zLhl,NVIDIA AI,0,11,1,0,1,0,0,0,13,0,Curious about #genomics tools and why they benefit best from GPU-based acceleration? Join Dr. Tychele Turner from the Washington University School of Medicine as she shares how genetic researchers can accelerate variant detection with NVIDIA® Parabricks®. Register today: https://nvda.ws/3NHgbBo,2023-06-26T00:00:00,[],https://scontent.fcai19-7.fna.fbcdn.net/v/t39.30808-6/355098433_646459344185017_2744565170277791223_n.jpg?stp=dst-jpg_p526x296&_nc_cat=102&ccb=1-7&_nc_sid=730e14&_nc_ohc=h0lRsItQMtgAX-O6PAa&_nc_ht=scontent.fcai19-7.fna&oh=00_AfBh1nyzWSBjV0j5AoBZgF5NmCeZMBunCE_Egt1OD78vgw&oe=64E2C639,https://www.facebook.com/NVIDIAAI/posts/pfbid079zbioiEfh6tFEC9MNVzFtgRKfwQ5H5z6FSpNFybBN6sLSKukeUrB3cKkm6N7zLhl?__cft__[0]=AZXBoREUqj35aRs3fReKe0Tld2-0P5AQN4nrmqHpvO1hFyvkS9yKTHjbGizeaR8_hPSylAR2gKdRKqhH1rlFDKFGFg_e7L8QqZlBZo02zEBOXw2IKE4woyGEXF1FEQTm343hdtCVIDiJW7f59CLUHN8MIhm0mfOR6OtRSW5rVpR4TWLhZ2apgnwjN5uLDrTF--BA-eRFZImA0q81nMDLhdcV&__tn__=%2CO%2CP-R,13,0,positive,13
pfbid02FKXbXayxV3mnxhWK9AcBZoevhxeRCvvR1DHaDMNikgoAYiXVGiUuKpE3NWsrmr2Hl,NVIDIA AI,6,24,3,0,0,0,0,0,27,2,NVIDIA founder and CEO Jensen Huang joins Snowflake CEO Frank Slootman June 26th to kick off the summit and discuss the latest in #generativeAI.Register now: https://nvda.ws/44db6Gn,2023-06-23T00:00:00,[],https://scontent.fcai19-7.fna.fbcdn.net/v/t39.30808-6/353038509_644900691007549_4443165605728951971_n.jpg?stp=dst-jpg_p526x296&_nc_cat=100&ccb=1-7&_nc_sid=730e14&_nc_ohc=Li-8JMuN5cwAX_l0DsA&_nc_ht=scontent.fcai19-7.fna&oh=00_AfAf515W0QbQYWZl-EBXB0d7dxzQMu5HlGLTZx83CZstmA&oe=64E42B7F,https://www.facebook.com/NVIDIAAI/posts/pfbid02FKXbXayxV3mnxhWK9AcBZoevhxeRCvvR1DHaDMNikgoAYiXVGiUuKpE3NWsrmr2Hl?__cft__[0]=AZXvo0o53wx8UT30LgX8MNbERCNZ3R0BDivz79mZjDECBbVwCj4WEgHYaOGY_-DBffMzGmk65dzsEYnmAhjCAU1PPVdzadrQ-Ccbqs_3ov0-rDFlrBRhdRSfjC5e3RpNqwQdd5dnDTfstAQC5VlfGtKvnq0Q4YmtQeTbpZ5mrfE4uvKDRvcqvjOdBOY4DE6XfYATsUwRjruzVLqLwkSCCj1A&__tn__=%2CO%2CP-R,33,0,positive,33
pfbid03CDVjdPXDW89dsUMe9Z86btLNVapEtsnkUMUzSjQvwpX4E2qA1upwF8U7NKqa7GJl,NVIDIA AI,2,18,2,0,0,0,0,0,20,1,Dive into the top Q&As answered by Coqui.ai for building zero-shot multi-speaker text-to-speech systems — from generating entirely new voices to hardware requirements for training a speech AI model. ,2023-06-23T00:00:00,[],https://external.fcai19-7.fna.fbcdn.net/emg1/v/t13/17376918898531843259?url=https%3A%2F%2Fdeveloper-blogs.nvidia.com%2Fwp-content%2Fuploads%2F2023%2F05%2Fzero-shot-multi-speaker-tts-featured.png&fb_obo=1&utld=nvidia.com&stp=c0.5000x0.5000f_dst-jpg_flffffff_p500x261_q75&ccb=13-1&oh=06_AbGq4l7jAljIcesemoHNevSNkUba8uG45vB3_ze6julC0Q&oe=64E02DAC&_nc_sid=dbad39,https://www.facebook.com/NVIDIAAI/posts/pfbid03CDVjdPXDW89dsUMe9Z86btLNVapEtsnkUMUzSjQvwpX4E2qA1upwF8U7NKqa7GJl?__cft__[0]=AZW6eil8a36UMhGs5zccXTQ7Tfjsf8_CxVd33xltx2RasqY0i0QEzj0o3cqv4LBDhEZmBlORP5fhKR1Fj1YTMiY1mQsPL36pwtXc7c0dZyqiMYYwqikUYmfUumuDs5MvpwZBwZS12wQlOxWp1fM2ms7A0YGIczkeaGnYEUh8-B2EAB48YejtzUM2Tj0o-toiDke37L9K3drQWuX4pHAXgeDv&__tn__=%2CO%2CP-R,22,0,positive,22
pfbid02SY6LtswQnLmikDKrG2VV2qRpmE4WfE1WWhRhdpujuxWNpoR3St3C7PHTnXVmFNbBl,NVIDIA AI,1,11,2,0,1,0,0,0,14,1,"Discover new research that is boosting the creative potential of #generativeAI with a text-guided image-editing tool. With this work, visual content creators can transform images into visuals with just a single prompt image and a few descriptive words. Learn more: ",2023-06-23T00:00:00,[],https://external.fcai19-7.fna.fbcdn.net/emg1/v/t13/5180021713829858803?url=https%3A%2F%2Fdeveloper-blogs.nvidia.com%2Fwp-content%2Fuploads%2F2023%2F06%2FPNP-Generative-AI-Diffusion.gif&fb_obo=1&utld=nvidia.com&stp=c0.5000x0.5000f_dst-jpg_flffffff_p500x261_q75&ccb=13-1&oh=06_AbGylm1UCaL9AOEYw7VHsEB6kuku8Cdzc16S_TLnXaX2vw&oe=64E032C4&_nc_sid=dbad39,https://www.facebook.com/NVIDIAAI/posts/pfbid02SY6LtswQnLmikDKrG2VV2qRpmE4WfE1WWhRhdpujuxWNpoR3St3C7PHTnXVmFNbBl?__cft__[0]=AZXTBkx0-hjZXdpAQiV-pdPEUp78UIGMA1ypIdlLHCgzQq7Gjw43B8rbHQnRk-WFjiXNlHggNfnUvLXsKGFMWz3yLjUkBgYXDkYPXNrlzAaqmH99D4mW-vFyF4PY5fA7kjVEyelSutAnkOhUDdopJcDAOyntGaw-VsAP_PpwQiU-TNe3UZdCX0KsqLDBBAe9m9hf3jEbfzc2gFdWdm9OEZft&__tn__=%2CO%2CP-R,15,0,positive,15
pfbid02EtC4iZtF6xBMxcpufTjYVnZ8m1zJAPYTjbPu79FgB34GgohS9G8uMzCY6GEcVyRBl,NVIDIA AI,2,22,2,0,0,0,0,0,24,1,"From forecasting to last-mile delivery, #AI is redefining the #retail industry. Tour our AI-enhanced landscape to see the possibilities in action. https://nvda.ws/3XnCI9x",2023-06-22T00:00:00,[],https://scontent.fcai19-7.fna.fbcdn.net/v/t39.30808-6/355874263_644309704399981_7427902639748465413_n.jpg?stp=dst-jpg_p526x296&_nc_cat=107&ccb=1-7&_nc_sid=730e14&_nc_ohc=XxXZAMPQYokAX_JcFHa&_nc_ht=scontent.fcai19-7.fna&oh=00_AfAw-9a9mHDE-Gsyt1VkPZagL_9f3-JDh_mZD5VnSCEIXw&oe=64E38E10,https://www.facebook.com/NVIDIAAI/posts/pfbid02EtC4iZtF6xBMxcpufTjYVnZ8m1zJAPYTjbPu79FgB34GgohS9G8uMzCY6GEcVyRBl?__cft__[0]=AZXhYvF_N1nNT6Iz0rgiQVwZr46kCmshrxPArN-QTQIiltjiH9Xtqh7wPYSHadun5VPgvVePTO8y-xd7ApJ9oYTCtA4uhG7bu_EddCuJj58tqDA-dpHU7ZW_v0zPsmgsk7VELcAA2b6JzJQQFwHRihWpMW-loxMJ8fYbEEQw_2f5Zk-LUhGd_cjN7U51vXC5KcG-2E84w-wB2XcH8GK3koKP&__tn__=%2CO%2CP-R,26,0,positive,26
pfbid0239bPeJjffVBmCbDTcXK2FfAGdPfgPNEBgGtbpeteX1jeXbwDxxwDpCGy4JDVFbnrl,NVIDIA AI,8,37,3,0,0,0,0,0,40,1,See the future of #generativeAI and MLOps at Snowflake Summit on June 26.Register now > https://nvda.ws/42TSkTm,2023-06-22T00:00:00,[],https://scontent.fcai19-7.fna.fbcdn.net/v/t39.30808-6/355605403_644284397735845_6165645105889636897_n.jpg?stp=dst-jpg_p526x296&_nc_cat=111&ccb=1-7&_nc_sid=730e14&_nc_ohc=rbEDumslI6MAX-FNzUR&_nc_ht=scontent.fcai19-7.fna&oh=00_AfC3nS789FNfYww2hzlONpfD1ay3BpafI20y28balqN_jw&oe=64E3DADE,https://www.facebook.com/NVIDIAAI/posts/pfbid0239bPeJjffVBmCbDTcXK2FfAGdPfgPNEBgGtbpeteX1jeXbwDxxwDpCGy4JDVFbnrl?__cft__[0]=AZXBOp_WZGqsKH0bjHvK_GyYP__W_uHd78zmZw9rFguw1r_OGKVbigD2ohpP_tCfb6KoQRzITtdHX8hn3wRi6BjSs6yW3NhqXZLYLJSYgtuPIfjdj3cpLHxHx8rG9vriLu-4tuc-NuFt405B_7Q9A7vLptqSamuq-mQ5dmUNApn25mG0uyvuMQPbzrRoXiGDhit_7lnCEHnZD4xQqulWti14&__tn__=%2CO%2CP-R,48,0,positive,48
pfbid027KiJkrd7hVj3JK186tQSNXwNbZ4vpzGSJNDkwj45bUSTNVDv5zAxHAoAhGT4aDK4l,NVIDIA AI,1,19,0,0,0,0,0,0,19,1,See how UC Santa Barbara Professor Philip Lubin and his students are using #AI and NVIDIA RTX A6000 GPUs to accelerate the detection of hazardous asteroids on a collision course with Earth! ,2023-06-22T00:00:00,[],https://external.fcai19-7.fna.fbcdn.net/emg1/v/t13/13382965701521771153?url=https%3A%2F%2Fblogs.nvidia.com%2Fwp-content%2Fuploads%2F2023%2F06%2Fucsb-blog-header.png&fb_obo=1&utld=nvidia.com&stp=c0.5000x0.5000f_dst-jpg_flffffff_p500x261_q75&ccb=13-1&oh=06_AbHU788xLBU1ZkXigjs9nBqj1quknjEFcNY10SQi5mt5rw&oe=64E0510D&_nc_sid=dbad39,https://www.facebook.com/NVIDIAAI/posts/pfbid027KiJkrd7hVj3JK186tQSNXwNbZ4vpzGSJNDkwj45bUSTNVDv5zAxHAoAhGT4aDK4l?__cft__[0]=AZVo_1zxzmZBwhZHEKtjjjI3PZyrroxjKOZrq0ll0a0co2l7oJR28Uz3gIM4coiPisiubXuJUByKnOc0j45y5XPGO_dLg8VN3zKUfYSkqOG4geLb4VaDIDOkazBpoNodVODNiyIw46SDvoB4nwMhvZNMDyK3My5KRVdXyaI83F6KV9T8VQ2UKCTWsovF4Brevt22_aOOiC_ZCN0_exInIdLx&__tn__=%2CO%2CP-R,20,0,positive,20
pfbid02nfmTqoZiuiZ5exn6vxBSqgoTiGvhHYuqrG5Hnqh3qd4QfHj4cvDqBs4UBH1atjTnl,NVIDIA AI,1,15,2,0,1,0,0,0,18,2,"We pioneered accelerated computing to tackle challenges no one else can solve. Now, the AI moment has arrived. Discover how our work in #AI and the metaverse is profoundly impacting society and transforming the world’s largest industries: https://nvda.ws/3JpFtSa #NVIDIAstory",2023-06-21T00:00:00,[],https://external.fcai19-7.fna.fbcdn.net/emg1/v/t13/8122003093654691989?url=https%3A%2F%2Fprod2-sprcdn-assets.sprinklr.com%2F50276%2Fcfe2cb93-f509-4377-8ec1-0491844ca851-1835824708%2F15_NVIDIA-1200x625_-_Ohana_Dor.jpg&fb_obo=1&utld=sprinklr.com&stp=c0.5000x0.5000f_dst-jpg_flffffff_p500x261_q75&ccb=13-1&oh=06_AbGlAShT0BJ1N1I2-eQkLKpRzg8BX9_34gY-csuGQRVrZg&oe=64E000FC&_nc_sid=dbad39,https://www.facebook.com/NVIDIAAI/posts/pfbid02nfmTqoZiuiZ5exn6vxBSqgoTiGvhHYuqrG5Hnqh3qd4QfHj4cvDqBs4UBH1atjTnl?__cft__[0]=AZX4bmj5VP_Ydu2ehhmyT-rkwiMw8OpUEwMFQzcASZzzhk8pHHtdUgD6QOEma2btKwMRxI6dHEmBUsGKoRj_SMtFRSKvmn_iVonKc8ufh6bul_Xm6V4JFS1yZRwgfWcSWw6ERsTRxql52ShBfuQz-FR6RznocTnfZ8Ot7-UYoNnVPvK2N9190kE9ba96rSEoko-3YThYFTRXZz2J4NKZctBr8jb9pCG-3W7XChPfuy_rO8y-f5bJrmNmp-fd15rWbgs&__tn__=%2CO%2CP-R,19,0,positive,19
pfbid02MokqrYQSspvYHzihaPBGDqpptrEGvcE7mKaRkhJssM12kVSMxz3HsiN14RXDW1Ykl,NVIDIA AI,2,12,0,0,1,0,0,0,13,1,"Discover how generative AI enables better products, services, and content. Watch the #GTC23 session on demand for an overview of the current state of #generativeAI and the opportunities it presents for business. https://nvda.ws/3N1soPO",2023-06-21T00:00:00,['blob:https://www.facebook.com/110bc5a6-ab36-4c54-933a-9b7751ea0faf'],https://scontent.fcai19-7.fna.fbcdn.net/v/t15.5256-10/358520181_1236033620448271_1966962272157781824_n.jpg?stp=dst-jpg_p180x540&_nc_cat=109&ccb=1-7&_nc_sid=ad6a45&_nc_ohc=0e0XneSNOhgAX8YE1aH&_nc_ht=scontent.fcai19-7.fna&oh=00_AfBWN7nIl5eLaiXaJoNNQBI9FXvy98v0SucRBhzKIiDU9Q&oe=64E4194A https://scontent.fcai19-7.fna.fbcdn.net/v/t39.1997-6/122841908_812223766267933_3152842039885787285_n.png?stp=dst-png_p403x403&_nc_cat=1&ccb=1-7&_nc_sid=0572db&_nc_ohc=JI2fVGABYxEAX-9Lcro&_nc_ht=scontent.fcai19-7.fna&oh=00_AfAsosR4pTbwRJ4u19m7mCG247kVQFy-DxKhIKJvL_8iuw&oe=64E46D9F,https://www.facebook.com/NVIDIAAI/posts/pfbid02MokqrYQSspvYHzihaPBGDqpptrEGvcE7mKaRkhJssM12kVSMxz3HsiN14RXDW1Ykl?__cft__[0]=AZV6B7m_uAwYuzqEtecQp42n680pbzFK-4kavIXDPbmnsJl2c75DHNebBrxR-wRzbCcCbP7p9G9z9oOuFz8B3eIhzbQ3gSGkVVARQVfQ1ykrv4VQNeRHCteM4Fag6W-RWCUGRU4kFEkBUyFNyjUb4Km_TE2ycjhAqBVTidDIi7ciW3crZTobz4g0RqXeekyUl64Qy7c3EY_YgzRunh6ee7TrSpZfvIvKPlk7RRZE6pyWvF1CrszNLAZGKuLkWeTVSro&__tn__=%2CO%2CP-R,15,0,positive,15
pfbid031fD1p1UsjKV6b7FuQykCuCWd6AsCFjbyKz3Ybi9xxGQgB6HQnCpfEMTAaSnJ2EDPl,NVIDIA AI,1,7,1,0,1,0,0,0,9,2,"Listen to this episode of NVIDIA #AI Podcast, to explore the groundbreaking role of mRNA technology in vaccine development and its potential to revolutionize immunization strategies. https://bit.ly/3OnmKd5 #healthcare #drugdiscovery",2023-06-20T00:00:00,[],https://external.fcai19-7.fna.fbcdn.net/emg1/v/t13/6492578958774254741?url=https%3A%2F%2Fblogs.nvidia.com%2Fwp-content%2Fuploads%2F2023%2F05%2Fnewsletter-hc-launchpad-lab-drug-discovery-600x338-1.jpg&fb_obo=1&utld=nvidia.com&stp=c0.5000x0.5000f_dst-jpg_flffffff_p500x261_q75&ccb=13-1&oh=06_AbHmTjR__MRb9GJF4VuqwXus7NnXo1I1KWYomWE7xcFdAg&oe=64E00A77&_nc_sid=dbad39,https://www.facebook.com/NVIDIAAI/posts/pfbid031fD1p1UsjKV6b7FuQykCuCWd6AsCFjbyKz3Ybi9xxGQgB6HQnCpfEMTAaSnJ2EDPl?__cft__[0]=AZVeUz480ivaa5ZJ2n9UO1IZPIAKov_d0Afb7TbmCU0Sq-hmIXUf4xa69FISD8QJ8XmhmKUdQIxV5eUg4ab_iGzBumU4r-e0ZVMt66vjAoAvjEa1BMChMrmOPfLAjR8xlvmX-449CZr73vL7JJxzOgfqsfasheE8Gdvjl8hjjT45ZCxtuDJtgqn9XrUpoC2uFFsixzU5UieJkX14xpVvbwHJ&__tn__=%2CO%2CP-R,10,0,positive,10
pfbid034MpDKQ8bB2GYWb6rigRPKF9Ttu9oeULpUDKdSTJpLAhBLtKKVgXimSVrjPWK5CNwl,NVIDIA AI,1,25,3,0,0,0,0,0,28,1,What makes USD unique? Universal Scene Description (OpenUSD) is a powerful way to describe assets in a 3D scene. Learn to utilize the USD Python API to experiment with the fundamental concepts of USD in this self-paced course. Enroll now: ,2023-06-16T00:00:00,[],https://external.fcai19-7.fna.fbcdn.net/emg1/v/t13/9455183775975661386?url=https%3A%2F%2Fprod2-sprcdn-assets.sprinklr.com%2F50276%2F27852e59-7e74-412b-a08c-35f282b48557-1111757458%2Fdli-social-usd-in-omniverse-li.png&fb_obo=1&utld=sprinklr.com&stp=c0.5000x0.5000f_dst-jpg_flffffff_p500x261_q75&ccb=13-1&oh=06_AbHxV0bKYSi1v8JVFoCqdU-yn4BPGLzm9s9v-kqWJkP7Bw&oe=64DFFDE5&_nc_sid=dbad39,https://www.facebook.com/NVIDIAAI/posts/pfbid034MpDKQ8bB2GYWb6rigRPKF9Ttu9oeULpUDKdSTJpLAhBLtKKVgXimSVrjPWK5CNwl?__cft__[0]=AZXicodYIGi3MYC_3InwqmhJij2imbq0jZxeswlwDFcOxN-FgxrLo8sBjlAVumw43V48qHX_caKfwx7zTm8atldz3k-50t7OzMDKmT8O--4zcCoyfULm6goqMgKV4P5IRXb4yBMW8CbV0CE6Cislzwn-LuvLlwDDjCoCmOUpcqTArNYs6ImOHKL0gp5JY3xNm9CWbb-Wm1QZ6JpO78A7m_nR&__tn__=%2CO%2CP-R,29,0,positive,29
pfbid0wyp5HDdR8NaL3TZsxdqYNdN2LEQ9GSx3QYr4ew2j2Nt75bnoyjQ9SXtzeehDyNXnl,NVIDIA AI,2,18,0,0,1,0,0,0,19,1,"Discover how #retailers need a new approach to #supplychain challenges that are inherently agile, adaptive and intelligent — and it all starts with #AI. ",2023-06-15T00:00:00,[],https://external.fcai19-7.fna.fbcdn.net/emg1/v/t13/9832644374832503206?url=https%3A%2F%2Fcdn.pathfactory.com%2Fassets%2F10412%2Fcontents%2F438319%2Fthumbnails%2F600x%2Fmaxresdefault.jpg&fb_obo=1&utld=pathfactory.com&stp=c0.5000x0.5000f_dst-jpg_flffffff_p500x261_q75&ccb=13-1&oh=06_AbENJx3O5WhkgOPenucn-N9L4WpHLCRYHJrE3ADkcwSGVA&oe=64E06A71&_nc_sid=dbad39,https://www.facebook.com/NVIDIAAI/posts/pfbid0wyp5HDdR8NaL3TZsxdqYNdN2LEQ9GSx3QYr4ew2j2Nt75bnoyjQ9SXtzeehDyNXnl?__cft__[0]=AZUOtBt4uSgXGyC2FvtgBEb2PsolWHytnzBonz-wC1NDkIKNzqwAs7u5IiRMZ9xhT8K1bHUzhNo6sgWG0ozraOUcKuFTE92qFSEDn96kZVEhwItSit2mGIib5vmWra6V-zedFHOjqiHneEpaQV1qJTRFJc2pdSlQEkizWkCYh4KRO3kVtcylo55ZdFPvDW8c1SS-wFdCPbUf-VcbZZzDIPfW&__tn__=%2CO%2CP-R,21,0,positive,21
pfbid0Phd7rtCz6GGtpz4qWGQmhengYu8Scyho6TjUBP7DHp7J5ozbFSW3CvpZE1kdKVhal,NVIDIA AI,1,23,0,0,2,0,0,0,25,1,"Learn about the opportunities, challenges, and concerns with new innovations for #generativeAI with fellow panelists Keith Strier, NVIDIA’s VP for Worldwide AI Initiatives, and the #NVIDIAInception startups playing in this space: Bifrost, MediVR, betterdata, Pebblely and WIZ.AI at the #ATxSummit. Read more: ",2023-06-15T00:00:00,[],https://external.fcai19-7.fna.fbcdn.net/emg1/v/t13/12359749247034589311?url=https%3A%2F%2Fcdn.techinasia.com%2Fwp-content%2Fuploads%2F2023%2F06%2F1685592345_My-project-1-6.png&fb_obo=1&utld=techinasia.com&stp=c0.5000x0.5000f_dst-jpg_flffffff_p500x261_q75&ccb=13-1&oh=06_AbHXjhB8nvJMWwcTKrVDVo4mMUPLQoV1od-HfWEblE39zw&oe=64E02389&_nc_sid=dbad39,https://www.facebook.com/NVIDIAAI/posts/pfbid0Phd7rtCz6GGtpz4qWGQmhengYu8Scyho6TjUBP7DHp7J5ozbFSW3CvpZE1kdKVhal?__cft__[0]=AZUV6Y-YKOual7VyaKAvZNJhxfIS0OoaXz1QjCifEFPhkRlJHzIhd6MCXow5HHSuq2hLOk-Gr53FC4-MwditlMNJLFDRUbM-oDzGLkrDT1Cj_0EPALa8-MOZEWKHvY4seFyWgC1p-XIMbi_Xv2nUGXGPLlgiO8TxLx-bNRvAYW7SAsjkwksLyxR9nK8eVED1UUji0FpuYm_UjTE3GjKd8lyQ&__tn__=%2CO%2CP-R,26,0,positive,26
pfbid0PyttTr2JaNe9z6DBP3K6wamVHpBLFSexH32c86Ldbej3SLhZVSFvqsZ12dGhLdg1l,NVIDIA AI,0,26,0,0,0,0,0,0,26,4,Did you miss our webinar on what telecommunication companies need to know about #NVIDIARiva’s cutting-edge speech and translation AI? Catch up on-demand: https://nvda.ws/3XcA9Hw,2023-06-15T00:00:00,[],https://scontent.fcai19-7.fna.fbcdn.net/v/t39.30808-6/353842205_640198498144435_8541415250223973446_n.jpg?stp=dst-jpg_p180x540&_nc_cat=104&ccb=1-7&_nc_sid=730e14&_nc_ohc=MFh1GPRykskAX_JIVGP&_nc_ht=scontent.fcai19-7.fna&oh=00_AfD-MN6uzUqBldMeAEUQhyGctGBUR0eRJMd-5JRWjTYJyg&oe=64E3C070,https://www.facebook.com/NVIDIAAI/posts/pfbid0PyttTr2JaNe9z6DBP3K6wamVHpBLFSexH32c86Ldbej3SLhZVSFvqsZ12dGhLdg1l?__cft__[0]=AZVIIs-i7SM-KHZvcxpzOKXmY291KknE7B3i2fhDOMsB0uiXnJQre0dz1evSdo69M0gEmim9qlkbQ1GtBGL788lX1HsP8VDm9YgbFU2lWRM19ab4hNgpLzS7hHDrLYu17HQUuX56nD9CoQ_k0bqZrE4rKiGsw8jijNulJsfyB50SamH65hgNfOPfhUVWNQZMZVLdnCd_5UBlyte1SRN0br1f&__tn__=%2CO%2CP-R,26,0,positive,26
pfbid02vJ4tmNbrxwpncwEboYXDVUZQk5tP2t71RBCXQaKB2yB5bM9QBZLN2VmhkcXvE66Fl,NVIDIA AI,5,43,5,0,0,0,0,0,48,1,How can you use ChatGPT and GPT-4 to build an AI-powered extension for @NVIDIAOmniverse?Join our #AMA on June 28th to ask the experts.Register here: https://nvda.ws/3X6jk0O,2023-06-15T00:00:00,[],https://scontent.fcai19-7.fna.fbcdn.net/v/t39.30808-6/354463616_640169418147343_6199052638459110680_n.jpg?stp=dst-jpg_p526x296&_nc_cat=106&ccb=1-7&_nc_sid=730e14&_nc_ohc=71x_zPVCWeoAX_1xMf1&_nc_oc=AQk-Pj541HI_4xe7FIgc05-kYwRE5NpjLm-bDdTWeSc-PKEBR6b0W38qIdyMx-oOeHA&_nc_ht=scontent.fcai19-7.fna&oh=00_AfCQkBQNdD_afzBjNhtrhwAkyKGImuupX5O9VwRkE6tuaQ&oe=64E2A02B,https://www.facebook.com/NVIDIAAI/posts/pfbid02vJ4tmNbrxwpncwEboYXDVUZQk5tP2t71RBCXQaKB2yB5bM9QBZLN2VmhkcXvE66Fl?__cft__[0]=AZVycNwS0-KbVcp4sVxo1D61g9y7W4yR5QUPisq_lqbN9b0fgAKSqb72AmgN021j6Y-BlKGEb4PtTFK-eNn37uqkMF_AH-NEBirTcC9ZrkX_QKW-lSApNHNJYucqUiXou7JQUlwcP0LT3m9PyaADlONEhjrxdKz81wiprtHbkdKkev4uvdNArW9oONttIkq0tKjTiT6hWZmkB1UzHLh7mbjS&__tn__=%2CO%2CP-R,53,0,positive,53
pfbid0vqjsFNNfdCveCnhGHn6KwZRrkuBPE5ECW12krJHVgJWPjFF8vygGjaXcSfFLEn5bl,NVIDIA AI,2,15,3,0,1,0,0,0,19,3,"Curious about the latest advances in AI that are shaping the future of technology? Hear Demis Hassabis, CEO and Founder of DeepMind, share the company's latest #AI breakthroughs and how they're revolutionizing scientific discovery. #GTC23 https://nvda.ws/3MWIPgt",2023-06-14T00:00:00,['blob:https://www.facebook.com/f8fd1a3f-8ed3-4485-939d-d14ed57220ae'],,https://www.facebook.com/NVIDIAAI/posts/pfbid0vqjsFNNfdCveCnhGHn6KwZRrkuBPE5ECW12krJHVgJWPjFF8vygGjaXcSfFLEn5bl?__cft__[0]=AZVqHlj_uZ0PiHygrgtilM1JP_HM_H68yS-f6nfBY_I2hrnrC5aB4Gq2gUkMZXUehk1Z4s5UwnGBC0ctTrrqVDUl_IatN3uYwIM8qH2DNbMouqGqF6QCFabTi5IYJBvrlD6VofDCXYE1cmO1t9Lwqo5OB8I2vDiormJhgordQmmkXdDCONNF-BVclGm6SzxyjFe_L9ttaROGjFYfOOBpbQ1gm_3puaBWFxkK4raFIAxF9UiOxENdXdSGy2sW6Jw2DvI&__tn__=%2CO%2CP-R,21,0,positive,21
pfbid031TQu2tL7dKTHDDTfqCVwzaiWFufMfhopk3iqVBPmMqPUkeEgzvqF57E3aNVuxMCbl,NVIDIA AI,0,11,0,0,1,0,0,0,12,1,"How did ChatGPT become the fastest app to reach 1 million users?Learn the story behind its meteoric rise and its connection to NVIDIA GPUs. Also, explore the future of generative AI with NVIDIA CEO Jensen Huang and OpenAI Co-Founder Ilya Sutskever in this #GTC23 fireside chat.Watch the full session  https://nvda.ws/3C7JgiY",2023-06-14T00:00:00,['blob:https://www.facebook.com/0baa90a7-c73b-4a8d-b214-644725ead250'],https://scontent.fcai19-7.fna.fbcdn.net/v/t15.5256-10/355736635_240849265338521_3172668082289739179_n.jpg?stp=dst-jpg_p180x540&_nc_cat=108&ccb=1-7&_nc_sid=ad6a45&_nc_ohc=Bdw_aLHlh0IAX_PIrGs&_nc_ht=scontent.fcai19-7.fna&oh=00_AfDoxNaDSynfwsT_OzB_4TH4M1sAdxdQ5x5rCdrEmJE9EQ&oe=64E2AFE6,https://www.facebook.com/NVIDIAAI/posts/pfbid031TQu2tL7dKTHDDTfqCVwzaiWFufMfhopk3iqVBPmMqPUkeEgzvqF57E3aNVuxMCbl?__cft__[0]=AZXB9P8u5ZdnhIGmIlpWH7JhGu0NjBY_wEmFVAVEg7QZTiz5aM_GwzwaeefbXsQ6eJcKEuTYskZby-qGsK7iXMEvJ4y6AJKtDwB5HbFZtyiul1U2kAAc1TUJEXmPMC6PXRQK6-lDWeYdQmH7BnI_dQNu2DSEDVFmmv-JIM8fXByDSQRO6NTBQnLnYCrqqgngPMuIfxTYuVFhQ0NlEvZn5OKt3J8C42BhE9oP0Eutn-DqocnvgeJJkT-EUDDMl_48aGs&__tn__=%2CO%2CP-R,12,0,positive,12
pfbid07svx9sAnzuTtCmmAfkoveJxry1TYptEgPuPzhKUqUCMxoxVFJewV73wYigaSDwiFl,NVIDIA AI,0,24,2,0,0,0,0,0,26,4,"We are in the #AI Pavilion at #HPEDiscover. Discover how we are taking #generativeAI to the enterprise and partnering with key software vendors across financial services, life sciences, manufacturing, the public sector, and retail. (Booth #378)https://nvda.ws/3p26Eve",2023-06-13T00:00:00,[],https://external.fcai19-7.fna.fbcdn.net/emg1/v/t13/15136642761797117254?url=https%3A%2F%2Fwww.nvidia.com%2Fcontent%2Fdam%2Fen-zz%2FSolutions%2Fevents%2Fhpe-discover%2F2023%2FHPE-Discover-og.jpg&fb_obo=1&utld=nvidia.com&stp=c0.5000x0.5000f_dst-jpg_flffffff_p500x261_q75&ccb=13-1&oh=06_AbEdYllJsuKdftqhIn0FFNakU0TtdwDQuqtuAcO6bMqufA&oe=64E0935C&_nc_sid=dbad39,https://www.facebook.com/NVIDIAAI/posts/pfbid07svx9sAnzuTtCmmAfkoveJxry1TYptEgPuPzhKUqUCMxoxVFJewV73wYigaSDwiFl?__cft__[0]=AZXmXkjCANcCzDBhTyjl-cTrWUACvWDYiWgs2NMliN7guB-uXdUjrAdPEWGCk_xzy0cy8oyET8loTR6916Izgk4rUGPM0R6u1AcxbmVeLzi6Ziks8RbS3aXyty7oyJzacMZnBgerHNaR_npm-uRu15MTwzR1AmRmaZG-CbsX8Av0SfVEt1flDlrawriKhskf28DKHAu9EzS9D-eXOdH9zHL0&__tn__=%2CO%2CP-R,26,0,positive,26
1195000517832882,NVIDIA AI,7,24,0,0,0,0,0,0,24,1,"Last chance to register for this live webinar. Join NVIDIA to learn how #AI is transforming financial services across use cases such as fraud detection, risk prediction models, contact centers, and more. #deployAI #inference #FSI https://bit.ly/3OIycjI",2023-06-13T00:00:00,[],https://scontent.fcai19-7.fna.fbcdn.net/v/t39.30808-6/353663574_1195000514499549_5700970820613346498_n.png?stp=dst-png_s960x960&_nc_cat=102&ccb=1-7&_nc_sid=9267fe&_nc_ohc=DY8PojpX4A0AX_pNqsG&_nc_ht=scontent.fcai19-7.fna&oh=00_AfAAFK2Bg0eayqbvx_KAsKjWNZtfl8OsPHwScwOalOZb6Q&oe=64E3D06B,https://www.facebook.com/NVIDIAAI/photos/a.119492422050369/1195000517832882/?__cft__[0]=AZUewBitooB1483uKht2g-CC4clKInkbidrbCGo7jZVwA2OUbWRtaMz8gcty0-Y-ufrTDn-4kh1RzRaTIWM2azTvaAAcr0FRcif1ou5Df-Wj2lErE6F1kd1zVjuAMIXsNi1GPFsTBLkr0QrID-Krlk0JL4T09tPphQT2vgyElHdWAIM-4tYwymUHaTWUEkMEGgs9bLf9l90H0NR8DIPSq6NZ&__tn__=%2CO%2CP-R,31,0,positive,31
pfbid0dsKWeXCBJXkjLrBAu4xPej6RWqYyiewhDFJajCEfS3g9B5cQe8RVT9nTf6WbUtCKl,NVIDIA AI,20,129,11,0,0,0,0,0,140,3,Ever wondered what runs #ChatGPT? Learn how NVIDIA and Microsoft Azure collaborated with OpenAI to build the #AI supercomputer infrastructure that hosts ChatGPT and other large language models. #DataCenter,2023-06-13T00:00:00,[],https://external.fcai19-7.fna.fbcdn.net/emg1/v/t13/9112171421105398222?url=https%3A%2F%2Fdeveloper-blogs.nvidia.com%2Fwp-content%2Fuploads%2F2023%2F06%2Fwhat-runs-chatgpt-featured.png&fb_obo=1&utld=nvidia.com&stp=c0.5000x0.5000f_dst-jpg_flffffff_p500x261_q75&ccb=13-1&oh=06_AbE5FjrYybCQaEe5E-gkSYWb_-ZZqlQpMJt-yUGE9k2Dug&oe=64E00502&_nc_sid=dbad39,https://www.facebook.com/NVIDIAAI/posts/pfbid0dsKWeXCBJXkjLrBAu4xPej6RWqYyiewhDFJajCEfS3g9B5cQe8RVT9nTf6WbUtCKl?__cft__[0]=AZUmUlUt2NhhyTJyOEKzcbaY3TLSPxgGSq017CSqCbvbbqys4jmkU6IJYOZotEcm6qeu9EHyU56FnFhDlMK_nP-UjPo_WrdzRl8vXOgcjsDtY2Tw1oJ4vYsWlcQlycphyfLXq70eYWyh1kAKSk3exEeo-iJtADIg8cMndIEIEBGNE9hdGuTqPpObWhTp5HCjCU3QC9ojNz6YPsXTPGN0XOTS&__tn__=%2CO%2CP-R,160,0,positive,160
pfbid035EpH63bLiyGojeu4CqSpHsKdaXFSZ5TLiUvQkUXJg3rJeaC3CwnKntrpKGfdP1Sil,NVIDIA AI,6,28,3,0,2,0,0,0,33,2,"Vision Transformers (ViTs) are transforming vision AI apps with superior accuracy and unprecedented image understanding. Join our webinar to learn how you can fuel your #visionAI applications with the power of ViTs, #NVIDIATAO Toolkit, and L4 GPUs for unmatched performance. Register now > https://nvda.ws/3NdSIHL",2023-06-12T00:00:00,['blob:https://www.facebook.com/4b71f8a8-1aab-4181-b2c9-c4554b958eb4'],https://scontent.fcai19-7.fna.fbcdn.net/v/t15.5256-10/350367748_1350133338903371_3990353377118956376_n.jpg?stp=dst-jpg_p180x540&_nc_cat=106&ccb=1-7&_nc_sid=ad6a45&_nc_ohc=m5YpQVERiKUAX9Ya5kN&_nc_ht=scontent.fcai19-7.fna&oh=00_AfA-3V-nUOk7tVI86zZOQEoKTkEUbynmnrlKPNwf0VTbPg&oe=64E39881,https://www.facebook.com/NVIDIAAI/posts/pfbid035EpH63bLiyGojeu4CqSpHsKdaXFSZ5TLiUvQkUXJg3rJeaC3CwnKntrpKGfdP1Sil?__cft__[0]=AZWKdt_ssE8kPSbtyGhh5fKFR9Gv2nLDVwIo1YLfmPSz6MDaSS1LQ-xwecBqGLn1tUhddHKCwq_AR6-GzpWuamCkk5CTOoeNKCMmBYC3jxTX9aoOuKpBQN-3ePLr9uX0X-1A4A89lkB5y7WxUbLKLHQ5ZgbJ6odV9SI3l--MphSSHX5_uHDLFqGa52aho966rrg3iUwrt6snAxz6Zna4uUDL6_cHoOhIKdGx6E0TSSMYG5gsKMHdb7xzrmFBsyXC5TY&__tn__=%2CO%2CP-R,39,0,positive,39
pfbid02gQyJAYLQs8HJXrVM5sDK128b8Eqz2jD6oyWxbcEc1W7rdJPoZJHRo5GZCsDo7o8Hl,NVIDIA AI,0,7,1,0,1,0,0,0,9,2,Explore how Elara Systems is leveraging #NVIDIAOmniverse Creator to transform #medicalimaging and enhance patient understanding. Discover the cutting-edge technologies shaping the future of #healthcare. Read more: https://bit.ly/3obCpBz #GenerativeAI,2023-06-12T00:00:00,[],https://external.fcai19-7.fna.fbcdn.net/emg1/v/t13/9995650904145541150?url=https%3A%2F%2Fblogs.nvidia.com%2Fwp-content%2Fuploads%2F2023%2F05%2Felara-systems-mto-feature.jpg&fb_obo=1&utld=nvidia.com&stp=c0.5000x0.5000f_dst-jpg_flffffff_p500x261_q75&ccb=13-1&oh=06_AbE0cByhEGFBbAfvpWsLPAvFv1hUmNd0W1EqfDLA-RnaZA&oe=64E083D2&_nc_sid=dbad39,https://www.facebook.com/NVIDIAAI/posts/pfbid02gQyJAYLQs8HJXrVM5sDK128b8Eqz2jD6oyWxbcEc1W7rdJPoZJHRo5GZCsDo7o8Hl?__cft__[0]=AZWEvKfnSRPBqFfafAl50W_07DNqWwmqCpgUGMDkgrlwI_RyKe-ZlbYVsl-HtSpdbDgP_F6TXi9lo1XWF5JzfaI3tw_K-VTtqUpAaXSdeqdNJRu56qRwjG57shLxk61MRuw8IUDUIW1LzXRh5myO5Av_NmAgHWuC8cpGtSl8T9OdB1actoqwlAGTT7S914OEHR9UbqZ2PIQpqcjSzaR-w9jk&__tn__=%2CO%2CP-R,9,0,positive,9
1194419381224329,NVIDIA AI,0,14,0,0,1,0,0,0,15,1,"Last chance to register. See how accelerated #AI #inference is helping banks and insurance companies better detect and prevent payment fraud, as well as improve processes for anti-money-laundering and know-your-customer systems. #Finance #modeldeployment https://bit.ly/3OIycjI",2023-06-12T00:00:00,[],https://scontent.fcai19-7.fna.fbcdn.net/v/t39.30808-6/353390259_1194419374557663_1466581568180783720_n.png?stp=dst-png_s960x960&_nc_cat=111&ccb=1-7&_nc_sid=9267fe&_nc_ohc=oTSkq_nsK0UAX_HEjcX&_nc_ht=scontent.fcai19-7.fna&oh=00_AfC0MVkK32EoqxwTv1ipsXPH4hD_etlGo6GKL5cJCo_kzA&oe=64E46A15,https://www.facebook.com/NVIDIAAI/photos/a.119492422050369/1194419381224329/?__cft__[0]=AZWY8b52G1rsGzphF-bTgseUY0XpzmLO8hLe66ZkM31CaYM-a83wAlvpM3Qf3YPaLvc9rOHcE4WVYpwALfuoKyQrsGAuNN2cInPglcXaHYe6nCl6959s69luWJ436s6Vs-iARX25p4DIGGoTwatle2xFz_V828Pzp6LsiMUvkWPMmtbI3OMJTS99f6HBqQMjMNCWvuIEe1R6ZsKeQxUALIzU&__tn__=%2CO%2CP-R,15,0,positive,15
1193800734619527,NVIDIA AI,0,20,2,0,3,0,0,0,25,2,"With #AI intelligence at the grid-edge, #utilities can modernize legacy power generation, transmission, and distribution infrastructure, scale #renewableenergy, and deliver lower cost energy to homes and businesses. Learn more: https://nvda.ws/3CkehAf",2023-06-11T00:00:00,[],https://scontent.fcai19-7.fna.fbcdn.net/v/t39.30808-6/352982025_1193800731286194_2179325738089850660_n.jpg?stp=dst-jpg_s960x960&_nc_cat=109&ccb=1-7&_nc_sid=9267fe&_nc_ohc=TJy73fgl5awAX981hw3&_nc_ht=scontent.fcai19-7.fna&oh=00_AfCLI_N3kiG8OpkzMKnyglz3XkMx5ibWIsYMmKEwb7fkog&oe=64E36AAF,https://www.facebook.com/NVIDIAAI/photos/a.119492422050369/1193800734619527/?__cft__[0]=AZUWzy9coR-V6wcBEBmmkdAB4WrvqgJK1mZ4Cz34sSx5E185QZFWnR-hR7vd4T4qp59ujw5mJdI2cMHFt5LPWNAVXDnOMoYcV8u6J2afYuStTfBxdzWMtOzNFIyzR9SWTSmGXqwS8q7rNTEjPpsk1RkzPXGsjppuJlRJYuFgxBo82SkhS8GTiOXL6G64cSW3HeasuHnmYjYjnP8IfjchupBg&__tn__=%2CO%2CP-R,25,0,positive,25
1193264054673195,NVIDIA AI,6,43,0,0,0,0,0,0,43,1,"Global #energy companies including bp, Chevron, and Shell are accelerating key subsurface workloads—such as reservoir simulation and seismic processing—with #AI, high-performance computing (HPC) and 3D visualization.Learn more: https://nvda.ws/3Njf9ew",2023-06-10T00:00:00,[],https://scontent.fcai19-7.fna.fbcdn.net/v/t39.30808-6/352561702_1193264051339862_7346743089184188588_n.png?stp=dst-png_p180x540&_nc_cat=100&ccb=1-7&_nc_sid=9267fe&_nc_ohc=18ddshOBMJAAX83LmoW&_nc_ht=scontent.fcai19-7.fna&oh=00_AfBcgCh8FKRWVie8DeGrIjaffS4a_ZtGTYLZbfHZ5y0R5w&oe=64E3EDA8,https://www.facebook.com/NVIDIAAI/photos/a.119492422050369/1193264054673195/?__cft__[0]=AZWwivAwXcTRpxh5HRw0Jr6jBsNMI1j0Ejp9DkqzJC5n08_wBH8qY26J0ndSYybZkvjkVbOMkgDq3-iJ8jB1d43e9t8GZ0GW2eQVa-NLJ55h9xtjXi1HSpbu7Oytp9t6eTpwobNaEYBS1O-lx9Ui4-aXQJXtukjZUM6YQIZ2sx3ajZfVY19pOs_PEm3dY5p67RZLc2Semd8QTYZgJtua2_eo&__tn__=%2CO%2CP-R,49,0,positive,49
1192846438048290,NVIDIA AI,0,24,4,0,0,0,0,0,28,5,Join the Deep Learning Institute in this instructor-led workshop on June 27th. Learn how to train the largest of neural networks and deploy them to production. Register now: https://nvda.ws/3X0sBHE,2023-06-09T00:00:00,[],https://scontent.fcai19-7.fna.fbcdn.net/v/t39.30808-6/352826471_1192846434714957_39412885565542752_n.jpg?stp=dst-jpg_s960x960&_nc_cat=101&ccb=1-7&_nc_sid=9267fe&_nc_ohc=6OFYbeXvbLUAX-mybXc&_nc_ht=scontent.fcai19-7.fna&oh=00_AfD2GU-R90nKDZOJZRariuUtqFyzE3Tsxur1VYou-27c0Q&oe=64E2A71F,https://www.facebook.com/NVIDIAAI/photos/a.119492422050369/1192846438048290/?__cft__[0]=AZVjsF9c2EVxDjyUrPMEdudBes8Xm1vo6Q5nFdFtq0m4X6UUrV4reSgrvv9Er6Dc5jnMUh9FHApqhL0HQe8263yP4K4MKdpVyzI09PBRpHkFy3E9DF2hM1MZKZRw-iLFt0pw16qu7C1zpcqskA8ENxcuky3H0-dZ4BUUm6Wq0lZuMSjswn_T1Kfqbv0IQ6P8HWEXQBFz03KsXaGC3MnzwxvN&__tn__=%2CO%2CP-R,28,0,positive,28
pfbid02rRy9FVtKxDpZxnyDpjVsziuNxavz8AjxQLvccLRZAv8V5WZJAwfhXvfuwuTJAN6Yl,NVIDIA AI,3,27,0,0,0,0,0,0,27,1,Dive into the #code to leverage #neuralnetworks and kernel-based methods to enhance real-world objects' #3D reconstruction process with #NVIDIAResearch Neural Kernel Surface Reconstruction.  And maybe win an RTX 3090Ti ...#NKSRSweepstakes. New weekend plans?https://nvda.ws/43IQ6Hy,2023-06-09T00:00:00,['blob:https://www.facebook.com/e2b96c0d-d617-435d-a82a-da94980cabfa'],https://scontent.fcai19-7.fna.fbcdn.net/v/t15.5256-10/349038575_1290198571929126_84043650160590554_n.jpg?stp=dst-jpg_p180x540&_nc_cat=103&ccb=1-7&_nc_sid=ad6a45&_nc_ohc=gcPJmBKCvvAAX-OZjFg&_nc_ht=scontent.fcai19-7.fna&oh=00_AfDGhyB6q_Y-jLgSaAXW0mT9tgp7xeX3jLFM4LVeqUgWog&oe=64E4002A,https://www.facebook.com/NVIDIAAI/posts/pfbid02rRy9FVtKxDpZxnyDpjVsziuNxavz8AjxQLvccLRZAv8V5WZJAwfhXvfuwuTJAN6Yl?__cft__[0]=AZVePDKr-RcaJwboEU0-50gUI7-2uF1vkKOODzzr1eoqroj0wl8G7r___RuKtPT9It84cdq6uuHN56tiYAIiOYtLvvQcp7qBRChj1kRt90oXt4MO5aH7BXNZs1pvnKNH-IicbCmZfbSC7L2Wxcbas9zdC-B84mdzqsRlIS09g_LilJ2-F1lASTo0rViKi-RnbBM3edD9_DeJQKD-_LmbfmoAkfaGqE_Suhl1W8RFp47J8A&__tn__=%2CO%2CP-R,30,0,positive,30
1192796654719935,NVIDIA AI,0,28,0,0,2,0,0,0,30,1,"Register for the live webinar to see how NVIDIA Triton and  NVIDIA TensorRT can help improve financial services’ ROI with easy deployment, running, and scaling of #AI models. #inference #finance #modeldeployment https://bit.ly/3OIycjI",2023-06-09T00:00:00,[],https://scontent.fcai19-7.fna.fbcdn.net/v/t39.30808-6/352406532_1192796648053269_6956875483572364423_n.png?stp=dst-png_s960x960&_nc_cat=101&ccb=1-7&_nc_sid=9267fe&_nc_ohc=E15xIR4bNIcAX8f6Wtj&_nc_ht=scontent.fcai19-7.fna&oh=00_AfC66o88r5DN9N8nhFVi_ShtYe6V8tUKKoSuF-nxEpr9ug&oe=64E34D24,https://www.facebook.com/NVIDIAAI/photos/a.119492422050369/1192796654719935/?__cft__[0]=AZVLckCIj5GYolMm0yNK6BIH6NispHRwFqZOoK6WvTWJERh6Zuu8MuhlKH4og0O0K6FWT4r4UMxjyhyJVVrvvqoxYCF38j-RYiT1rNB_fIefl2S2pS-JzpAb5CH6233crUdf0BqXJHXykFRYlWBdscMehycuJuNx7lxAjxzYw9M4ejd0uajYxT8mSt5szbDhiIRcWknoP20qQFQT8zfIUBO7&__tn__=%2CO%2CP-R,30,0,positive,30
pfbid02BPiTZaxz4uMV5iKWMnZDnMTZgGqYydzAgCvgyXLNAq83hCduFbC7VhbuLEdQ45Zdl,NVIDIA AI,3,23,0,0,0,0,0,0,23,1,"A joined effort between NYU and NVIDIA, explores how #LLMs can improve patient readmission predictions with incredible accuracy. This AI-powered approach has the potential to revolutionize patient care and reduce #healthcare costs. https://nvda.ws/3J0ZNsQ #AI #GenerativeAI",2023-06-09T00:00:00,[],https://external.fcai19-7.fna.fbcdn.net/emg1/v/t13/16906602558774448423?url=https%3A%2F%2Fblogs.nvidia.com%2Fwp-content%2Fuploads%2F2023%2F06%2FAdobeStock_231024312-1.jpg&fb_obo=1&utld=nvidia.com&stp=c0.5000x0.5000f_dst-jpg_flffffff_p500x261_q75&ccb=13-1&oh=06_AbGmZohyV0NGcErC0iZGWYmmhDbmf0ssYSnUZ0NU5mOJjA&oe=64DFFE1A&_nc_sid=dbad39,https://www.facebook.com/NVIDIAAI/posts/pfbid02BPiTZaxz4uMV5iKWMnZDnMTZgGqYydzAgCvgyXLNAq83hCduFbC7VhbuLEdQ45Zdl?__cft__[0]=AZXRrHLDNGKYPLU4wCKXGCg41QX_xxCDBTExNX1TmTpimL6RKUZWrwdB_BJUCHbdo6x94AKD4oeVxqmDJ2RWYg7O61wWGDRFgrDfXLFjYcD4h0ULZryJ1LscFNZ_zyduhElXeXhProh4uMeky1hKrTSY0QiAql8Q9vbiPWRlcTvM79csjZGU95D3FN-e3s4n9RRT6jVs_A0HCWdGRrbI25f3&__tn__=%2CO%2CP-R,26,0,positive,26
1192657074733893,NVIDIA AI,0,13,1,0,1,0,0,0,15,1,"NVIDIA and Bridge to Turkiye Fund are committed to enabling a disaster-resilient future. Together, we’re announcing the Disaster Response Innovation and Education Grant. Educators and researchers in Turkey who are developing curricula & new technologies for natural disaster response are encouraged to apply! https://nvda.ws/3oWVs2Q",2023-06-09T00:00:00,[],https://scontent.fcai19-7.fna.fbcdn.net/v/t39.30808-6/352382505_1192657071400560_9033853843040430181_n.jpg?stp=dst-jpg_p180x540&_nc_cat=110&ccb=1-7&_nc_sid=9267fe&_nc_ohc=R1U5ZjCdDQIAX8trUFW&_nc_ht=scontent.fcai19-7.fna&oh=00_AfBQxTGxlWVxtD6rfstaWajGPq63-FCdseBtb_rvVBgxqw&oe=64E37531,https://www.facebook.com/NVIDIAAI/photos/a.119492422050369/1192657074733893/?__cft__[0]=AZWQlS6mB841SZGhD3MyGYGmeUfJrA3VrxOguIRcYkK9XzTFCOFXA7BXyzgIeQ7G-dI4qegp4l35Uatl9m6X5V6DuSatF53kN4jWtc_3UwMD8CGt_P0Yf45i3tTlZHGoFRMS8ReIBJ9YdZcRf-Dd8i7VOVgHXXzGvH-P31DbVfA2BROF1kCCcOT6V643cmho5w46CyAqRDWa-OpdLT_j5d6H&__tn__=%2CO%2CP-R,15,0,positive,15
1192311304768470,NVIDIA AI,0,17,0,0,1,0,0,0,18,0,"Join us for a live webinar to learn how #AI can deliver successful outcomes across top use cases, such as transaction fraud and contact-center automation. #finance #inference #modeldeployment https://bit.ly/3OIycjI",2023-06-09T00:00:00,[],https://scontent.fcai19-7.fna.fbcdn.net/v/t39.30808-6/352749768_1192311301435137_2405090406714465327_n.png?stp=dst-png_s960x960&_nc_cat=109&ccb=1-7&_nc_sid=9267fe&_nc_ohc=aMlKqSV1t1gAX_GI92d&_nc_ht=scontent.fcai19-7.fna&oh=00_AfCqoMJD7uZI7y4P3Ya9OJ8xQ_ESpwzJkcCY9kWRjLSYlw&oe=64E3D344,https://www.facebook.com/NVIDIAAI/photos/a.119492422050369/1192311304768470/?__cft__[0]=AZWvYQkFv-jNbdQ529kfrtQgvPf1jzAYmY7oNSyPNeMcp9yE5CeJgCoQuj0Xij7JqZ9cCLjmz8sf56nNDkuofUjAiebcdo_M5zDPcfpX1FDIYrnT9KLaqh-brsDqweDgLiFgbRc-2-3gGWT3r_ykpWJqD7mGuyJajZeQNU62LQ89fhBmQzLsj2EsQQictjTuLAp6yLnZmcjF4RHO33QXn4N5&__tn__=%2CO%2CP-R,18,0,positive,18
pfbid0YME35jhr6ExSzahNhVCNfNt8JQ3TyE9k8PojfvhpFndGuRqxpojVU9khLVSnBnX6l,NVIDIA AI,2,36,0,0,0,0,0,0,36,1,NVIDIA Triton is powering Microsoft Bing ads and delivering 7x throughput for the search giant at a reduced cost. Check out how here: https://nvda.ws/43kKF1s,2023-06-08T00:00:00,[],https://external.fcai19-7.fna.fbcdn.net/emg1/v/t13/16070750618513410840?url=https%3A%2F%2Fblogs.nvidia.com%2Fwp-content%2Fuploads%2F2023%2F06%2FMS-Bing-logo-x1280.jpg&fb_obo=1&utld=nvidia.com&stp=c0.5000x0.5000f_dst-jpg_flffffff_p500x261_q75&ccb=13-1&oh=06_AbHqflDPjOGIIg7GPK7Hr3a2tLE4HN6tRlB_PatEfbqFmA&oe=64E04C30&_nc_sid=dbad39,https://www.facebook.com/NVIDIAAI/posts/pfbid0YME35jhr6ExSzahNhVCNfNt8JQ3TyE9k8PojfvhpFndGuRqxpojVU9khLVSnBnX6l?__cft__[0]=AZVoyNxTayxWKABckM72TGbkqkukTRP2ehU9kAIPBQRILJ2G0Q1f1fHDrv4cOODJo9l-IfCCafz9x2Tzj8QPMAaQIKAyl2sFH7WpJ4Snk_bSPYfLD47-ZiIMWF0OQOvnzT1hNWRmPCf2Sbqy58RtSPw_TlCpReUm6vhSh9ZhNICJYAJqcQmneGcAYo-9n98_x3BIMVBYR2Hu5sYrKn546VAs&__tn__=%2CO%2CP-R,38,0,positive,38
1192244164775184,NVIDIA AI,1,18,1,0,1,0,0,0,20,1,"Join NVIDIA at #HPE Discover on Wednesday, June 21 at 1pm PT to hear how HPE and NVIDIA are changing the game with these new inferencing solutions designed for Large Language Models and Generative AI Workloads. https://nvda.ws/43pGdyr",2023-06-08T00:00:00,[],https://scontent.fcai19-7.fna.fbcdn.net/v/t39.30808-6/352372579_154859904245752_8606662917719353617_n.png?stp=dst-png_p526x296&_nc_cat=109&ccb=1-7&_nc_sid=9267fe&_nc_ohc=kFket3vb6nIAX90dPGh&_nc_ht=scontent.fcai19-7.fna&oh=00_AfAxiWjtIMJve_QEMYejclejJtzcocmEm7rE70L8ZZZU8Q&oe=64E32D54,https://www.facebook.com/NVIDIAAI/photos/a.119492422050369/1192244164775184/?__cft__[0]=AZWvq13oU6JEddjaIFWYGHr1oVXidpNHQTIE5sAUWlkDaqF_AsHl0w0xDXuzt1Ud7j-9lyLkse6M7bRt1FgjSCp-zfU8333-PsXZmOXYAapfIdq--xAHYVqNs5IVGpHtq4eiZ60xAhJNWXOzHApaOFR5QsiZVelym7ox6-cIVZCFG0pV3n2CR5L4-CdGxZRVN6X6wlPKVmpfX8lRLI6A2Zxm&__tn__=%2CO%2CP-R,21,0,positive,21
pfbid02sq7Sg5esjRiP5n3yP9ayDcPKybwR6wzvRqpRFQ6BNhwuFxC6QvAECLpuSfHe1bEUl,NVIDIA AI,0,10,0,0,1,0,0,0,11,1,AI is revolutionizing #healthcare in Africa by freeing doctors from paperwork and empowering them to focus on patient care. Discover how #AI technologies are streamlining processes and improving healthcare outcomes. #LLM Read more: https://nvda.ws/3CcRA0X,2023-06-08T00:00:00,[],https://external.fcai19-7.fna.fbcdn.net/emg1/v/t13/3916266532181034634?url=https%3A%2F%2Fblogs.nvidia.com%2Fwp-content%2Fuploads%2F2023%2F05%2FAlt-KV-x1280-scaled.jpg&fb_obo=1&utld=nvidia.com&stp=c0.5000x0.5000f_dst-jpg_flffffff_p500x261_q75&ccb=13-1&oh=06_AbGCWcHry0k_8i1NKDvkm4YVExcHsToJvSstnxAYB2h1Lw&oe=64E08ABD&_nc_sid=dbad39,https://www.facebook.com/NVIDIAAI/posts/pfbid02sq7Sg5esjRiP5n3yP9ayDcPKybwR6wzvRqpRFQ6BNhwuFxC6QvAECLpuSfHe1bEUl?__cft__[0]=AZVmxT-QfQdM4K0cBvLOUbIA6v9MibNOZClt5c3CKWp18hfJA9Mbq7dGCn4hIeWuRhiAUV-DowHIU3FKbJV13XJpdUi6kaZNvrnNuLYOos6v00MVgioGJkjIZvuXdIoNoOtpstk9H6r6kJ6KXBSsUwW6axPboKSmv0qjnbHw-az533dW-DCaF-0-N-9_sBwOpLdZdc9GnxlP-0mF2jK0Lzaq&__tn__=%2CO%2CP-R,11,0,positive,11
1191801028152831,NVIDIA AI,0,17,0,0,1,0,0,0,18,3,Financial firms had the 2nd highest cybersecurity breach costs at ~$6 million last year. Learn how NVIDIA Morpheus enables #AI-based #cybersecurity to identify previously undetectable threats and contain breaches faster. Register for the webinar: https://nvda.ws/45KiScq,2023-06-08T00:00:00,[],https://scontent.fcai19-7.fna.fbcdn.net/v/t39.30808-6/352200853_285249493881616_190451822920236995_n.png?stp=dst-png_p526x296&_nc_cat=107&ccb=1-7&_nc_sid=9267fe&_nc_ohc=_2yGaXJqYx8AX9fOnjl&_nc_ht=scontent.fcai19-7.fna&oh=00_AfCT9hLIVravlZvkinJTRe2GBwKUZKd5YH6ufQwRaR-jEg&oe=64E30E47,https://www.facebook.com/NVIDIAAI/photos/a.119492422050369/1191801028152831/?__cft__[0]=AZWe0J22s8VwtMaNjTc9WldKOEh63v5ec0nTEFr1A4nV53rD7191aAIHbfxQJF5Zrdz2a14odHEVFUkrZth6Z3KaRbMggMZYLh3XC1-XTq1Sj4p6F4WdXqe7i_lzByN3pvm_r2O3mG7UWwy4ZP93OtUd44A8KKpk4GrZd6O9rMpXW-k27sh4N3samXlsb3BPhEZxOyeAK1NXNM9pDgM6-F5A&__tn__=%2CO%2CP-R,18,0,positive,18
pfbid0sKWxqcfDR4vnGYKoZ39G6EXjoK8gHcW8amnLFQqUh4MUs8YiazScU5gEy5Vsmtbzl,NVIDIA AI,0,17,0,0,1,0,0,0,18,0,"NVIDIA NeMo framework is an end-to-end, cloud-native framework for curating data, training and customizing foundation models, and running inference at scale. Check out this video to learn more and discover how you can get started with Nemo framework! https://nvda.ws/3Ndtqtb",2023-06-08T00:00:00,[],https://external.fcai19-7.fna.fbcdn.net/emg1/v/t13/14501338244897783549?url=https%3A%2F%2Fi.ytimg.com%2Fvi%2Fn2c_spQuexU%2Fmaxresdefault.jpg&fb_obo=1&utld=ytimg.com&stp=c0.5000x0.5000f_dst-jpg_flffffff_p500x261_q75&ccb=13-1&oh=06_AbFnsPJXq3YuXLVS7c_SOovOSJPoHnhXw-i-1NHzRVfMgg&oe=64E02EE0&_nc_sid=dbad39,https://www.facebook.com/NVIDIAAI/posts/pfbid0sKWxqcfDR4vnGYKoZ39G6EXjoK8gHcW8amnLFQqUh4MUs8YiazScU5gEy5Vsmtbzl?__cft__[0]=AZXNG9nZZXp_EJFdJ8jw5xWbbAwt0UX1269tiK8wNCk280rBFTu7xfJ5IYV-LlotAdXujmiFoXFcGE1uvRpDJ0PcahvX0kZhSr7ZlWPY9EbYDBm5SP0vwulCLIv7M6gSZgLBlOXzatDkwJ8pWZP4k_pAO4OT71LFVCJE11LrgM5gHsIUwmRWzNerC_SQs3FJ9waBUsSq3t6VglFPWpfoYRek&__tn__=%2CO%2CP-R,18,0,positive,18
pfbid03QfZwVnjDHcgJceZFHH3EbCcSLi2TbcmiWkJQJTpYURJeSzfVFQMYZvM1NWUFFmQl,NVIDIA AI,0,8,0,0,1,0,0,0,9,0,"Our Founder and CEO Jensen Huang and ServiceNow President and COO CJ Desai talked about the recent partnership, the future of #AI as an industry, and how #generativeAI models will transform enterprise #IT operations. Watch the entire video: https://nvda.ws/43LyZEY",2023-06-07T00:00:00,['blob:https://www.facebook.com/5ed487cb-ad6e-4fc1-8e02-ca000ebbff18'],https://scontent.fcai19-7.fna.fbcdn.net/v/t15.5256-10/350898309_269065492282821_883316011824324316_n.jpg?stp=dst-jpg_p180x540&_nc_cat=103&ccb=1-7&_nc_sid=ad6a45&_nc_ohc=4OCc0NY2eV8AX-7wzWR&_nc_ht=scontent.fcai19-7.fna&oh=00_AfAkwDntHhampFbO1spJVfjt747JAr_0EvVLF2CYZ_Zpdg&oe=64E377F0,https://www.facebook.com/NVIDIAAI/posts/pfbid03QfZwVnjDHcgJceZFHH3EbCcSLi2TbcmiWkJQJTpYURJeSzfVFQMYZvM1NWUFFmQl?__cft__[0]=AZUjSF_lisV3pnYn9p2B61CfmlTsWOauXLAjdlCerCEzdz1s66GaAKX69f81H317YwPnNunHfpFq_Zu1Gz3Vtz54ptNaDyxEVQTA4DBBqRTG6WKAaRwXoQhMK1vlDs3nUTOgU9jBvDWN1Y12XT8D6HN5hu0nAPKNdMLiLAlJEcbVWzeXSwtUAUtsKxjKnxiZZA2HOo4tzsj6veoQmhPRW2VWgNqWdLTW1z3-4f95TSy43QfziNhBfp5axGsbu1AvINQ&__tn__=%2CO%2CP-R,9,0,positive,9
pfbid0HmPjpqeG2Zdnix5yMsZrN1gukeMMAma1EzzKKTxKNx9SJpDBp5LnaqiZRsMRrWPVl,NVIDIA AI,0,19,0,0,0,0,0,0,19,2,"Join us at LLMs in Production, the MLOps Community virtual conference June 15-16 as we discuss best practices on evaluating #LLMs and how NVIDIA is powering Generative #AI. Register now: https://nvda.ws/3MTdJ9o",2023-06-07T00:00:00,[],https://external.fcai19-7.fna.fbcdn.net/emg1/v/t13/15170890799951732110?url=https%3A%2F%2Fd2xo500swnpgl1.cloudfront.net%2Fuploads%2Fmlops%2FLLMs-Prod-Part-II-thumbnail-624-326px-Gradual-56ef1a75-7408-4cdc-8acb-143c9d719f06-1683816813351.png&fb_obo=1&utld=cloudfront.net&stp=c0.5000x0.5000f_dst-jpg_flffffff_p500x261_q75&ccb=13-1&oh=06_AbEeRSVLrazpK6J8on0N_e3DqsmjY8lgHysT06OZk2vkeg&oe=64E0854C&_nc_sid=dbad39,https://www.facebook.com/NVIDIAAI/posts/pfbid0HmPjpqeG2Zdnix5yMsZrN1gukeMMAma1EzzKKTxKNx9SJpDBp5LnaqiZRsMRrWPVl?__cft__[0]=AZWFTzcT0kutO7VT7sCZ4-qPQRQpN2L2jndTKuEJVSbG2aUGByOSy8blFk23K-CDlhn5EFOfA7wj5DjIZqVvqVdNNdJzFvhWCl4bdOzdkd3y569ajouAGGglJmnTGxxO7borBXz3VEhknHM4jXboVgtPw4wsAgzpyc1Wa9VB4un5WWD1hDWfhZFnH--0s3y-441pZdHDK00uipVtoY_SPbJW&__tn__=%2CO%2CP-R,19,0,positive,19
1191673801498887,NVIDIA AI,0,17,1,0,1,0,0,0,19,1,"NVIDIA is partnering with #HPE GreenLake across many areas to deliver speed of innovation for customers looking to take advantage of the cloud consumption model.  Don’t miss this #HPE Discover theater session on Tuesday, June 20th at 4:30pm to get all the latest updates!!! https://nvda.ws/42rp7iD",2023-06-07T00:00:00,[],https://scontent.fcai19-7.fna.fbcdn.net/v/t39.30808-6/352186525_267006522658219_6682656371866137483_n.png?stp=dst-png_p526x296&_nc_cat=104&ccb=1-7&_nc_sid=9267fe&_nc_ohc=B8kZw3lahYkAX_6wkD7&_nc_ht=scontent.fcai19-7.fna&oh=00_AfCZunj9syYyCeoeNpvIhZ_4W9-bafIy8TVjXuMBFw_KUA&oe=64E381BE,https://www.facebook.com/NVIDIAAI/photos/a.119492422050369/1191673801498887/?__cft__[0]=AZU3sRTbLi90WqA_0T0mys1WNhmF8Fb6cFy0xnozCK3_KHQuCExZ5hquE00e-SPfkADccvPG_b28yEMZ2_ArLGF8HpDvVI-lQEY8y68Y_SoXpk_MDVslFIgCgkyMJv-32FIziX4JI_aeWZUEV-aCM2FAE9NXfCJpQ6HaBN5F4Q29mAzMZ3_GVZ1boAyhZ0KVnwxxv4Az6XyOicWGHf2mmSdA&__tn__=%2CO%2CP-R,19,0,positive,19
1191596948173239,NVIDIA AI,2,27,0,0,0,0,0,0,27,1,"Join us at our booth today (6/7-6/8) at the AWS DC Summit and say hello! Experience captivating demos on #digitaltwins and #cybersecurity, along with exclusive showcases of #GenAI and #HPC demos featuring our esteemed NVIDIA Inception partners, MosaicML and Rescale. https://aws.amazon.com/events/summits/washington-dc/",2023-06-07T00:00:00,[],https://scontent.fcai19-7.fna.fbcdn.net/v/t39.30808-6/352559887_2452167478285851_8280156304291709749_n.png?stp=dst-png_p526x296&_nc_cat=110&ccb=1-7&_nc_sid=9267fe&_nc_ohc=k-AwaweL3o4AX9d9aKp&_nc_ht=scontent.fcai19-7.fna&oh=00_AfCSevMgpetpyOdhzzrdcVvIQnVazjhth3P67MGATnHIBA&oe=64E3485B,https://www.facebook.com/NVIDIAAI/photos/a.119492422050369/1191596948173239/?__cft__[0]=AZUU7NUIINeHBr9xbHLjtpsKRBox5njCeqgx6Okw5QzxKUU5XWqHJIMtuGbLcQCeCGhR3pomnSW56C1-nfxcDMaUUOnCTHxLILh9tZ1fFaBTTdMPOf7NBtkinw1F2iHgX2BvXombQSVzxQ4W44_HC_8BMvIF460-gFHR6ueRMB5EmSKyyk4YixbScV_Bnx-4l3jzqcn2p_5x4TAnHnpNGsYI&__tn__=%2CO%2CP-R,29,0,positive,29
1191194284880172,NVIDIA AI,0,27,0,0,2,0,0,0,29,4,NVIDIA and Microsoft have teamed up to accelerate generative #AI for enterprises. Request access to a private preview of NVIDIA AI Enterprise within Azure Machine Learning and discover multiple reference examples in the Azure ML registry. https://nvda.ws/3NdtUj0,2023-06-06T00:00:00,[],https://scontent.fcai19-7.fna.fbcdn.net/v/t39.30808-6/352359247_718862956707128_7775699425031715978_n.png?stp=dst-png_p526x296&_nc_cat=105&ccb=1-7&_nc_sid=9267fe&_nc_ohc=ydPD9TbNJBUAX_0TpeC&_nc_ht=scontent.fcai19-7.fna&oh=00_AfA3EubpMldvLfUvqycvPB-a2qbCWVbrCKjZDTC1dXyYSA&oe=64E3E325,https://www.facebook.com/NVIDIAAI/photos/a.119492422050369/1191194284880172/?__cft__[0]=AZWhMg7TvSB4XTyiQjMvLab--a2m3c4wl9bGE3MARRTQyadD1mOYmWjJCvOpeKYZMmpr9MqFikFHrzSkrXUC4LCxShWJCjEiNqYrLLnDbDHjVqc7Dckqjd3DWa1EXuntYTXruKNn6nDSQhUkHVjPj8fthltURQVoKEh2e4n-yuueXiu5nrArWUM1B6jpX3TEt_qyK4rAXjM8S8evhIhTHaoO&__tn__=%2CO%2CP-R,29,0,positive,29
1191175168215417,NVIDIA AI,2,16,0,0,1,0,0,0,17,1,"Are you heading to the AWS DC Summit this week? Join us for an insightful session on 6/8 @ 8:45AM ET (Room 146B) where NVIDIA’s AI experts will unravel the power and key role of digital twins, cybersecurity, and generative AI in the public sector. https://aws.amazon.com/events/summits/washington-dc/",2023-06-06T00:00:00,[],https://scontent.fcai19-7.fna.fbcdn.net/v/t39.30808-6/352397396_1246087316040896_4055769288474247487_n.png?stp=dst-png_p526x296&_nc_cat=103&ccb=1-7&_nc_sid=9267fe&_nc_ohc=2cp3Hq_KMHoAX-PewnI&_nc_ht=scontent.fcai19-7.fna&oh=00_AfBcKrf77CSRUpd8dyV6hr-Ruk3RxeKOjRK5xX0st3GtuQ&oe=64E37909,https://www.facebook.com/NVIDIAAI/photos/a.119492422050369/1191175168215417/?__cft__[0]=AZUT0AG_hFDajjieE1q-wd66i7LJWD57jdI7MPs2yZ2dwKacsH4ncybKEppXg6ud_G32v-nm5k8R3GbWO6sFN5E27tfDSTs8uIzsn0SzDe1GS_3p3wD83MvW0nB7WofI942aBbIf3_xEU4cX6i6pRsxHqaHhZYn-hsg_FqL57kp31hOB25OtZA0Fk5r6tezD5kEaHVp1wel0gzG_9G6cTelr&__tn__=%2CO%2CP-R,19,0,positive,19
1191154814884119,NVIDIA AI,0,11,0,0,1,0,0,0,12,0,"Missed GEOINT 2023? Delve into the #FedGovToday on-demand interview with Bob Pette, Vice President of Visualization at NVIDIA, as he shares the advantages AI is providing for is providing for the public sector. https://nvda.ws/3MQAFG9",2023-06-06T00:00:00,[],https://scontent.fcai19-7.fna.fbcdn.net/v/t39.30808-6/351529823_589156699720867_105946636513501951_n.jpg?stp=dst-jpg_p526x296&_nc_cat=100&ccb=1-7&_nc_sid=9267fe&_nc_ohc=KQ7jp0JxDFsAX_HynGV&_nc_ht=scontent.fcai19-7.fna&oh=00_AfCpIBbrisri6oYJi7aTx9mWrLfsXHO_UNdrUPwngwhvUg&oe=64E3FD27,https://www.facebook.com/NVIDIAAI/photos/a.119492422050369/1191154814884119/?__cft__[0]=AZXBkfC5zs70Va-rYrsrmCTSYQLpchr1pZAPNOGoJ3mGqksXSTwm__TgawFQDCbbusfZJAJsdtHMT6YpoAmXJXDSu8cXo5x3e0sdweKnQ8fEuZytbF-Ei7FzeaNyRjKOIcytLYEbSy5TUgI66RNfuEgOx2583Jg4od0voPvB2wKcwf_uhuDol5-HjRig9bk-FEr_5FRwogtHp48_fTSUA1pc&__tn__=%2CO%2CP-R,12,0,positive,12
1191134778219456,NVIDIA AI,0,19,0,0,0,0,0,0,19,1,"Last chance to register for our webinar with @Infosys, NVIDIA and @Quantiphi on June 7! See real-world examples showcasing successful implementations of multi-language, #speechAI agent assist solutions in #telecom contact centers. https://nvda.ws/3LzyAz9",2023-06-06T00:00:00,[],https://scontent.fcai19-7.fna.fbcdn.net/v/t39.30808-6/351575188_1214343695930752_292432990920287723_n.png?stp=dst-png_p526x296&_nc_cat=106&ccb=1-7&_nc_sid=9267fe&_nc_ohc=GDDdYXP7LQIAX-LF3On&_nc_ht=scontent.fcai19-7.fna&oh=00_AfDrFRvaY_9RUfuy_GmoVIaEh2KQPTsLLAv16-92-YALLg&oe=64E39D9D,https://www.facebook.com/NVIDIAAI/photos/a.119492422050369/1191134778219456/?__cft__[0]=AZUQpOsdFRGkn8yLYwCGw8u4o6jvOVfvd2sCdI1ttBPwe-DSgh_Jy9CoEvMtPztoM_tNbtdUgrIDnnsNgkUe6C4b5R8w4MTi5Eba0pogyi0ESdWtW3-_q2sryn1NfYCxwGXXmdN6zdc1q4hQgKX-I8LilbaDRpstWCqYS90fh3HRc4hXt5gFTieLI4rFusoWgdP6cSAKLXoOYBQ3LhhN_T-h&__tn__=%2CO%2CP-R,19,0,positive,19
1191064714893129,NVIDIA AI,0,59,0,0,0,0,0,0,59,10,"The NVIDIA HGX AI supercomputing platform is the most powerful end-to-end #AI supercomputing platform that brings together the full power of NVIDIA GPUs, NVLink, NVIDIA networking, and HPC software stacks to provide the highest application performance. Read more: https://nvda.ws/43mu9OH",2023-06-06T00:00:00,[],https://scontent.fcai19-7.fna.fbcdn.net/v/t39.30808-6/351505754_483903013925562_6000718955703191807_n.jpg?stp=dst-jpg_p180x540&_nc_cat=111&ccb=1-7&_nc_sid=9267fe&_nc_ohc=a4QfoBf4Q0YAX8N94QD&_nc_ht=scontent.fcai19-7.fna&oh=00_AfDejb3nPGDrqpq9v1xN91DvlhctU3yBRR0RuZUxMKjS1w&oe=64E47171,https://www.facebook.com/NVIDIAAI/photos/a.119492422050369/1191064714893129/?__cft__[0]=AZX6172SnjrbLjDvcDeCM1oyBqyvQSzGR-BMlmkhWSzPAmZEkW3nc1f-hXWz9E2_YtEGgWGc8L7s07G5yVwy-OVhN-vOkEvM5QPXDTB3mBFs-w1VuP8-Udu43mfFm6yEMfl4HhRVgrYa7NOFL4EINqm0Uh7Pj2DI-b04p7afi_IQ_uSoJ390PiafmmnPDo7NYFAMGLnRXbllhoZWHK7BW1TV&__tn__=%2CO%2CP-R,59,0,positive,59
pfbid02NFRNpAmV3Y7ixC53GvWELKRcaX9yAetsemLnjprKjKjLc8RJ5x1HpK53W3SDdW3tl,NVIDIA AI,0,12,1,0,1,0,0,0,14,2,"Learn about NeMo Guardrails, the new toolkit for easily developing trustworthy LLM-based conversational applications.It works with all #LLMs and natively supports LangChain #AI, adding a layer of safety, security, and topical guardrails to existing applications. https://nvda.ws/3IZ4d3c",2023-06-06T00:00:00,[],https://external.fcai19-7.fna.fbcdn.net/emg1/v/t13/14458607045409934761?url=https%3A%2F%2Fi.ytimg.com%2Fvi%2FHg2KibOvnLM%2Fmaxresdefault.jpg&fb_obo=1&utld=ytimg.com&stp=c0.5000x0.5000f_dst-jpg_flffffff_p500x261_q75&ccb=13-1&oh=06_AbFWbCDSqRm-i45AHVPjBBx8YLCHWMSdbFtkzZ0Z-LaPvg&oe=64E009CD&_nc_sid=dbad39,https://www.facebook.com/NVIDIAAI/posts/pfbid02NFRNpAmV3Y7ixC53GvWELKRcaX9yAetsemLnjprKjKjLc8RJ5x1HpK53W3SDdW3tl?__cft__[0]=AZV1iUyyS9B6ufj58Q_Gw0uPJ-9d813E-gX2BgdhdP--YwoJvGTaqbjfnpKYKfOr0Joce-TL9PchkTBpf6O0yeOPbQzpdbZf8StMiWoJQiNp1qraZ6_gEg8yFV_ohZfCjZ5ynnZot0dGybPW4bbnvrfjgRshXKNuJp5_mqXfl5YGDWqTwu36-NAvbWaivzK_CF4F6UZd_3e4vC_cXc9eumlU&__tn__=%2CO%2CP-R,14,0,positive,14
pfbid02MMDdqJ1DHUTaTqLdhWzx369jy5Bo1JiuTYa9J6GdzSqhsotfiE1MDFfgjtbKy72Pl,NVIDIA AI,0,17,1,0,1,0,0,0,19,1,Join this Ask Me Anything on June 29th and ask our experts how you can build an AI-powered extension for NVIDIA Omniverse using ChatGPT and GPT-4. Learn more: https://nvda.ws/3IT3gtc,2023-06-05T00:00:00,[],https://external.fcai19-7.fna.fbcdn.net/emg1/v/t13/6951600912296474865?url=https%3A%2F%2Fprod2-sprcdn-assets.sprinklr.com%2F50276%2F707d0f7a-79d5-4f61-96ab-9de0f923b2b4-440569874%2Fsocial-gen-ai-ov-ama-1200x628.jpg&fb_obo=1&utld=sprinklr.com&stp=c0.5000x0.5000f_dst-jpg_flffffff_p500x261_q75&ccb=13-1&oh=06_AbEeAqjTTXAtsyZ7GmuKxCEMDccUdNn-DneQbJKuyfGZaA&oe=64E0222F&_nc_sid=dbad39,https://www.facebook.com/NVIDIAAI/posts/pfbid02MMDdqJ1DHUTaTqLdhWzx369jy5Bo1JiuTYa9J6GdzSqhsotfiE1MDFfgjtbKy72Pl?__cft__[0]=AZXIgWtMhJADonNO5r40xZ4zIIHNxw-gZwlWmR1A151k8Y-7w4-k_LmLA3MD39TB0dNSOF7rZFa-eeq8HcVTPlEQNsOtnyYlAqonSW-_93zUV1z4CeUston6O2bmUglRHLDwc4f9s3BpJtZU7XXim5hXlUB0oXVdvbejK1CfAWiUeM9RQ5D1bNObRHtbE-SyWpdq3qbfITz2lfzvn6BYpAfv&__tn__=%2CO%2CP-R,19,0,positive,19
1190640211602246,NVIDIA AI,0,13,1,0,1,0,0,0,15,2,"Join NVIDIA at this upcoming financial services webinar to see how accelerated #inference can enable greater security, increase transparency, and create a better experience for both firms and customers with #AI in payments. https://bit.ly/3OIycjI",2023-06-05T00:00:00,[],https://scontent.fcai19-7.fna.fbcdn.net/v/t39.30808-6/352160009_1280377729519815_7419800406137934290_n.png?stp=dst-png_s960x960&_nc_cat=110&ccb=1-7&_nc_sid=9267fe&_nc_ohc=l6eb3gmhiIcAX8reWgh&_nc_ht=scontent.fcai19-7.fna&oh=00_AfBUfoDlfIQoT0CjvmGpd4fhaDrRO0IqCBC23Tz1HhiqkQ&oe=64E4319D,https://www.facebook.com/NVIDIAAI/photos/a.119492422050369/1190640211602246/?__cft__[0]=AZX3puT-DtOWVmWoq14Z85g7HavZzkAq9HoB0BN_6r2uMVqZ8MJtUr3ZYsQT0xnQsZ9ViRmlkochJeNn1q35fJhBpJe4V494rQavIirUYXKPDV5LPKVtmxjW3TSsInr6t-bzJ_jA8iK9g26eQzadE3ZVlb4yyAb-_71k-ZhHzg3cqge7wVGvfNmx1VqVp1WE9576mQhhtt-FE9zKeW_AfFxj&__tn__=%2CO%2CP-R,15,0,positive,15
1190616594937941,NVIDIA AI,0,18,0,0,1,0,0,0,19,2,"Smarter stores, clever product design – level up with AI. From supply disruptions to shortages, learn how retail companies are harnessing the power of smart technologies and AI to tackle challenges that keep businesses up at night. #MakeAIYourReality #AzureHPCAI #NVIDIAonAzure  Read the VentureBeat article: https://nvda.ws/42fhYle",2023-06-05T00:00:00,[],https://scontent.fcai19-7.fna.fbcdn.net/v/t39.30808-6/352303208_569020445145494_1102920165493699704_n.jpg?stp=dst-jpg_p180x540&_nc_cat=108&ccb=1-7&_nc_sid=9267fe&_nc_ohc=txHHgPf8XzoAX9dlB3c&_nc_ht=scontent.fcai19-7.fna&oh=00_AfA4C7wd0q6XrKguucLHqz2tFbZ7hRb7jj3r363J2ACk0A&oe=64E2C59D,https://www.facebook.com/NVIDIAAI/photos/a.119492422050369/1190616594937941/?__cft__[0]=AZVdqnZmOg2TH76gcbeKv1kzkGIgOQifKWV3d6Pz3QA_3uzI9Lc23-X4CKjkCEuSiKjT1LrEXrYvNXurVSCFLl94MtzF8du-OTbuEqYZh4XDACUcdB-44N_eQuZmbpoRL2ZR6pOS2gpedqDwiZowh530XzpA9qAMzXvgebYt-nsuyhnQVXb1jLFHChv9puKE4zauzNJmUSTvdVJfkSOGJ4eH&__tn__=%2CO%2CP-R,19,0,positive,19
1190199408312993,NVIDIA AI,2,22,0,0,0,0,0,0,22,1,"Only two days to go. On June 6, join our #cybersecurity and #AI in #retail webinar to learn about how modern AI solutions can be leveraged to improve cybersecurity in retail. https://bit.ly/41K3Yjg",2023-06-04T00:00:00,[],https://scontent.fcai19-7.fna.fbcdn.net/v/t39.30808-6/350671100_3302914576636095_7492539571731714176_n.png?stp=dst-png_p526x296&_nc_cat=109&ccb=1-7&_nc_sid=9267fe&_nc_ohc=_PTKbGfmFX4AX9IojIU&_nc_ht=scontent.fcai19-7.fna&oh=00_AfCITdPiAIZvrw_vNcA_E8pL_zRY-XpoZFYC2tR87czzeQ&oe=64E2F331 https://external.fcai19-7.fna.fbcdn.net/emg1/v/t13/4981618893305824546?url=https%3A%2F%2Fi0.wp.com%2Fthecyberbeat.com%2Fwp-content%2Fuploads%2F2020%2F11%2Fcropped-pexels-photo-417074.jpeg%3Ffit%3D512%252C512&fb_obo=1&utld=wp.com&stp=c0.5000x0.5000f_dst-emg0_p98x98_q75&ccb=13-1&oh=06_AbGH4QYkqZUjFsuezS0l6zKJMSeIW4NwAZjSYOzbZ-xDBw&oe=64E096D8&_nc_sid=dbad39,https://www.facebook.com/NVIDIAAI/photos/a.119492422050369/1190199408312993/?__cft__[0]=AZUmX6zUbBQFFLgYNGPmhj4_r8EG-4cOI7MhIWyEqEAMIhgJQ8wlG2i3ZDiCTW7PvalkiBGrgrbrOxiLSbHFpuMkXhdw5DDFkeg56siUEiX_zQjTb-F-Jf4Df9tmHar78bxZY6aN8P4lOMSO6rg2RicqeVaOetB3v6HFTFVQvYxqaWdFSs06-RU2pIXvLq4k35bbQgKv1DfgU3JhGnja_ZYA&__tn__=%2CO%2CP-R,24,0,positive,24
1190179151648352,NVIDIA AI,1,15,0,0,1,0,0,0,16,1,"Next week, see how Cleo offers an interactive experience with personalized insights, financial management tools, and advice with an #AI-powered personal finance assistant on AWS and NVIDIA.Watch the demo at #Money2020EU on June 7: https://nvda.ws/3qf3rbT",2023-06-04T00:00:00,[],https://scontent.fcai19-7.fna.fbcdn.net/v/t39.30808-6/350814480_116828921429862_7828485142903908772_n.png?stp=dst-png_p526x296&_nc_cat=106&ccb=1-7&_nc_sid=9267fe&_nc_ohc=YovXhn-s9pMAX8f_cHW&_nc_ht=scontent.fcai19-7.fna&oh=00_AfBR6xRHYy_aWWydqlLM3vd85A6Vs_u2OmFrVk-v3wqKBA&oe=64E3ED90,https://www.facebook.com/NVIDIAAI/photos/a.119492422050369/1190179151648352/?__cft__[0]=AZX3SmH3HDzNvdNcLt7674nFrHrObINIeHXmSxtkrCp7W8Kbb9-8ukphYT5wu2cE644NYfd0S0y4Ps6L5Rt4sQRfID7BjI9JN2fT1juFS36A3u8F77XAIGJ-58_QmCmX5R_TBEfNDqVLsGzliC8__MZtOKy8i0ScJAT7OxE_iIRSKu5zYMXb5ZSLyZPtCkrgBo2EaIEgChH8ZAk6Z-VmzB7B&__tn__=%2CO%2CP-R,17,0,positive,17
1190078858325048,NVIDIA AI,0,29,3,0,0,0,0,0,32,3,"Next week, see how Clarity AI uses #AI and machine learning—powered by AWS and NVIDIA—to offer a comprehensive sustainability platform for investors and consumers to inform #ESG decisions. Watch the demo at #Money2020EU on June 7: https://nvda.ws/3N6Kx03",2023-06-04T00:00:00,[],https://scontent.fcai19-7.fna.fbcdn.net/v/t39.30808-6/352056695_269312325511039_3902295955876778579_n.png?stp=dst-png_p526x296&_nc_cat=102&ccb=1-7&_nc_sid=9267fe&_nc_ohc=Ugh8R1EYXqAAX8IOkEV&_nc_ht=scontent.fcai19-7.fna&oh=00_AfCEPW7hCKxHr2sbkf1o6qB-VWb_9EmWOdSoyqTaGHo8yA&oe=64E3A835,https://www.facebook.com/NVIDIAAI/photos/a.119492422050369/1190078858325048/?__cft__[0]=AZVDSaJCxqHM9Ebobo6Qr2X-CkL_1bA3ewDJ4_btBu7amAGGbStPz0z1tbHIMUKRXs4ynQKZffV_UfcG2FkHhR9vAgXlQWhHeg16rMKEcxdSoFgy79rhFcUdZocpmr_gBtlSX5q0ioCPcPBGrryWcb9u28fUR89qfyJ_kwTo0kFgzE5K3WYb2luHCofiZZlLK_du0_P70DWlPtf91-xtioqz&__tn__=%2CO%2CP-R,32,0,positive,32
1190003078332626,NVIDIA AI,0,13,0,0,1,0,0,0,14,0,"Next week, hear from BBVA, ING, Swift, and NVIDIA on #generativeAI opportunities for #banks and #fintechs—from asset management to fraud detection to customer service. Join the session at #Money2020EU on June 7 at 3:37 p.m. CET: https://nvda.ws/3IOr0if",2023-06-04T00:00:00,[],https://scontent.fcai19-7.fna.fbcdn.net/v/t39.30808-6/350526969_1266021237372752_4397416867401777853_n.png?stp=dst-png_p526x296&_nc_cat=107&ccb=1-7&_nc_sid=9267fe&_nc_ohc=sSc3HtK1LAMAX-pzTyH&_nc_ht=scontent.fcai19-7.fna&oh=00_AfCSZz15XFUp-OPurKTKtaGncuC-w2bBNHfBbYJWuWCKdg&oe=64E476CB,https://www.facebook.com/NVIDIAAI/photos/a.119492422050369/1190003078332626/?__cft__[0]=AZUMjFzmCPuAYcG2vQsbwlr2tLK-zmXEwO7FIHIozwihKyWPCtdcbpukMSCHvC59GAOLxaHphWrYpt6AJ1yVL4MUUuwQsKe5svXYrtTa1KjNwCK9yEJLSXeL7_wf80fmsB7nufRlJIE_NVUN73uoTg4KifRnhW5DfId3kSxAw3fLQjaYPt7NziMtDb5UXeOtThiMIHC9xglViUIZDTY1RuWx&__tn__=%2CO%2CP-R,14,0,positive,14
1189574145042186,NVIDIA AI,0,17,0,0,1,0,0,0,18,2,"Join NVIDIA at #HPE Discover on June 20th at 2pm PT to hear how generative AI will influence enterprises to develop new business strategies, and what challenges businesses face when using Generative AI. Learn how HPE and NVIDIA can help customers through this exciting journey by joining this session. https://nvda.ws/42kD2H4",2023-06-03T00:00:00,[],https://scontent.fcai19-7.fna.fbcdn.net/v/t39.30808-6/350114423_205840345691767_7741195231135471381_n.png?stp=dst-png_p526x296&_nc_cat=109&ccb=1-7&_nc_sid=9267fe&_nc_ohc=nD7-4x69pWUAX_PTc8z&_nc_ht=scontent.fcai19-7.fna&oh=00_AfBAlys6io8O9GB5z4c-LwgIwIvs9oaDSzAuPQF7NzNzig&oe=64E31993,https://www.facebook.com/NVIDIAAI/photos/a.119492422050369/1189574145042186/?__cft__[0]=AZUiGKkbyEgdcJ_2udFEhHsJ4z6gOQ6BwzBaO2F6C98EC6W8U6LnDlqFsws0J0m1XHnjDNq85nNtXq5tQgP5nuC51RTEt9j9jjPPq96VRSSqMvgwJ6Uyf2LtMJkcfoyQpGZLL8zrRIfNjslHdSyJr0ftOE44VW2-zhAS0CezpCvEnEpEjMxvfdGPTPN4fwjpHwdOvIceEJLQmYdsO9EFlqaY&__tn__=%2CO%2CP-R,18,0,positive,18
1189524445047156,NVIDIA AI,0,16,0,0,1,0,0,0,17,3,"Next week, hear from Bain Capital Ventures and Amazon Web Services on how #fintechs are using #AI and machine learning to deliver faster, cheaper, and hyper-personalized financial services. Join the fireside chat at #Money2020EU on June 7 at 3:05 p.m. CET: https://nvda.ws/43gC3ZT",2023-06-03T00:00:00,[],https://scontent.fcai19-7.fna.fbcdn.net/v/t39.30808-6/350099026_289268556782988_2547917594302413283_n.png?stp=dst-png_p526x296&_nc_cat=103&ccb=1-7&_nc_sid=9267fe&_nc_ohc=kmDKWc-AIN4AX-J4__b&_nc_ht=scontent.fcai19-7.fna&oh=00_AfBMbLpBkS1FPqUGKcWtzRO2Vxk8vKNwsanDulm1gPwlwg&oe=64E3FD97,https://www.facebook.com/NVIDIAAI/photos/a.119492422050369/1189524445047156/?__cft__[0]=AZWTRxcSTSCFPP4qUqqoRb9RDifdlYwdVcXUJCy6NCetTwd6v08TjR6bCU7lARgw2z9YFimBr7m5RO-yVVOzbYQ6NIlrPP4lzapI_7_R2_dIZtHoe0rAKJrvMVScYztsUY16toyisfUpMXqoJAhRDOkif8QdCGgdhcH5Rxi81keIH_puUF4PuyCguL4IUO6_--qaxWVlczudQ6cHfYNlgfe9&__tn__=%2CO%2CP-R,17,0,positive,17
1188850238447910,NVIDIA AI,0,12,2,0,1,0,0,0,15,0,Meet and connect with executives across the financial services industry at a reception hosted by AWS and NVIDIA at #Money2020EU in “Money in the Park” on June 6 at 6:30 PM CEST.Learn more: https://nvda.ws/3IyIXRN,2023-06-02T00:00:00,[],https://scontent.fcai19-7.fna.fbcdn.net/v/t39.30808-6/350982460_1248944249344793_2766620493858112249_n.png?stp=dst-png_p526x296&_nc_cat=101&ccb=1-7&_nc_sid=9267fe&_nc_ohc=4JyXdj_HL6AAX-RmgvW&_nc_ht=scontent.fcai19-7.fna&oh=00_AfCip__96yR-xaYvRwkAqBy8NYUVSMeRtZUX3AHDp2meAw&oe=64E47DD0,https://www.facebook.com/NVIDIAAI/photos/a.119492422050369/1188850238447910/?__cft__[0]=AZVv1IM8pxucA3N0f-aGr0nkKIGrLPpUqR6kIHxTWBJDoGYQgnibDjW1vq5acPEoLUQbKT39pIfszQoKsNKKt5X1k9kqhgjeuGiCenvsrjFiUMwiyMMfW04ha2j0NUvkcagg_6x3PbpPib__Ilzg3c29IX9hrGU2RDQms7sg3XgbTGktrv7Oq9OBcCNd2XNsuHA2OnLkcmyrNWcq29XLD-Dw&__tn__=%2CO%2CP-R,15,0,positive,15
1188609868471947,NVIDIA AI,0,20,0,0,0,0,0,0,20,1,"Over the last several years, quick-service #restaurants (#QSRs) have been faced with new challenges—ones that require fast, agile responses. See how NVIDIA Tokkio helps QSRs create and deploy branded #avatars with voice order taking. https://nvda.ws/3WGUOmJ",2023-06-02T00:00:00,[],https://scontent.fcai19-7.fna.fbcdn.net/v/t39.30808-6/349127488_974977776964330_7296081612941352654_n.png?stp=dst-png_p526x296&_nc_cat=110&ccb=1-7&_nc_sid=9267fe&_nc_ohc=IFKLn8KlbkwAX9xuq3g&_nc_ht=scontent.fcai19-7.fna&oh=00_AfDp6bQDSdSN0XD5R8abpFa-shazW7QJf0HrroHGKFmZsg&oe=64E471BD,https://www.facebook.com/NVIDIAAI/photos/a.119492422050369/1188609868471947/?__cft__[0]=AZX2QRun6QgSQE4Uq-5Lkh06Sz-lr70Wq1nz-NZPLI9d0W-ttdPekoJn0rE5mHSplJdya5chB2Bz3IM1HebIQ0L0m_CWY5vEkLBp4_KBmnNl-Idv6-3eyKD8t9Tbsgbt3uaLbfBz_xyYTEXZaVbTUmDtIIxR4wLQqGwYobpSVjxRnanVnak5fhv9W2vnXgg1H4HnTxzw3jUfLspjisIe0rEl&__tn__=%2CO%2CP-R,20,0,positive,20
1188559801810287,NVIDIA AI,0,14,1,0,1,0,0,0,16,1,Read how Quantiphi improved customer satisfaction and reduces agent churn by customizing speech recognition models with #NVIDIARiva. https://nvda.ws/3OOn0lw,2023-06-01T00:00:00,[],https://scontent.fcai19-7.fna.fbcdn.net/v/t39.30808-6/350843816_5811981565568847_3313927255122122764_n.png?stp=dst-png_p180x540&_nc_cat=109&ccb=1-7&_nc_sid=9267fe&_nc_ohc=fCywDBCQOpIAX8p9VPs&_nc_ht=scontent.fcai19-7.fna&oh=00_AfAn9p-4232249_OSZGfCk5Jj7Y4wOJxc0AfMXOYsQMNhQ&oe=64E3322E,https://www.facebook.com/NVIDIAAI/photos/a.119492422050369/1188559801810287/?__cft__[0]=AZU9yC46YkkEoYPzn7kE6XzzWBHxhQK_hnzbkaCHCfRAk0Mf7oBywmSLLjMRR790YBvCbcaCMq2M7NPMj4TpMC1v-hVVy0e8N_dwOKiu2GXiE51K0uzhmSaQg7hS9mCSIMU0eAnp_x0PVYeQD6q8VlgorlNYcoCet72NcclReS6-efiP2ddMyxBm-vclRP7tAgZ_5x91Kl12PIwus0BSgzxT&__tn__=%2CO%2CP-R,16,0,positive,16
1188540458478888,NVIDIA AI,3,20,0,0,0,0,0,0,20,1,"Join NVIDIA at this upcoming webinar to learn how accelerating #AI model #inference at scale can help banks and insurance companies better detect and prevent payment fraud, as well as improve processes for anti-money-laundering and know-your-customer systems. #finance https://bit.ly/3OIycjI",2023-06-01T00:00:00,[],https://scontent.fcai19-7.fna.fbcdn.net/v/t39.30808-6/350646760_647248936799058_1334691395902362209_n.png?stp=dst-png_s960x960&_nc_cat=106&ccb=1-7&_nc_sid=9267fe&_nc_ohc=gJ5NstLSlmgAX_2Je6K&_nc_ht=scontent.fcai19-7.fna&oh=00_AfDcz0pOAG9PDbzkVbMpeeLn0JObsK9cy2WDH_3cQilouw&oe=64E47F44,https://www.facebook.com/NVIDIAAI/photos/a.119492422050369/1188540458478888/?__cft__[0]=AZUHyjfaXJPjfQGkX10MFeHgeutX39GEyv9idircsM9oFHETBKAvRekgIVU00W9vzMjK-yWi9qb7WRb1LjDXdwemgKkKSVc1kVmFt0z7kVdJEslqYXFDy4BhHLALYRGSEzQZLvar2a2uwQGLcZK5nDJRtuU4Y9V0iG1tdC1VSfFgku2vOTs77a0XgErW34bOteCWWe8fV_7Ad1F5h1ouuIOA&__tn__=%2CO%2CP-R,23,0,positive,23
pfbid0291TNw1UJkYCvCsT7LNS8g2tpeq9wdd8TyzNA1RTcyg13eF9mTSmahWEJSKgAoGrMl,NVIDIA AI,0,13,1,0,1,0,0,0,15,0,"“We are challenging the notion that data sharing and privacy protection are mutually exclusive,”- Uzair, co-founder and CEO at betterdataCongratulations to #fintech #startup and #NVIDIAInception member betterdata on their recent funding raised: https://nvda.ws/3WMT0IY",2023-06-01T00:00:00,[],,https://www.facebook.com/NVIDIAAI/posts/pfbid0291TNw1UJkYCvCsT7LNS8g2tpeq9wdd8TyzNA1RTcyg13eF9mTSmahWEJSKgAoGrMl?__cft__[0]=AZX_2WoIk2cER0cK0E5q0wW-wZFnnmMsQ_kp06088GpyMHTfEbo4zBAMn1kA97rU1dnam9nzgqVz_dryDz9Y5_ZkZCIDMz7-JEWdrD657zSaZDIYIr4Jjybq_dWh5lUg5-UfU4z65oa1JkBf1jYeRk1HmFlrU6E2AGNr731jvwgMmEEkc5h_A30vVjA44aoTiZq4wuQdYm7456kRIRJWxzHN&__tn__=%2CO%2CP-R,15,0,positive,15
pfbid0pxTZRGU4K2EQtRy3FTQetrZEXvMncrCJeqqURdErS3evFWAass8WB8KPGYF4qbKFl,NVIDIA AI,0,21,9,2,0,0,0,0,32,37,Turn any 2D video into a detailed 3D model?Introducing Neuralangelo from #NVIDIAResearch: A new #AI model to turn video from any device -- cell phone to drone capture -- into 3D structures with intricate details. #CVPR2023 Read more: https://nvda.ws/3MNY4b8,2023-06-01T00:00:00,['blob:https://www.facebook.com/c1682155-112c-4e9c-8bf5-8a9e56f8a7d4'],,https://www.facebook.com/NVIDIAAI/posts/pfbid0pxTZRGU4K2EQtRy3FTQetrZEXvMncrCJeqqURdErS3evFWAass8WB8KPGYF4qbKFl?__cft__[0]=AZVBtEbrqSXm1eY1W1B5stoabIoZM9TPeKy-iOZW9wcaQ674ztO86XE7hHASqb8LncZjMfkkbkMjyBHmh29PORzDxVMX9-264HUTY1mUdV8-ynuk3MbsyNuUQEXPfvBlBLElfCNxNk0TbperMk6Jf5kGrHQtgbecUD_KMtwuWgir6osyDiD9x-_UblSzQLww5TA9wNWkNQ1EcrPDfkyA6UmX1Nzu66mL_vTqQSCrDEysPg&__tn__=%2CO%2CP-R,32,0,positive,32
1188431381823129,NVIDIA AI,0,12,1,0,1,0,0,0,14,0,Connect with fintechs and financial services companies at #Money2020EU in a networking reception hosted by Amazon Web Services and NVIDIA. Join the event on June 7 from 4-5 p.m. CET: https://nvda.ws/3ooAaLs,2023-06-01T00:00:00,[],https://scontent.fcai19-7.fna.fbcdn.net/v/t39.30808-6/350814378_912762946674282_8018953903395238119_n.png?stp=dst-png_p526x296&_nc_cat=102&ccb=1-7&_nc_sid=9267fe&_nc_ohc=25w6Ft7WrnYAX-mq7C4&_nc_ht=scontent.fcai19-7.fna&oh=00_AfCASiIHQCPS__9fNkD83xo9auxcCYTLv1z2fBv6zOMoFA&oe=64E46ABD,https://www.facebook.com/NVIDIAAI/photos/a.119492422050369/1188431381823129/?__cft__[0]=AZV_BMP5s8bVIMUbXMycRNpKSiXshiaKmSwpeauGCswB7zTL6_zPrnDlIBoz8OO6TAqZO7bftUM_ZWBtujcC_WPZdiVLcjUo_nhnyggBpYHaOj9aNqH3Sf7RKS00ufVc22qEBCAQj6VZteUcHvBIG6z3PGpHJCr1m9At_t4E7voWse-jNi7N5ulYXc_uOJpKENd9UiPQmRL78WTJK13E8NGX&__tn__=%2CO%2CP-R,14,0,positive,14
1188408875158713,NVIDIA AI,40,775,0,0,0,0,0,0,775,26,Just announced: NVIDIA collaborates with SoftBank Corp. to power SoftBank's next-gen data centers using Grace Hopper Superchips for generative AI and 5G/6G. https://nvda.ws/45CWQs4,2023-06-01T00:00:00,[],https://scontent.fcai19-7.fna.fbcdn.net/v/t39.30808-6/350661274_554945880126370_3727428161448330964_n.jpg?stp=dst-jpg_p526x296&_nc_cat=104&ccb=1-7&_nc_sid=9267fe&_nc_ohc=_A6D-pR6dFYAX8Hg3Mn&_nc_ht=scontent.fcai19-7.fna&oh=00_AfDO8H3FgPttZr1w9po6CelrBNi0tn5fQiK10-9O48x82g&oe=64E2D759,https://www.facebook.com/NVIDIAAI/photos/a.119492422050369/1188408875158713/?__cft__[0]=AZWZGgsfjwvJJRfBAcdLfS2jC-djdaSdIl1iQIISY4FxTKII1Rv2uCmHJh8KHMVaffJ-ltfVUtAy2sKs1IK29NlOrN-eRHsJUamNpOJve6Ot-V2kI5lwjmEkyVbkoQHQ6E5EH0P9phuhNJaXXMdQCXSm9-aFpyu4oX2EBQ9PhL5WKlqrJUar2xXsAETOF13WkDYt6WELVCAq6Rhffq9RYcre&__tn__=%2CO%2CP-R,815,0,positive,815
pfbid0CnrqtdGo7dFm2TzsfB7XE1K6AUWWLg6g169fmGxj1DDp7M9BwXLQj9AxzzcQ1fdnl,NVIDIA AI,0,26,0,0,0,0,0,0,26,0,"Introducing #NVIDIAMetropolis for Factories, a set of #visionAI workflows that enhance factory automation, adopted by electronics giants like Foxconn, Pegatron, Quanta, and Wistron to advance factory digitalization. #COMPUTEX2023Learn more > https://bit.ly/3IDRBP4",2023-06-01T00:00:00,[],https://scontent.fcai19-7.fna.fbcdn.net/v/t39.30808-6/350509537_1088283502128053_5320309207778295826_n.jpg?stp=dst-jpg_p526x296&_nc_cat=110&ccb=1-7&_nc_sid=9267fe&_nc_ohc=Qfu6ifv9A_AAX9DaHSO&_nc_ht=scontent.fcai19-7.fna&oh=00_AfA5cIkAjcijGfFBXUWDSHQXgQmixoXGE9Ud_smAsgdWoQ&oe=64E2EA25,https://www.facebook.com/NVIDIAAI/posts/pfbid0CnrqtdGo7dFm2TzsfB7XE1K6AUWWLg6g169fmGxj1DDp7M9BwXLQj9AxzzcQ1fdnl?__cft__[0]=AZUYxvPVZuMjqX3HeoqM8e-3H41BONEKZu1jhR_xgyQ91oclwpbGEwgNbkqN_f5IKTMszUbehG_GcSLS8mIGzYT1VGAUIlkq8zKrtlJj580yikCMPf_KT0RidhlNW5Jpl7U-m2B2xhpn2qxOSiyw5So-7VaX2l2whc7fDYP9bIwZ5yQ2PeaCQJVdS1UUBcsW2ZLGtcfCzQuvH0E2rvMwzXP2r8rnQ20t82LRCYhe3AVuFj8Y6jCa3WH6tqBvmlmEQWSxHZDl8QFNbRW7lDM9Vde8&__tn__=%2CO%2CP-R,26,0,positive,26
1188054875194113,NVIDIA AI,0,14,1,0,1,0,0,0,16,1,Our #cybersecurity and #AI in #retail webinar is coming up on June 6. Register now to learn how modern AI solutions can improve your enterprise cybersecurity posture. https://bit.ly/4573dDx,2023-06-01T00:00:00,[],https://scontent.fcai19-7.fna.fbcdn.net/v/t39.30808-6/350783343_1399837764142719_6659658890659636778_n.png?stp=dst-png_p526x296&_nc_cat=108&ccb=1-7&_nc_sid=9267fe&_nc_ohc=1KqJ1bI3b-UAX8iAKl1&_nc_ht=scontent.fcai19-7.fna&oh=00_AfC5_hSlSFw32PuQD2KM8jqoCf-Aew1U--Zrr4mgSJwiVQ&oe=64E32842 https://external.fcai19-7.fna.fbcdn.net/emg1/v/t13/4981618893305824546?url=https%3A%2F%2Fi0.wp.com%2Fthecyberbeat.com%2Fwp-content%2Fuploads%2F2020%2F11%2Fcropped-pexels-photo-417074.jpeg%3Ffit%3D512%252C512&fb_obo=1&utld=wp.com&stp=c0.5000x0.5000f_dst-emg0_p98x98_q75&ccb=13-1&oh=06_AbGH4QYkqZUjFsuezS0l6zKJMSeIW4NwAZjSYOzbZ-xDBw&oe=64E096D8&_nc_sid=dbad39,https://www.facebook.com/NVIDIAAI/photos/a.119492422050369/1188054875194113/?__cft__[0]=AZWTkwp1HzCp4wU0T_c6eikZfFR3N2t2ir7lmQpY_bV1xNZHWfd_4nsCipnEyt9Fqe8FYPMCrycsqE_5ABIdV5P4CdXIf5bAGmZMEWitzLGdcLs1H0ciyA2rXGg53lXswAJXVKXT3Tym6HMeQgEXtFwhi5DE9XlIRRdQOfABP1J6KN5fQ-tjB-TfbeAWjj-3Rzenq7Vf8k8dE0My0sP_gT8E&__tn__=%2CO%2CP-R,16,0,positive,16
1188017818531152,NVIDIA AI,0,12,1,0,1,0,0,0,14,0,"Infosys cortex language neutralization powered by #NVIDIARiva speech and translation enables contact centers provide a scalable, cost-effective, and efficient solution to their customers. Read more. https://nvda.ws/3WJsFez",2023-05-31T00:00:00,[],https://scontent.fcai19-7.fna.fbcdn.net/v/t39.30808-6/350274823_247851727845905_6289703239696171323_n.jpg?stp=dst-jpg_p180x540&_nc_cat=106&ccb=1-7&_nc_sid=9267fe&_nc_ohc=StcMO1OQ7LoAX9pza-0&_nc_ht=scontent.fcai19-7.fna&oh=00_AfAglBOTXF6WTzs41vvVvddWeApJBnZIdaeJ8pD2X-Ld3A&oe=64E34E02,https://www.facebook.com/NVIDIAAI/photos/a.119492422050369/1188017818531152/?__cft__[0]=AZVLY04ncAH9Lm2oCIwn4VLfOXEIyAqI1wlYG30WnzeDfdo-IR4yJXsaQRceonjU5OWZPoXO8CbnfmN8gYYsw83dNErtpahoh8qbiZahgRuDKxVyWdgf9LzuCJ1bAdU8rBmpTU66lbqmfgS15fOR92vxhnhi1k61lzNxXxhnt24NuWipFjesd4D3ICkY72YJcVZKvsOPQd3ZsJwJ4KoHV2Vv&__tn__=%2CO%2CP-R,14,0,positive,14
pfbid02AVWk1wqp9UNtMK7bJvcF4jNSFKqt1j7WnsMEq2bA8bRweEDdrAypaaWLmEFWfZVul,NVIDIA AI,0,11,2,0,1,0,0,0,14,1,Join this Ask Me Anything on June 6th to see how you can integrate NVIDIA RTX™ Path Tracing in your games while maximizing your performance with DLSS.Begin asking your questions today.,2023-05-31T00:00:00,[],https://external.fcai19-7.fna.fbcdn.net/emg1/v/t13/2461305277889945713?url=https%3A%2F%2Fprod2-sprcdn-assets.sprinklr.com%2F50276%2Fc527b670-a8b2-46e5-96bb-c61d7de89a31-13180613%2Fdeveloper-program-social-rtx-p.jpg&fb_obo=1&utld=sprinklr.com&stp=c0.5000x0.5000f_dst-jpg_flffffff_p500x261_q75&ccb=13-1&oh=06_AbG2uM_dSwVH1j08WUPKN4OCW6PxczaLs2wJXdSpVUq-2g&oe=64E00180&_nc_sid=dbad39,https://www.facebook.com/NVIDIAAI/posts/pfbid02AVWk1wqp9UNtMK7bJvcF4jNSFKqt1j7WnsMEq2bA8bRweEDdrAypaaWLmEFWfZVul?__cft__[0]=AZUYRR8AvUmsD_8gwCJX3quAPKBYH5pdkhzgBFLa2JQJgKZTu1Tzk5w7M-2a1Apa8Ibv_NheylXPJvvT8R6I_55FdT7izNy3ygo-hVzb0qIcd4N78X9MRtiHnpWvNdk8LV5ngCR8bnse_IDtU9_fr5ZA7GNanlzc653QjkSKtHQrchcQaErA4oM6Qsd6oDdFRM6KsZphM6PDjyAW6WLb8mR9&__tn__=%2CO%2CP-R,14,0,positive,14
pfbid0gdRTGsGt8YDd2UTDRxwDh1gNce3vh1az8uoXkojXGdjyHnZVJNqaRpoNBt3NHCqrl,NVIDIA AI,0,16,1,0,1,0,0,0,18,3,"AI is revolutionizing scientific computing research. From pharmaceuticals to materials science, the newest subdomain of AI, #generativeAI, is driving progress at an unprecedented rate.Check out this post to learn about the impact of GPT-3 on SARS-CoV-2 evolutionary dynamics and more.  https://nvda.ws/3IMS55A",2023-05-31T00:00:00,[],https://external.fcai19-7.fna.fbcdn.net/emg1/v/t13/17424898329013362837?url=https%3A%2F%2Fdeveloper-blogs.nvidia.com%2Fwp-content%2Fuploads%2F2023%2F05%2Fai-for-a-scientific-revolution.png&fb_obo=1&utld=nvidia.com&stp=c0.5000x0.5000f_dst-jpg_flffffff_p500x261_q75&ccb=13-1&oh=06_AbEBagIz_678GTXtoEwCya9STJ-2ECXVoCW5QPtGfy-Mtw&oe=64E08201&_nc_sid=dbad39,https://www.facebook.com/NVIDIAAI/posts/pfbid0gdRTGsGt8YDd2UTDRxwDh1gNce3vh1az8uoXkojXGdjyHnZVJNqaRpoNBt3NHCqrl?__cft__[0]=AZXWOc7Q9H5ib5Jl-qZ2jQWVtE_tcZx48xTcjAV6xstljRoLuG4ZUuT-Aqp9W3qEPWI0ZhlMS4rfNOlzf4k2ItZwVfA_uQlJeZ1KULAzoJkSl0nkI4gjU3K29XzmDnCGhz5zmEIclW02SokoLQhC9xvicT_zUu4e0dcseH06eYu0XEUDQeRbUeVlHTy3G-ChQBgvHJ82uFJ-2mtpp4yhI-H0&__tn__=%2CO%2CP-R,18,0,positive,18
1187548078578126,NVIDIA AI,0,15,2,0,1,0,0,0,18,0,"Join NVIDIA at this upcoming webinar to learn how #AI is transforming financial services across use cases such as fraud detection, risk prediction models, contact centers, and more. #inference #FSI https://bit.ly/3OIycjI",2023-05-31T00:00:00,[],https://scontent.fcai19-7.fna.fbcdn.net/v/t39.30808-6/350116969_131605143265150_3588473696023990322_n.png?stp=dst-png_s960x960&_nc_cat=103&ccb=1-7&_nc_sid=9267fe&_nc_ohc=9GBoltjuWCoAX8_rUfZ&_nc_ht=scontent.fcai19-7.fna&oh=00_AfCRFJiHWpSmeqDQ5IQdradw4bclr_8FN5xAbfHlHZ4ujg&oe=64E38870,https://www.facebook.com/NVIDIAAI/photos/a.119492422050369/1187548078578126/?__cft__[0]=AZVd_nLGFWwv33Z0vdBxJGzEjYDzBR0jtRyxFiKjEIFNABRT-Ua3XWauh15Z6iDoGn9aCERg2Bx5g9rgOjPafjKjQHXBzpUgZtej-XOtQPrR3v_-XiXT1sWQdYRZYZsWk-scAOgXNIFNPsUKtIF4seh62e09XasDXJlyIdKnk-c-bsw3ZfwWw95Q1h9oWgjshmoWDjh-UxKG7jCdhu1MA983&__tn__=%2CO%2CP-R,18,0,positive,18
pfbid03788pi9iqrvSNx1bsYDVMdFBNKuVidYDNa8vyvAxq66fy4jTWovwbR9djyTgegc5Yl,NVIDIA AI,1,48,0,0,3,0,0,0,51,1,NVIDIA CEO Jensen Huang will join Supermicro CEO Charles Liang at #COMPUTEX2023 to discuss the future of #AI infrastructure. Learn more.https://nvda.ws/3MKvQ14,2023-05-30T00:00:00,[],https://scontent.fcai19-7.fna.fbcdn.net/v/t39.30808-6/350304357_576454874598078_153643434179442714_n.png?stp=dst-png_p180x540&_nc_cat=107&ccb=1-7&_nc_sid=9267fe&_nc_ohc=UlafS_7NXkQAX-E67jA&_nc_ht=scontent.fcai19-7.fna&oh=00_AfArGolYYw4F2EnD-VjFUYiNxNnf3bgcEPz0KGmJBSf2Ug&oe=64E417BA,https://www.facebook.com/NVIDIAAI/posts/pfbid03788pi9iqrvSNx1bsYDVMdFBNKuVidYDNa8vyvAxq66fy4jTWovwbR9djyTgegc5Yl?__cft__[0]=AZWXRSppAu0TqEQWrfrhmrTUPIoA3ubHQCjBIP7q4CNMzAjdT9TrsYL8hUsFgENC-8js__5DpKJTprNZooer9tqYYm5ziM0bGL9emYzP66rjw8IupPEPcldPaypYbevuOFWjottm6uy5kHAkc5KmvPAEUjg702QFYQkyVeCUh8Rg7uoWmgLsD7XG9a85yu0U_KlVvfs_k8AUAT9F_4JuBQZwrH9tNRunvFI_XMBd08hbacqx1Fosimz28m02uoAYQ1J6SoEQde3aiIxb4Wm2bRtI&__tn__=%2CO%2CP-R,52,0,positive,52
1187490861917181,NVIDIA AI,0,18,1,0,1,0,0,0,20,2,"NVIDIA is powering #GenerativeAI through pre-trained foundation models with optimized inference engines – take a closer look into these NVIDIA inferencing platforms offering a full stack solution, including inferencing software, accelerated computing & networking optimized for rapidly emerging generative AI applications.  Don’t miss this #HPE Aspire session on Tuesday, June 20th at 9am PT. Register Now.https://nvda.ws/3WIlZh2",2023-05-30T00:00:00,[],https://scontent.fcai19-7.fna.fbcdn.net/v/t39.30808-6/350121895_603476505089395_2787972388546498918_n.png?stp=dst-png_p526x296&_nc_cat=104&ccb=1-7&_nc_sid=9267fe&_nc_ohc=8vaU_rtHZ0sAX80I_t-&_nc_ht=scontent.fcai19-7.fna&oh=00_AfAIilksU2hDF6dp2De7xzPBYNadtF_XxCnSp4tjJu2lVg&oe=64E39440,https://www.facebook.com/NVIDIAAI/photos/a.119492422050369/1187490861917181/?__cft__[0]=AZVjTL_0lWA6XKJoBy4_uu6MKKDPzXMb_wk0Lj-4Q4Q2VJuXNWb6B867mgB2Iy6kGQjtkOhoSD2sfc43uGjAZL6YdQ-uJBxWrPBk0X2vW4btCuDcolPWzFthHpHVFK2jD19DawQCmLKkFwEAkKmiJxlSr9YZr43As3AIzj7AKrH_4sjlnYmv8UHCyDHCOxP-6DvZuR4Af5h_DQbb8aOU7LMA&__tn__=%2CO%2CP-R,20,0,positive,20
pfbid02Y5Vq46V38q1vtNFfHKHPnbZkJkLKQrTjW8uastWZbidTbH668vFbBsycecqKRgUjl,NVIDIA AI,0,21,0,0,0,0,0,0,21,0,"Elevate your team's skills with NVIDIA Training. Customize plans to bridge skill gaps, accelerate development, & maximize the benefits of NVIDIA tech. https://bit.ly/3ouKly8 #NVIDIA #Training",2023-05-30T00:00:00,[],https://external.fcai19-7.fna.fbcdn.net/emg1/v/t13/12418226441088780038?url=https%3A%2F%2Fprod2-sprcdn-assets.sprinklr.com%2F50276%2F9d2b8fa3-a4dc-4868-a493-f274750e0d3b-201492638%2Fresized-preview.jpg&fb_obo=1&utld=sprinklr.com&stp=c0.5000x0.5000f_dst-jpg_flffffff_p500x261_q75&ccb=13-1&oh=06_AbGNv1LG5YURbrGtLPJsCRGwK2Ufz4Cj5TEU-fc2Lz1rmA&oe=64E06E02&_nc_sid=dbad39,https://www.facebook.com/NVIDIAAI/posts/pfbid02Y5Vq46V38q1vtNFfHKHPnbZkJkLKQrTjW8uastWZbidTbH668vFbBsycecqKRgUjl?__cft__[0]=AZWZUsfTxVr3Z3U8W1iTlaA5AlNrSl35JXcoGuKMdQVU49TQYyjkHtEj0xVe8wKr95gue27CyVedx4TLYt2coYdIfaZbJe7xnezbnU3iqIb1Yfs5LaGcmb9-_nIC7m5p41h3d3gINH-3dBzHOkDH7CMI-0TvE6-evdH4nYacB_gddghC9Wmsi297JLfP_ejZ52gB6QXM87-Az-pLJ2pBnBte&__tn__=%2CO%2CP-R,21,0,positive,21
1187450295254571,NVIDIA AI,0,13,0,0,1,0,0,0,14,0,"Last chance to register for our webinar! Hear learnings and best practices from @Infosys, @Quantiphi, @Talkmap and NVIDIA on how to enhance customer experiences in your contact center with #conversationalAI applications such as intelligent virtual assistants, digital #avatars, and agent assists.https://nvda.ws/3AvzJBm",2023-05-30T00:00:00,[],https://scontent.fcai19-7.fna.fbcdn.net/v/t39.30808-6/350272484_1906943943016581_4684489582557421127_n.png?stp=dst-png_s960x960&_nc_cat=101&ccb=1-7&_nc_sid=9267fe&_nc_ohc=T9VSwbOz7hMAX_-E3cS&_nc_ht=scontent.fcai19-7.fna&oh=00_AfBeWn_OhCGNZRB7vPG1kfizeV7FgZ10EbOHHnJcn56sbw&oe=64E3AAFC,https://www.facebook.com/NVIDIAAI/photos/a.119492422050369/1187450295254571/?__cft__[0]=AZVX4hlk4WekbRuIKZUASBeTGUN7Av3Q4Kx1_rPS8fl73mxLZ-MWoC3lNgzcxe6uwMo3APesu4gAF-rhEZnU6CI1NjQI0HSOg1REktsMiikmWPbPY37X9n1mUrc7Oq0Oo_u7qWA3F2ZWfOwyX7nOr8CUIPgOK8OlJRDKYqjedZnvPi0SseMxLARfrA8b7RAxp4qULBfjX_4MS-PCmwsba6aX&__tn__=%2CO%2CP-R,14,0,positive,14
1187424605257140,NVIDIA AI,3,18,0,0,1,0,0,0,19,1,Learn to harness what’s next for developers at Microsoft Build. Listen to experts from NVIDIA and Microsoft in insightful on-demand sessions. #MSBuild #NVIDIAonAzureWatch now: https://nvda.ws/3Mptqop,2023-05-30T00:00:00,[],https://scontent.fcai19-7.fna.fbcdn.net/v/t39.30808-6/350512571_214991848004479_4256643973817054776_n.jpg?stp=dst-jpg_p180x540&_nc_cat=104&ccb=1-7&_nc_sid=9267fe&_nc_ohc=TIky9_lZ00cAX9UJNli&_nc_ht=scontent.fcai19-7.fna&oh=00_AfCB5hV_kKm0evWy1uNQVGvXgrntdyIcqoCmJm9bU-lbBw&oe=64E44DAA,https://www.facebook.com/NVIDIAAI/photos/a.119492422050369/1187424605257140/?__cft__[0]=AZUTwe8jDl-5tx9DogmgUu9T5t1gsFLuTE2IzBDFwrKicF8IuvLgvoZ2PdDS8QJsi626m1u-gMPjMJH7goZoQ6lQE7J-hvoMhVplO16ZZqIiqnBZeuRNcHhaAEifE_yi-AtU39wjjfzZH70J_sNaz4yRzfsoFVWzFp3RijzFLkrFj5dlPcAAImx2VjKFsllDbwERIftnj6GB7kxEkDGDWLMu&__tn__=%2CO%2CP-R,22,0,positive,22
1186490332017234,NVIDIA AI,0,17,0,0,1,0,0,0,18,3,"CPFD Software enables #sustainability tech developers to predict fluid, particulate-solid, thermal, and chemically reacting behaviors up to 1,500x faster using CFD simulations accelerated by NVIDIA. Read the solution brief: https://nvda.ws/3IJue6v",2023-05-28T00:00:00,[],https://scontent.fcai19-7.fna.fbcdn.net/v/t39.30808-6/350337521_174624638606432_2351449693922846820_n.png?_nc_cat=103&ccb=1-7&_nc_sid=9267fe&_nc_ohc=kusNJjHVhTQAX8Ym0fT&_nc_ht=scontent.fcai19-7.fna&oh=00_AfBqJGmcLED7N0wJyz66Su302I11b9GPWdujB2HYFpV3tg&oe=64E3730F,https://www.facebook.com/NVIDIAAI/photos/a.119492422050369/1186490332017234/?__cft__[0]=AZVzsfuoT3MmBZhQhWOsRclna8ZwQZAwq3oxveAR6eLyNG29L9J6Y50_VBVPTrZBrS-s8qmShvWR2C0-UiTXIkAKWPOKlsg14xvQPjPTZ7Y6WyvL4MpeWgGACSV4WqK678vwhcO2RG3nzlzdpN3zVxuUOOLRuEdlEXRHz9vBMRU0FkTFW17F_mBAUlJ-X9x64hYXATkQqo-HPhSzgs31EuN_&__tn__=%2CO%2CP-R,18,0,positive,18
pfbid09rAV8cyxEZnUvj2krJCF9LWjKZN3tLgdPy9HDwFyAFPw69xqm6ULgeLRotBpKGpdl,NVIDIA AI,0,17,0,0,1,0,0,0,18,1,"Recommender systems—powered by Amazon Web Services #AI and ML and NVIDIA accelerated computing—are enabling next best actions, personalized recommendations, and 360-degree customer views for fintechs and financial services firms. Read the TechCrunch article: https://nvda.ws/3WpZuNI",2023-05-27T00:00:00,[],https://external.fcai19-7.fna.fbcdn.net/emg1/v/t13/11393803297729522497?url=https%3A%2F%2Ftechcrunch.com%2Fwp-content%2Fuploads%2F2023%2F05%2Fnvidia-art-4-HERO.jpg%3Fresize%3D1200%2C800&fb_obo=1&utld=techcrunch.com&stp=c0.5000x0.5000f_dst-jpg_flffffff_p500x261_q75&ccb=13-1&oh=06_AbG7CQP9FqpE3Xv4DmUIO7lpWrn7KmqAhJKPg3B3MGVsCA&oe=64E04575&_nc_sid=dbad39,https://www.facebook.com/NVIDIAAI/posts/pfbid09rAV8cyxEZnUvj2krJCF9LWjKZN3tLgdPy9HDwFyAFPw69xqm6ULgeLRotBpKGpdl?__cft__[0]=AZVEaHfYPu_9kvVH_yMxgD67gQgOV_XcHKHpNYQYJQ0BpGTcPGsuCQzZWHOWNbudZmzmB7KLOEAOja4HNmLVWNkbwmRD3eUk5AAFv9IZo0azi0Qdg8eIaGrtetvTbshhqrcF_ivhrq5DoEkp9fL0sil_vru68_trJZtyw7QHfoOl51-ORS6s3ssF6jnAfs63FtUuHEwzyZmSXNaIEEGnKlie&__tn__=%2CO%2CP-R,18,0,positive,18
1185508145448786,NVIDIA AI,0,15,1,0,1,0,0,0,17,1," NVIDIA & Domino Data Lab are going ALL IN with the latest in AI innovations at Rev 4! We've just announced the final lineup for this groundbreaking event that convenes the greatest minds in AI and data science, and it features an impressive lineup of keynote speakers including Neil deGrasse Tyson, Cassie Kozyrkov, and many more. Use code NVIDIA50 for half off registration. https://nvda.ws/3OKxJgT #Rev4",2023-05-27T00:00:00,[],https://scontent.fcai19-7.fna.fbcdn.net/v/t39.30808-6/349773407_798256691807276_7428078269540528112_n.jpg?stp=dst-jpg_p526x296&_nc_cat=106&ccb=1-7&_nc_sid=9267fe&_nc_ohc=eAFUEVdlBukAX8kPAfH&_nc_ht=scontent.fcai19-7.fna&oh=00_AfAnlHTQ84e4I0sUd07v9P9zgLnNiyoj8uz8EGMe5PGAdA&oe=64E3C05C,https://www.facebook.com/NVIDIAAI/photos/a.119492422050369/1185508145448786/?__cft__[0]=AZUhD__0xVRN_8vMl0gJHGtJOzbL3RkZsPWsFqIbtMT5_iw9DptyZgUGNhIkBvXCIL2Xg3_DG4sad6Yc3poZqdvF6Kzg8qN_KhuyG-mIxPoDetWjewkJ3HDZQkG-8x7fiuX4ZzhSX_fT-8XHgVT5F5Ji08DHR6NzR-lUDAzn3iZhGg6fuWewQuu9_6pJyj6dIKhVRZ0lTQaaWi9M3PTph7TC&__tn__=%2CO%2CP-R,17,0,positive,17
1185470928785841,NVIDIA AI,0,9,0,0,1,0,0,0,10,0,"Cleo offers an interactive experience with personalized insights, financial management tools, and advice to users by building an #AI-powered personal finance assistant on Amazon Web Services and NVIDIA. Learn more in the demo at #Money2020EU: https://nvda.ws/3MzXpKG",2023-05-26T00:00:00,[],https://scontent.fcai19-7.fna.fbcdn.net/v/t39.30808-6/349195902_1464738351007520_1642228038821534844_n.jpg?stp=dst-jpg_p526x296&_nc_cat=106&ccb=1-7&_nc_sid=9267fe&_nc_ohc=Zw4y5rusX08AX-oiFWU&_nc_ht=scontent.fcai19-7.fna&oh=00_AfDefC8gFjVKE6ODSQSWJJUQSduvy8Edfk25U7Mar7C_jQ&oe=64E3931D,https://www.facebook.com/NVIDIAAI/photos/a.119492422050369/1185470928785841/?__cft__[0]=AZXGKfyqO1RMmjd7vA6rHlRFiI3WPAYCKf0k30hxjdrEKS96Xhd2qc3AUyRLX0-ew0HEfGzaqCaB8-LWik1Zm6lGl7JC1pfaMgkwK82AoJDpNgmlcNP4FPyAvLPoTgiNhdG-0Fg5f1u8hpDV4B-qpD2ZoFjW65RQcLHj-kwy1DWSLrDXEz2ltwdVVTn6lEuPS6pBWa01_by3E_-4SnT8Z6ja&__tn__=%2CO%2CP-R,10,0,positive,10
1185413812124886,NVIDIA AI,0,18,2,0,0,0,0,0,20,1,Discover the game-changing combination of NVIDIA GPUs with MosaicML’s platform powered by OCI. https://nvda.ws/423Y64B,2023-05-26T00:00:00,[],https://scontent.fcai19-7.fna.fbcdn.net/v/t39.30808-6/349131337_960362848609819_1709342128833474873_n.jpg?stp=dst-jpg_p843x403&_nc_cat=108&ccb=1-7&_nc_sid=9267fe&_nc_ohc=0UOOWItKXGQAX_Q4dhO&_nc_ht=scontent.fcai19-7.fna&oh=00_AfCtzsnZyvp_1wN0dGk8XNg2P1QHi2OGwcMuKTxDb7pwsw&oe=64E30F22,https://www.facebook.com/NVIDIAAI/photos/a.119492422050369/1185413812124886/?__cft__[0]=AZVUSSujmBcDDmMHKhd1LZ5-XCYI2170zJdyZ7cpwkTSkl9Q-wK8qAKKHRduoONsUFejtcD784ca7tAuETOTjSUBkl5q17HWFIteD84S0LUtp4nT0jl1HS1bwZrEupOMbCtSkYwTxIgYu3MInur9u0Ii3Ma9CQZSnBi29K1YxNsHc4jSdhu4pOp2T7HZgRW7xI82e8UBslYJuB6IrZ9VfmC2&__tn__=%2CO%2CP-R,20,0,positive,20
pfbid0y8sGKf339bMJXgZpUFF2z7RP7Hkt2iJM6p4seoMGqjc1LydUo892mBQLqioheDL9l,NVIDIA AI,0,20,0,0,0,0,0,0,20,4,"Join Stephen Jones, CUDA architect, for a step-by-step walkthrough on how to exactly approach writing a GPU program in CUDA: how to begin, what to think about, what to avoid, and what to watch out for. Watch on-demand now: https://nvda.ws/3OfzMt2 #GTC23",2023-05-25T00:00:00,[],https://external.fcai19-7.fna.fbcdn.net/emg1/v/t13/4511109410703339165?url=https%3A%2F%2Fprod2-sprcdn-assets.sprinklr.com%2F50276%2Fa3fbf53b-2933-490a-b206-d0a33af495e6-122435980%2FCopy_of_gtc23-spring-session-s.png&fb_obo=1&utld=sprinklr.com&stp=c0.5000x0.5000f_dst-jpg_flffffff_p500x261_q75&ccb=13-1&oh=06_AbH1cVPqq5eQ639020IXSZK83FhRy7sjTy9s03LngR2WMA&oe=64E065D3&_nc_sid=dbad39,https://www.facebook.com/NVIDIAAI/posts/pfbid0y8sGKf339bMJXgZpUFF2z7RP7Hkt2iJM6p4seoMGqjc1LydUo892mBQLqioheDL9l?__cft__[0]=AZUzk2lpDx8UmPES3uSME9v2egFngFWXztmX31Z-4DMgTU3se533JKnWyErCUYSrv4Dn_idBRGft_CrNjd6TaxTJaZOm77OekNRujdQ0HhSxypUDNEbQJXBgyn7pwRd95VAJZXoF1wvW3YF3nFYPtE2pG0OxWgfnYIKsPa_XLgTnxk_3FLqhwB7ZQ9GBIXfUFVwwg_wD85raWeghWQDlWmTm&__tn__=%2CO%2CP-R,20,0,positive,20
1184999345499666,NVIDIA AI,0,11,1,0,2,0,0,0,14,3,Clarity AI helps investors and consumers make more informed ESG decisions using #AI and ML—powered by Amazon Web Services and NVIDIA—to offer a comprehensive #sustainability and impact analysis platform.Explore the demo at #Money2020EU: https://nvda.ws/420lIH5,2023-05-25T00:00:00,[],https://scontent.fcai19-7.fna.fbcdn.net/v/t39.30808-6/349001733_951891212795691_4326002495684287158_n.png?stp=dst-png_p526x296&_nc_cat=105&ccb=1-7&_nc_sid=9267fe&_nc_ohc=YNMmu290ToEAX_as1Go&_nc_ht=scontent.fcai19-7.fna&oh=00_AfAUl9KAPuum1M-_nCS8_eJprIwC3Q7jw_sefVhyFIRsyQ&oe=64E44591,https://www.facebook.com/NVIDIAAI/photos/a.119492422050369/1184999345499666/?__cft__[0]=AZWDsp9KHbIpCKwIryHxunM4hFMam5_pZMCY2NFJB9NJ0spxjdZs1M3UsKcgccYgt2ao6qVeNsSXiRRs_NYL-joLi8OXU_ekCRAjYNUXokHnhqu70OJ2nqZB4Jb0wV0GBDw8bIH7dwHJ-JtXpnumt7S35QF1tQCXs6WZ10VZ4WMkiGgreAf1BCOj0Mt14hwPnYjF2soLB0wwSXiCUPWOOGnk&__tn__=%2CO%2CP-R,14,0,positive,14
pfbid02fGF5qUZ1nzsj3U3KfZQ4qehLYVeedxRSx45xA3hFvsMRzACKn5Y5y77Y2xr51mpUl,NVIDIA AI,3,29,0,2,0,0,0,0,31,1,NVIDIA H100 Tensor Core GPUs just dropped on Lambda Cloud. 1x H100 80GB PCIe instances are LIVE for only $2.40/hr. Spin up an instance while they last: https://bit.ly/44Iskwx,2023-05-25T00:00:00,[],https://scontent.fcai19-7.fna.fbcdn.net/v/t39.30808-6/346307966_812164230339998_298424439205828676_n.jpg?stp=dst-jpg_p526x296&_nc_cat=107&ccb=1-7&_nc_sid=730e14&_nc_ohc=S1Z_GSR9rE0AX-jnAuy&_nc_ht=scontent.fcai19-7.fna&oh=00_AfDP_nACmxpRAhBxkT7bqccxDKTfDySZH93Dnjy9UFTRyQ&oe=64E3A62F,https://www.facebook.com/NVIDIAAI/posts/pfbid02fGF5qUZ1nzsj3U3KfZQ4qehLYVeedxRSx45xA3hFvsMRzACKn5Y5y77Y2xr51mpUl?__cft__[0]=AZWACwnupZjyln7EeO7eoFiwZ9cfRJGpzeHRhi7LYO39qg7IsLLRLroJmXsYgOSWxpGn-XzvTBr9Iy4CG8sTYTvy79Nq9_MKPUBlOqACHJDcuSTkgtYwQ-h9UtRK06ofxi5l6TReKX1QEI5aRafJWMGsexXNn_-rgcUsE4lRxCyLxwI3k9vDOkb1f6LR20iwTWwPBeIrUUB-Q9nwB1PBfOlJo7xQsSJ7hlA1RrWQ4Ih7sr-NfNgcdXbiBnmMkpz5lOc&__tn__=%2CO%2CP-R,34,0,positive,34
pfbid0iEoA8uw63npwMnFWpTwn2e4VjbvSdNGKQ1PSY6byMp1u6yFoxUAq7ApqxSg8TkS3l,NVIDIA AI,0,11,0,0,1,0,0,0,12,1,Learn how artists using #AI are pushing creativity to new levels to discover new forms of expression with #generativeAI. Watch #GTC23 on demand: https://bit.ly/3AfVLrH #NVIDIAInception #startups,2023-05-24T00:00:00,[],https://external.fcai19-7.fna.fbcdn.net/emg1/v/t13/4936584447287677983?url=https%3A%2F%2Fprod2-sprcdn-assets.sprinklr.com%2F50276%2Fd98c8d95-968c-4390-bd14-81685218b049-1901071610%2F2765329-gtc23-spring-web-best-.png&fb_obo=1&utld=sprinklr.com&stp=c0.5000x0.5000f_dst-jpg_flffffff_p500x261_q75&ccb=13-1&oh=06_AbEk_haS-CiN4bknE5geOLhLlemwAGeEFes1HB0eeGGNyg&oe=64E026D1&_nc_sid=dbad39,https://www.facebook.com/NVIDIAAI/posts/pfbid0iEoA8uw63npwMnFWpTwn2e4VjbvSdNGKQ1PSY6byMp1u6yFoxUAq7ApqxSg8TkS3l?__cft__[0]=AZWx8irmAPs5Dkn63ThoM1mfF-RQpqIjJiKDmkrhMegnU6YsT1_2J3-Y5lDjhLNW5NBIiHmALN530bpP5P_dHtTBsqiT0Zeivq8DctwFGKrX6aKMNxW6jU7R7zXL6nZcIp6Td6fZcLTa-nrnxgttF01FURsFbZr2BF7a0ZRALBcwAF1LvrNQlmMT-aKolrzUltO5vPEXsaX4e1ysHp8ybqUs&__tn__=%2CO%2CP-R,12,0,positive,12
1184539855545615,NVIDIA AI,0,7,1,0,1,0,0,0,9,1,"Join @infosys, NVIDIA, and @quantiphi for this live technical webinar where we will demo how you can empower your contact center agents to deliver the best possible personalized customer experience.https://nvda.ws/3HfNVlC #speechAI #telecom",2023-05-24T00:00:00,[],https://scontent.fcai19-7.fna.fbcdn.net/v/t39.30808-6/349192288_3355802971339134_6840591898861606712_n.png?stp=dst-png_p526x296&_nc_cat=103&ccb=1-7&_nc_sid=9267fe&_nc_ohc=Ef_ONjDF4TIAX-Cbf5p&_nc_ht=scontent.fcai19-7.fna&oh=00_AfAL3-ITBm1G49BPtqXZ1WZtKlTylhtbHJ1YAW8RcP2i0Q&oe=64E335C0,https://www.facebook.com/NVIDIAAI/photos/a.119492422050369/1184539855545615/?__cft__[0]=AZXn0Rndqk0cwCcvwOLxvD4-xjRqv4o15lAd3fKHOxi2oheCZHf4AwuAQwp5t_yooDvUhLGXafcxIvMlPZZsRP_Zjl53qnsA5a9wE7unvkX0bP4Qe26gTe9J1nz-U1Z5Z_bHGHjEV0YeY0PxTnJ88aHIw8D0S8ALGHogqpjfXlEnii_Het1kJ0bIx_QMoqsmY2qITdgbsaeQcUJOCsKEcB1g&__tn__=%2CO%2CP-R,9,0,positive,9
1184502658882668,NVIDIA AI,1,12,2,0,1,0,0,0,15,1,"#MSBuild is happening now. Explore NVIDIA's sessions, free developer resources, demos, and the latest AI news. #NVIDIAonAzureCheck it out: https://nvda.ws/3WqDEtm",2023-05-24T00:00:00,[],https://scontent.fcai19-7.fna.fbcdn.net/v/t39.30808-6/348629467_639324071013105_478668857668853903_n.jpg?stp=dst-jpg_p180x540&_nc_cat=110&ccb=1-7&_nc_sid=9267fe&_nc_ohc=GCvwvajazQwAX-6rvJw&_nc_ht=scontent.fcai19-7.fna&oh=00_AfA5dSXZZWNGuq_RpRwe71vcK-F90GA7lcOQjWGJsbsm5g&oe=64E4376F,https://www.facebook.com/NVIDIAAI/photos/a.119492422050369/1184502658882668/?__cft__[0]=AZV2AeRvq6a7JYUtc2Xuv97XOWcPOF3LLq5xIGHS-zdgeA64Fz8LR0s9g-iOepP1hkgfDEHcriF3YSEfgo5adt8SP0PVcHJZwJ_IjqVFMPtgePz7OG3-KdRpcWaSFhK3NmlN98pLxb98rFSVXKSjPc2Lz4m4_7WWG46NI9up_YGnfTto1-dLyKtUpBCDu7dMf-lvTODvEXrXrYQX1HJ1EVa2&__tn__=%2CO%2CP-R,16,0,positive,16
1184421752224092,NVIDIA AI,0,10,0,0,1,0,0,0,11,1,Learn about how modern #AI solutions can better address #cybersecurity threats for #retailers. Join our webinar on June 6. Register now: https://bit.ly/433FTEW,2023-05-24T00:00:00,[],https://scontent.fcai19-7.fna.fbcdn.net/v/t39.30808-6/348844603_790235256109071_8757146383030127975_n.png?stp=dst-png_p526x296&_nc_cat=109&ccb=1-7&_nc_sid=9267fe&_nc_ohc=IsGatvQq6dYAX_MeuCx&_nc_ht=scontent.fcai19-7.fna&oh=00_AfBjvZG3J1sa5V5_I1K0nA7g_suZ53ioq58zX0B0he9HHA&oe=64E4122A,https://www.facebook.com/NVIDIAAI/photos/a.119492422050369/1184421752224092/?__cft__[0]=AZUNQMTQqDe-oSJIp7_dtLtWRWX0oABZVxQLUvSrbsWqnuBAEUEDA1vaNGRSecW0x8tsM2hecQ3wolPcTIKc1SSK4dRyu7qI7NnCYKQMUzbHX-55Idc2UoAIyB0AFcBsfcEM8wxvTZK3JX_5p8DUfwo0hk-MJAJsM9v_WoasawbK-qKLoqRDrlDydNwBuWdt5AOtUYoxgPzMObONsGs1d6Tu&__tn__=%2CO%2CP-R,11,0,positive,11
1184054132260854,NVIDIA AI,0,8,0,0,1,0,0,0,9,0,"Announcing Project Helix, the blueprint for on-premises generative AI from NVIDIA and @DellTech. Learn more. https://nvda.ws/42WaLb5",2023-05-23T00:00:00,[],https://scontent.fcai19-7.fna.fbcdn.net/v/t39.30808-6/348553964_290425850005605_8322459899823396635_n.png?stp=dst-png_p180x540&_nc_cat=104&ccb=1-7&_nc_sid=9267fe&_nc_ohc=wIMug-pVbUYAX9wVUeY&_nc_ht=scontent.fcai19-7.fna&oh=00_AfA7qG_tyKtlxaRo4oxzGp7L842JBTNsGW7urPJdWXQsrA&oe=64E48DF5,https://www.facebook.com/NVIDIAAI/photos/a.119492422050369/1184054132260854/?__cft__[0]=AZWfTtUc5cQYK2MBvOv3pedda1Xu2xQ8p29JIvR1QyzHkxDTQhkPdEKrkGu2g1T6lPfz7IEZ51Ax1v0rkLFzBdlEmlIYYgTUOWZopEheS476TwwR-mgmhc9gTL-KeCxSldMHWVtwrgaIIZhQv1EPrPq5BGE3rt5aRBDrgYDFbkFvrPMoS6UfAWBEnLFD0AwUy6VbzWRM2K55bqQ_rQvTOwAM&__tn__=%2CO%2CP-R,9,0,positive,9
1184037872262480,NVIDIA AI,0,10,1,0,1,0,0,0,12,0,"Don't miss out. NVIDIA + Microsoft session today @11:30am PT will cover NVIDIA AI Enterprise integration with Azure ML service, the first enterprise-ready software platform for developers to easily train & deploy custom, secure #LLMs. #MSBuild #NVIDIAonAzure Sign up for free & watch here >  https://nvda.ws/439JJN0",2023-05-23T00:00:00,[],https://scontent.fcai19-7.fna.fbcdn.net/v/t39.30808-6/348813111_185784627384164_4017889262531351912_n.jpg?stp=dst-jpg_p180x540&_nc_cat=105&ccb=1-7&_nc_sid=9267fe&_nc_ohc=kEBccrgWMtgAX-xifbf&_nc_ht=scontent.fcai19-7.fna&oh=00_AfC_MtXQRWYqEQbKDBs9bASNs3PR1Rzoz44dSm70jzGQJw&oe=64E3DAC4,https://www.facebook.com/NVIDIAAI/photos/a.119492422050369/1184037872262480/?__cft__[0]=AZWphYVor2ZucxcRA_YvJHxQrfXgI5KIbeOHxEFO_kt_KZM7ZUpKmM9MT-V5ifmiUb9JBatB17Tyn9Rbh0JdQdiDux4LVck0MXm-9GqR-lFpuNyillCOg3lz5L2APUvcqSoZRuNxCxYFdWTAZrf5AJ4_1jEdn2cBQV-8qco9LvTmITxkWwpUlC8VhEnZFUdGggDShs7Cqn_U1f8VUcg5ZtbC&__tn__=%2CO%2CP-R,12,0,positive,12
pfbid02B8D2e3S65S8xExALXmC7SUhxyKz3M2Jh55QxMcCJyfAyt9FnCtbMCHFzP7hZHAVcl,NVIDIA AI,4,27,2,0,0,0,0,0,29,1,"We're teaming up with Microsoft to drive innovation for Windows PCs in a new era of generative AI. From graphics driver performance enhancements for WinML to new GPU-accelerated Windows Subsystem for Linux integrations, there's a lot of news.Read more  https://nvda.ws/3OwOqfB",2023-05-23T00:00:00,[],https://external.fcai19-7.fna.fbcdn.net/emg1/v/t13/2730567918074051975?url=https%3A%2F%2Fblogs.nvidia.com%2Fwp-content%2Fuploads%2F2023%2F05%2Fnvidia-microsoft-annoucement-nv-blog-header-preview-1280x680-1.jpg&fb_obo=1&utld=nvidia.com&stp=c0.5000x0.5000f_dst-jpg_flffffff_p500x261_q75&ccb=13-1&oh=06_AbGgRzsE3zx8O0Kj1hGiPZX66GOl8l8nGRj8YFS9Wxa44w&oe=64E04B6E&_nc_sid=dbad39,https://www.facebook.com/NVIDIAAI/posts/pfbid02B8D2e3S65S8xExALXmC7SUhxyKz3M2Jh55QxMcCJyfAyt9FnCtbMCHFzP7hZHAVcl?__cft__[0]=AZUfbGiKI9uwRrYa7wXj5sw_bpc_3onL3XNDz-m115lo51GD7ai9rEeAdfGLZHl_DuJr8HtpQG0GbGLX-TcuIE46rd6yS1Y-oRV3FEOJZ-mXas-ksbinI9DMIsxLCG18qqKSRCMc7DfcEFqLUyCrsU3pMIfoevVvLkyfI5BQj8B0E6aX4A5Qj8aywSc6vQZSmmepGsX4vsszet5XVeSkOGJq&__tn__=%2CO%2CP-R,33,0,positive,33
pfbid02Q4UtWNTmybHoe2LaJtWXafpRPU7LN4jcbghPtyrNqA5WiHzXyaiSmPQdhJ53Pb4pl,NVIDIA AI,0,9,1,0,1,0,0,0,11,4,Stay ahead of the game and learn what's next for developers at #MSBuild. Gain insights from experts from NVIDIA and Microsoft in AI-focused sessions. #NVIDIAonAzure #GenerativeAI Register now. https://nvda.ws/42eLoQF,2023-05-23T00:00:00,['blob:https://www.facebook.com/66698fbd-eba7-4b21-a386-e5085d956db2'],,https://www.facebook.com/NVIDIAAI/posts/pfbid02Q4UtWNTmybHoe2LaJtWXafpRPU7LN4jcbghPtyrNqA5WiHzXyaiSmPQdhJ53Pb4pl?__cft__[0]=AZXpPVyGtD4sC_Xt7HK_G0Ueqn_eAEkQIReZAAunfMoBwKQ_Cw0r9XXSPolGlrBFqpjLQxdFqgW7iK2UAW2dMyitDeMMx3W-FKO8VXqlI8KDdKsZxjTNQWYQsMwahSiBoFWL6MnItvceP6cI-vHPwYYWg2Xc1YonEuJ3KUOeLLhZ9-Av8bffDhArYiUFTYUUQtlSxsM2TvGXrsdoD3RcXs_aHurymVefLnl56kbm-GcXPw&__tn__=%2CO%2CP-R,11,0,positive,11
1183634155636185,NVIDIA AI,1,25,0,0,0,0,0,0,25,2,At #DellTechWorld 2023 see how NVIDIA and Dell Technologies are partnering to deliver enterprise-ready accelerated computing solutions—from #genAI to digital twins. Learn more: https://nvda.ws/41zkaUq,2023-05-22T00:00:00,[],https://scontent.fcai19-7.fna.fbcdn.net/v/t39.30808-6/348703221_2222986637885255_7122033452959243424_n.png?stp=dst-png_p526x296&_nc_cat=110&ccb=1-7&_nc_sid=9267fe&_nc_ohc=9Bg0xdhD-mQAX-6iO1V&_nc_ht=scontent.fcai19-7.fna&oh=00_AfBWgD_FtXLDarprfbhRTS93OMN3Z3Pg2NpAQWvkP5aD-A&oe=64E2FEAC,https://www.facebook.com/NVIDIAAI/photos/a.119492422050369/1183634155636185/?__cft__[0]=AZWw8xraz1f530XUGzOxr21hqF0vkVHFsgodJrTY6Xe-PdpnMKr-EC579JOwp6ri_MZfrhnraqsDxZz_DBk-pkg4W7OIbLojvH-pvLYn2w6u8SKCysOZ7z8U6h57SHg8XsuUyT7YIi10YjEhbbvlsc510-gvmA0fE97CUEZCDBkSX4Ux_glfllZvPeCSkXxhZJF6_dFUC2EoXe13gni1fTa1&__tn__=%2CO%2CP-R,26,0,positive,26
1183616265637974,NVIDIA AI,0,13,0,0,1,0,0,0,14,1,"Learn how previs, virtual production, and visual effects departments are being transformed with Generative #AI. Join speakers from Seyhan Lee for their session on May 24. https://bit.ly/41YEAqP",2023-05-22T00:00:00,[],https://scontent.fcai19-7.fna.fbcdn.net/v/t39.30808-6/348626014_245349064743954_5526525348515343538_n.png?stp=dst-png_p180x540&_nc_cat=111&ccb=1-7&_nc_sid=9267fe&_nc_ohc=zOGOUwyIQAAAX8O_MXS&_nc_ht=scontent.fcai19-7.fna&oh=00_AfA2-GPxopbwdvc4T_OFbaKD06CZkgjvc-9CStyTKiTlbQ&oe=64E349D4,https://www.facebook.com/NVIDIAAI/photos/a.119492422050369/1183616265637974/?__cft__[0]=AZX4CRSci6QV1WnnSJjVKleDCLzQwsPC70i6xYI4fc3NF9X4Bxz7jXD46JB6kpt3W6WO5jBw1NUQWB8Q3jSqpwwtD5K0HEoopyZPqQ9reeyB4bO2wfTecmZOtEmY3cTih0Z_1_LaxLyIoGJlbmrL4fJJx5pxzLSvBPkZJLzusR-4XPW4GXLi7iOHFhUZXtLOxlNDaPLi1OejKxIrNO6aZ_HJ&__tn__=%2CO%2CP-R,14,0,positive,14
pfbid02fTAXYyfaU73Cwibko14a16K4rN8t9AgRDjiYjgCVuXTLWZwFi7bC7achLfhc43L7l,NVIDIA AI,0,8,0,0,1,0,0,0,9,0,Join us tomorrow at 9 am PT to learn how NVIDIA can help retailers run workloads 5x faster with up to 4x cost savings on leading Apache Spark platforms. Register today: https://nvda.ws/3Mvoxu2,2023-05-22T00:00:00,[],https://external.fcai19-7.fna.fbcdn.net/emg1/v/t13/14224587667950062528?url=https%3A%2F%2Fprod2-sprcdn-assets.sprinklr.com%2F50276%2F9ab4dc00-e60f-4484-8376-5b149e4fd6c6-1753317338%2Fretail-social-webinar-apache-s.png&fb_obo=1&utld=sprinklr.com&stp=c0.5000x0.5000f_dst-jpg_flffffff_p500x261_q75&ccb=13-1&oh=06_AbFdpFlPWef6CCRjI4hDI2hKPFnIUpoP8-Rs__5MywFG5w&oe=64E08394&_nc_sid=dbad39,https://www.facebook.com/NVIDIAAI/posts/pfbid02fTAXYyfaU73Cwibko14a16K4rN8t9AgRDjiYjgCVuXTLWZwFi7bC7achLfhc43L7l?__cft__[0]=AZWMOJ6_v1k6n_PkszsNF5MUOCGnG9xZWbqAWGr01aHpPEjCrDiG42kYvAMkgee6INEWUJrYgWafyDq03HNvYvw8BPxMtrr49yUGLIRVCntSbD8dKptj_ahBeDc1kWVsayt45PMlrevJxYKMjSZfGK9Z2V0yM6Mqh8xefMTrYzw9pxMg5L4oqPexAqLKtu1WhrurbWBlWei8CnF-kJebMVvw&__tn__=%2CO%2CP-R,9,0,positive,9
pfbid0oktf8w4X6mCGYcT3cvmEQBqZgyJ2NuP1h3A2R2WMnLwhBU2pfHCD3uEiUwmXNSLpl,NVIDIA AI,0,7,0,0,1,0,0,0,8,1,Join Adel El Hallak at Microsoft Build along with other experts to learn about NVIDIA AI Enterprise and the collaboration with Microsoft to bring NVIDIA's suite of enterprise software to Azure Cloud. Discover how you can accelerate data science pipeline and simplify production AI deployment. #MSBuild #NVIDIAonAzure Register now: https://nvda.ws/43it0XL,2023-05-22T00:00:00,['blob:https://www.facebook.com/5b77d368-7c95-40e5-95fe-f32bed6191a7'],https://scontent.fcai19-7.fna.fbcdn.net/v/t15.5256-10/345093188_563222139301899_3249554685659562214_n.jpg?stp=dst-jpg_p180x540&_nc_cat=100&ccb=1-7&_nc_sid=ad6a45&_nc_ohc=FnSS_nHcNLEAX-wsxtj&_nc_ht=scontent.fcai19-7.fna&oh=00_AfC_8mZhQ6ptnsfnv8CP26yRNdltkOerTTFQiRvLbWO6wQ&oe=64E2F481,https://www.facebook.com/NVIDIAAI/posts/pfbid0oktf8w4X6mCGYcT3cvmEQBqZgyJ2NuP1h3A2R2WMnLwhBU2pfHCD3uEiUwmXNSLpl?__cft__[0]=AZX6PGJhsxC01cjE_7eZv9fit4ayvolozaAGHUB9rrAQEynWuchnVR3lOFluSAnatp0xsboZzkrAR-OG-HDcU9p-oHQ5MwhkdJxlX96V_L6K0bzqNRISzvaOUcLrDf6wd_hH5e4o447UxrV4TMZsHEckC7yWn9lUgQgfejY1J_sT76j0e9VaQ-4eloqWQPRz-RamNsiZfC-22hNjRz_SmydITH7RkZOEzxqptg8jAnYjVg&__tn__=%2CO%2CP-R,8,0,positive,8
pfbid02ScgMY9zqwDgxMygR7eV2xBm2Yd9EzrjHqy7SpAcCf3Tge6KUReaJFk1mx9Pq93KNl,NVIDIA AI,0,5,0,0,1,0,0,0,6,1,"Explore the use of Transformers for synthetic tabular data generation in this NVIDIA on-demand session. Work through end-to-end development covering data pre-processing, model pre-training, fine-tuning, inference, and evaluation. Watch now: https://bit.ly/3Bun0j1 #GTC23",2023-05-22T00:00:00,[],https://external.fcai19-7.fna.fbcdn.net/emg1/v/t13/1197194350178603391?url=https%3A%2F%2Fprod2-sprcdn-assets.sprinklr.com%2F50276%2Fc75f0fbc-642a-4f1b-965c-b2193c0cd419-1147468914%2Fgtc23-spring-social-organic-be.jpg&fb_obo=1&utld=sprinklr.com&stp=c0.5000x0.5000f_dst-jpg_flffffff_p500x261_q75&ccb=13-1&oh=06_AbHrDS3ScoRzdUaCFInDUOrgSDRjcLOU6vXmXz1-K8HcOA&oe=64E09472&_nc_sid=dbad39,https://www.facebook.com/NVIDIAAI/posts/pfbid02ScgMY9zqwDgxMygR7eV2xBm2Yd9EzrjHqy7SpAcCf3Tge6KUReaJFk1mx9Pq93KNl?__cft__[0]=AZWj5Kb57Zl2J8ppsEqIBY3VetqQ4Ct0Efp6lZ7Kta2kE67cfb3-EwDn0lciDgxRqBNUOtHyd8CSY0ZBhrXggscpPDb6cYRioOiMoGPLzyV1MxPrVH2iV8TpI8ToN4VLA0OSVm9dUC1qY6ldVgAwBwIZozYW4UmxYhqNwX-XznXrnTp7n98-Ai1dsF0zyq5kkwnp8X98_KAbehnai_9BOImX&__tn__=%2CO%2CP-R,6,0,positive,6
1183017902364477,NVIDIA AI,0,16,3,0,1,0,0,0,20,1,"NVIDIA is collaborating with Automation Anywhere to bring the power of intelligent automation and #generativeAI to the workforce and empower people to work smarter. To learn more about the latest innovations, register for Automation + AI: Live on June 1: https://nvda.ws/3pWtc0D",2023-05-21T00:00:00,[],https://scontent.fcai19-7.fna.fbcdn.net/v/t39.30808-6/348250992_9637525546265517_2734598669290677669_n.png?stp=dst-png_s960x960&_nc_cat=103&ccb=1-7&_nc_sid=9267fe&_nc_ohc=LFwKLXgGQc0AX_U839o&_nc_ht=scontent.fcai19-7.fna&oh=00_AfA_F8N01YkbVpAlyl8cJAK41EJ_9HK3KqIxYaiBFpJ23A&oe=64E35898,https://www.facebook.com/NVIDIAAI/photos/a.119492422050369/1183017902364477/?__cft__[0]=AZWgLEZ3H0TLdV4X5OrJLmIFJk0J-Dj7uUa80wJptMP7Xy8LzcSgKnUDAePevv90oTT0XEew99G6_FvX8Weh7rtgpNE9El8hhgZNFfMD_jgbcBThfTP0vrOb49tYtLrP0dp3HyP2OlzBXWgrGS8pTNAcgLiNUNs0TpV4ROBBvDUfJ9-IgP0HKPxLOe7JzQyjxbCbuseAsRFioOnFhoeJ8_zT&__tn__=%2CO%2CP-R,20,0,positive,20
pfbid06PSGyMRHjVCDyEFf7Wy7dAWa25JkqpULePQPNTAHLwdHE1ubPZ3ufqDZjLCLnJxul,NVIDIA AI,0,8,1,0,1,0,0,0,10,0,"Missed a #GTC23 Deep Learning Institute training session? View the on-demand sessions with topics covering deep learning, data science, and accelerated computing. Watch now: https://bit.ly/3pH8hhT",2023-05-20T00:00:00,[],https://external.fcai19-7.fna.fbcdn.net/emg1/v/t13/14687074390652022932?url=https%3A%2F%2Fprod2-sprcdn-assets.sprinklr.com%2F50276%2F95222fee-4ce1-4d2a-96aa-10648388cda5-91159729%2Fgtcs23-dli-nvod-training-lab-2.png&fb_obo=1&utld=sprinklr.com&stp=c0.5000x0.5000f_dst-jpg_flffffff_p500x261_q75&ccb=13-1&oh=06_AbG6lT-pQARt25lvpoouSsm902i54ams0UOdvWvyzpBzig&oe=64E09B62&_nc_sid=dbad39,https://www.facebook.com/NVIDIAAI/posts/pfbid06PSGyMRHjVCDyEFf7Wy7dAWa25JkqpULePQPNTAHLwdHE1ubPZ3ufqDZjLCLnJxul?__cft__[0]=AZXgrNR-cYR_Dr5ADNuB630gNiX6McIONrFCFYjY6Q5rFHwOaEaRp-RYUWduNnMdESUUqHJ8_DrtPEvP3R_GXOMh6YnfUEOefAzHAWGo-RUqBitHS6deHCPVZn4hLU-favzUs7Zgpvw5iB_fklxlZXdwKXjYLPZqJD5leXByMIZlKwvwCjz2CaPW-QDx81ePnrHCPNrMpkFpjxlreqW5JyUb&__tn__=%2CO%2CP-R,10,0,positive,10
1182405152425752,NVIDIA AI,0,10,0,0,1,0,0,0,11,1,Ready to explore the power of federated learning in collaborative machine learning? Learn about the combined strength of Azure Machine Learning and NVIDIA FLARE. Check out our MONAI with demo frameworks that unlock the true potential of collaborative AI in today’s data-driven landscape. #MSBuild #NVIDIAonAzureRegister to watch: https://nvda.ws/3pS82AQ,2023-05-20T00:00:00,[],https://scontent.fcai19-7.fna.fbcdn.net/v/t39.30808-6/348424963_196835926607142_1101667657570864972_n.jpg?stp=dst-jpg_p180x540&_nc_cat=106&ccb=1-7&_nc_sid=9267fe&_nc_ohc=9B49FKLLJmEAX_Qj4Kq&_nc_ht=scontent.fcai19-7.fna&oh=00_AfAGlb3RF5KoBQfFtVB_HzyAsPPsMnLGaaiJPUm22ALtvw&oe=64E41AD7,https://www.facebook.com/NVIDIAAI/photos/a.119492422050369/1182405152425752/?__cft__[0]=AZXhJGVHZL5iH-NmRafPsAxRllmy_6pw04nRJ-AVdboYXWmQOmkRKaoVRfpft0viqxWx6APTPbQ_zUAsM7LQyBM2vvrNy-JvYL0g-dCpqrU47sgKaxmQ08ja5JUDNRnoNpoDZxRbyrAT4xO9Gm_lCgI4-ZV09ozdIKl8MwxHjZa2MKp-D9xKi4GJBmtrbt2T14ExHII1QbuhJufyJy6O7Yc0&__tn__=%2CO%2CP-R,11,0,positive,11
1182332099099724,NVIDIA AI,0,19,0,0,1,0,0,0,20,0,"Hear from Bain Capital Ventures and AWS Startups on how #fintechs are using #AI and #machinelearning to deliver faster, cheaper, and hyper-personalized financial services. Join the fireside chat at #Money2020 Europe on June 7 at 3:05 p.m. CET: https://nvda.ws/3IcTT7q",2023-05-20T00:00:00,[],https://scontent.fcai19-7.fna.fbcdn.net/v/t39.30808-6/347249909_253807023868232_2151464367324643007_n.png?stp=dst-png_p526x296&_nc_cat=103&ccb=1-7&_nc_sid=9267fe&_nc_ohc=SCxfKGxouUMAX9sZUDU&_nc_ht=scontent.fcai19-7.fna&oh=00_AfCChxH6ltWULY1s0p-RTom_dCS17LiYvYjCbC4Q9jyrLQ&oe=64E41B2E,https://www.facebook.com/NVIDIAAI/photos/a.119492422050369/1182332099099724/?__cft__[0]=AZXRr4zMYKGKb9-nflKVdZAGe4ifuCBgb8qr4-epkCUkDkL1s22k_g_DndcVh1r_TGHJKlfupy4eo4DZ8Lc3Wu7nsc2MEawlnjh7U-JRxvvqPO45CEAzGkFoadgUkpWQKdlEGYQf5wKFnUO9DwK62_DAEc3KTBlfUvR4tf5Jn6mLla-do3tzXt9wFFjzetm-P8bv2wTxqGnmIpZB3zo35yHD&__tn__=%2CO%2CP-R,20,0,positive,20
1181895359143398,NVIDIA AI,0,7,1,0,1,0,0,0,9,1,"Discover the art of Recommender Systems in the newest episode of the Grandmaster Series. Our KGMON team, placing 2nd and 3rd in a recent Kaggle competition, unpack their winning strategies. Don't miss these insights from the experts: https://nvda.ws/3OmG7TL",2023-05-20T00:00:00,[],https://scontent.fcai19-7.fna.fbcdn.net/v/t39.30808-6/348424587_949666499567422_5615496435450081531_n.png?stp=dst-png_s960x960&_nc_cat=105&ccb=1-7&_nc_sid=9267fe&_nc_ohc=CI20KYdG4L8AX8GtL0X&_nc_ht=scontent.fcai19-7.fna&oh=00_AfC4JHa4dCLCnxT84bGNRNIQFQQ42m2tzgpIp8mjFw8v7A&oe=64E3B9AC,https://www.facebook.com/NVIDIAAI/photos/a.119492422050369/1181895359143398/?__cft__[0]=AZUkMg5zpR5jANKKULvYXkmMZA1kCBxL63w2a7CajF1fZYds6XsZ9mXYz9xVTiXMFWimPzo0OpciOk4Jid9NS5r9c_bW2q8vy9EGaE73CtQO3aCSyiDRvV5wJpKvt-9FwTBuEHJ2u_IxpBx0AVnjOzGovr9RK1NA8k4y9XnRFzZWDQyhYz8Sy9XMKTtig9f2sLpCMfGZwMwxx2veFTk3aRVR&__tn__=%2CO%2CP-R,9,0,positive,9
pfbid02z59GfvbmGtdk9pBDQF6PyucNgi4cNwHHmHeMgztawNJrkDuxHgVXcgcSXkkRgxw9l,NVIDIA AI,0,6,0,0,1,0,0,0,7,1,"Next week, we'll show you how retailers are already using Apache Spark to reduce costs while obtaining results faster. Register for the webinar here: https://nvda.ws/3HDQiii",2023-05-19T00:00:00,[],https://external.fcai19-7.fna.fbcdn.net/emg1/v/t13/15714930316084034555?url=https%3A%2F%2Fprod2-sprcdn-assets.sprinklr.com%2F50276%2F63820f40-3118-4bc3-b5f0-17d45f4bbe89-1753317338%2Fretail-social-webinar-apache-s.png&fb_obo=1&utld=sprinklr.com&stp=c0.5000x0.5000f_dst-jpg_flffffff_p500x261_q75&ccb=13-1&oh=06_AbFJtCPIbf0dOpPlquIY8T1d2S_ityCdroDbkXD9f1GBpA&oe=64E0801C&_nc_sid=dbad39,https://www.facebook.com/NVIDIAAI/posts/pfbid02z59GfvbmGtdk9pBDQF6PyucNgi4cNwHHmHeMgztawNJrkDuxHgVXcgcSXkkRgxw9l?__cft__[0]=AZVFpqlYpaRsqVdPwXiyf4CLPxU5e0bOjwzGbaWkulHTKmBkqSJWBMYjOFq9iUSYUKP3ADXk3xWTR9OexDMdfLYX_Vc9hZdKUB29Tn30hi3vHk7tXBKyoS0rTRjsY9xh91hQanTzo1qyJJ3J60GDhO-9rCT8G6LFto7pZTvzMiIsBK9JZLVd0KcdBW_aLkWnMaUTpkLHPM-8gBrnj3LiEZfy&__tn__=%2CO%2CP-R,7,0,positive,7
pfbid0277GBgWwi2SdzUBvyxdobdJbkJFJvD75xd38rAc2nfuHRnwsD7WihCeSDUfyaMWyvl,NVIDIA AI,0,10,0,0,1,0,0,0,11,1,"In the world of financial #ML, hardware acceleration is key. Our study found that using GPUs significantly speeds up random forest training on limit order book data even over multithreading on the CPU, reducing the time required for ML researchers to develop profitable strategies: https://nvda.ws/3BHEZCz",2023-05-19T00:00:00,[],https://external.fcai19-7.fna.fbcdn.net/emg1/v/t13/829250824677503576?url=https%3A%2F%2Fdeveloper-blogs.nvidia.com%2Fwp-content%2Fuploads%2F2023%2F05%2Fstock-board-with-arrows-1-2048x1152.jpg&fb_obo=1&utld=nvidia.com&stp=c0.5000x0.5000f_dst-jpg_flffffff_p500x261_q75&ccb=13-1&oh=06_AbHhWXYJgRgG5-V5A3OPQVbusE2MgZgaCpxV_IpZHhtzOA&oe=64E08C52&_nc_sid=dbad39,https://www.facebook.com/NVIDIAAI/posts/pfbid0277GBgWwi2SdzUBvyxdobdJbkJFJvD75xd38rAc2nfuHRnwsD7WihCeSDUfyaMWyvl?__cft__[0]=AZWSIatM70Zu4_XDGokxj3UBf4fzTgMGq9BW9X_MkS_qaPoSAO8wZ2HCjZvWAzqB9znoqU-S-xGZDedevHVsgBHN-tMDqubtVHd_nBYIp9XefWSCAzgZ6Zx7L-J5VVoo_P_A1qnKE90atcs3xCeGkJy0mV_sf9hFGxw9E2T2f7V_Ou1Zo-K8qQTYaNZxlKjZ5LQxqhcpWe4hrwnZ_bLBqSq6&__tn__=%2CO%2CP-R,11,0,positive,11
1181805839152350,NVIDIA AI,0,14,2,0,1,0,0,0,17,0,"Discover the potential of next-generation technologies, including generative AI, cybersecurity, industrial digital twins, and more at #DellTechWorld with @DellTech and NVIDIA. https://nvda.ws/42Oajen",2023-05-19T00:00:00,[],https://scontent.fcai19-7.fna.fbcdn.net/v/t39.30808-6/347618315_571741965100136_2716686299443288354_n.png?stp=dst-png_p526x296&_nc_cat=109&ccb=1-7&_nc_sid=9267fe&_nc_ohc=0K4f3dwNL4wAX_iLI6n&_nc_ht=scontent.fcai19-7.fna&oh=00_AfAFJV9IeHOcBX0X6P2MQthx1XC3Fb3u34ayx1ImIB9A3g&oe=64E455EC,https://www.facebook.com/NVIDIAAI/photos/a.119492422050369/1181805839152350/?__cft__[0]=AZU5WR5x3zldIq6H4haeLQBdhJ3UgWtdR_knr2UVO3Ii8EgnbzzwrHNfyk_b3NlruXAD2T35kGIjV7Rme7krXruIfAsoKxZLWjEz7UMn1F8SOO9ViQqJm3HiS0QnqGZM2U__S79lyJFeRgnyJou5JxQACFKmiDrmHWHFduTL1y-XUh4LBsnTG7B-_xzI9bru0fZGOmKSBlz0qJT6ZR8b8r0l&__tn__=%2CO%2CP-R,17,0,positive,17
1181765282489739,NVIDIA AI,0,14,0,0,1,0,0,0,15,0,"Join Seth Juarez, Microsoft, and Dylan Dias, Fractal, as they discuss the next-gen AI services built on NVIDIA AI on Azure cloud. #MSBuild #NVIDIAonAzureRegister for free: https://nvda.ws/3OngEcz",2023-05-19T00:00:00,[],https://scontent.fcai19-7.fna.fbcdn.net/v/t39.30808-6/348422213_195906000038844_3183599560319281520_n.jpg?stp=dst-jpg_p180x540&_nc_cat=109&ccb=1-7&_nc_sid=9267fe&_nc_ohc=TP-Zc2cSzsoAX_Exy9E&_nc_ht=scontent.fcai19-7.fna&oh=00_AfCWN_r57Ii3L8R5OSpctphy1HU-g0LFp86xYoxyo1MZ1w&oe=64E409F4,https://www.facebook.com/NVIDIAAI/photos/a.119492422050369/1181765282489739/?__cft__[0]=AZUtwaMcLIUbWdu-RKKJWsydxH0K6zxh6CMN1B5AlHQEz2EO64LkjN9HQ3LnDQELBQV6eT3dbfcUsoVzoMtTr_BEJEwMHmyME1pwT1MVRIEGG7TpYQQLCNkzvye4425gpqCOkcQbky2aa8HmpAjZcxRPakZ61knDexle85uthBeRYBLR-cYRFvEkiYExfkYSWzE4Vjr2_W2Xv6tXN31DdbdW&__tn__=%2CO%2CP-R,15,0,positive,15
pfbid02VzPDXLUyaH3wGHkw4R4cBtX6zQGZrGWDSSfC9smPKeZDEzqpGVsFVXxZ3A566g7Ml,NVIDIA AI,0,5,0,0,1,0,0,0,6,2,"Streaming live today at 9:15 a.m. Pacific. Watch the presentation by our Senior Director for #AI Research, Anima Anandkumar, on how AI is enabling science for a positive impact on society. President's Council of Advisors on Science and Technology Meeting: https://www.whitehouse.gov/pcast/meetings/2023-meetings/",2023-05-19T00:00:00,[],https://external.fcai19-7.fna.fbcdn.net/emg1/v/t13/8372352745362583054?url=https%3A%2F%2Fwww.whitehouse.gov%2Fwp-content%2Fuploads%2F2021%2F01%2Fwh_social-share.png&fb_obo=1&utld=whitehouse.gov&stp=c0.5000x0.5000f_dst-jpg_flffffff_p500x261_q75&ccb=13-1&oh=06_AbGdmLlJeeWvQJJUZcKxdEwtvh1awUC48cnaUiruhh4Ckg&oe=64E09D57&_nc_sid=dbad39,https://www.facebook.com/NVIDIAAI/posts/pfbid02VzPDXLUyaH3wGHkw4R4cBtX6zQGZrGWDSSfC9smPKeZDEzqpGVsFVXxZ3A566g7Ml?__cft__[0]=AZVGSu9CRvU8zNIak1_ZlVQBFAlPL8icE4HzTL_t5JmFMWzicpOMv-X17PxCQyAw7QEBwDTtsiNoR15yrHKUErxZ45nAdg8ctSYzOP9Ui-JeW3yio2uXTpg6CNgTcNs8-fOQXgfujxn64pr2MxzTQgAouMuDr0nGpOgxnIk0tX1Lbf06M3pFndr9DwAcFAdhdpIe5yBg_oengc8CXZik09zX&__tn__=%2CO%2CP-R,6,0,positive,6
pfbid028oLHSWhKhemfCvMM5jWAVbwovLPLoXb9nWjisVh4J9G6VwUBeES89St1GRXe9nGbl,NVIDIA AI,2,16,0,0,1,0,0,0,17,1,"KDnuggets and NVIDIA have extended their blog-writing contest to 5/22, with the winner receiving an RTX 3080 Ti GPU. Learn more: https://nvda.ws/43oAJDZ",2023-05-19T00:00:00,[],https://external.fcai19-7.fna.fbcdn.net/emg1/v/t13/8289836833176149975?url=https%3A%2F%2Fwww.kdnuggets.com%2Fwp-content%2Fuploads%2Fkdnuggets-nvidia-gpu-contest.jpg&fb_obo=1&utld=kdnuggets.com&stp=c0.5000x0.5000f_dst-jpg_flffffff_p500x261_q75&ccb=13-1&oh=06_AbEx5p_S96lkYSBVnikIHnBDI2DUBgR8Hhk9Bi4Sr9cchg&oe=64E095D8&_nc_sid=dbad39,https://www.facebook.com/NVIDIAAI/posts/pfbid028oLHSWhKhemfCvMM5jWAVbwovLPLoXb9nWjisVh4J9G6VwUBeES89St1GRXe9nGbl?__cft__[0]=AZWXKjBt3ESM7Pt8N-NbxuiULX1kWEe3yqtLsFPyVVAkhJc3ujRxf0bRZh0B4_R9otFvCaeLrEFP54e8vum36Cdwlz6qTz6zYzF5aJa1AquoNwwpOtzcvgnT_qetDotRLxXOjouhTF_IWIb3MmW305uV_1qsvw7VoBVGP6lV9lzBMceYgWbbArtPydgiPm6X_-SwRtsG1vwwR1rH7yhRiQnhKloTMfVJN30R8NwCClqPDg&__tn__=%2CO%2CP-R,19,0,positive,19
pfbid02cfeGPEQuQhZHUFNrBUpJiC9CbVsBdkzDqZGsHnwnwxK4pxq1wbAS42ikEerEhunKl,NVIDIA AI,0,10,0,0,1,0,0,0,11,1,"Explore how to achieve optimal #inference performance with NVIDIA TensorRT, NVIDIA Triton and @AmazonSageMaker: https://aws.amazon.com/.../host-ml-models-on-amazon.../",2023-05-18T00:00:00,[],https://external.fcai19-7.fna.fbcdn.net/emg1/v/t13/14357954649862271721?url=https%3A%2F%2Fd2908q01vomqb2.cloudfront.net%2Ff1f836cb4ea6efb2a0b1b99f41ad8b103eff4b59%2F2023%2F05%2F08%2Fhost-ml-models-triton-tensorrt-1260x630.jpg&fb_obo=1&utld=cloudfront.net&stp=c0.5000x0.5000f_dst-jpg_flffffff_p500x261_q75&ccb=13-1&oh=06_AbHBAqcYO8ZIh4lGIPII-FAwq6sPuRfyv0d7oo2zDZmd-Q&oe=64E02A1F&_nc_sid=dbad39,https://www.facebook.com/NVIDIAAI/posts/pfbid02cfeGPEQuQhZHUFNrBUpJiC9CbVsBdkzDqZGsHnwnwxK4pxq1wbAS42ikEerEhunKl?__cft__[0]=AZXHtlEAq8cAdETNoznFfvwVkfbyXtnmQGNLDo8Jugi-ODlUF9KkKG21JQJ9TMPGVb347j9BXF5TBznE79-0qGEcNUtpdwK0GEnC_3_Lte2Ft74lpWDawePAP887butDmX7Q236NYKSrNwXdqJR1y4CMXNCq7uUWiwhf-hq5UhZsN2WUw7pSj_omOPJyQdPby1rbnwbHCRmoFSpJwgW-54jkMCpdmEW_lF4Nz3NVeQZ18g&__tn__=%2CO%2CP-R,11,0,positive,11
pfbid0WFTPpXY37xwLzyD5iaQxpnk94GLJ3iaR4R3M6p9grcSUycLnDFqyJWNsCjNjHo6gl,NVIDIA AI,0,16,0,0,1,0,0,0,17,2,"Technical walkthrough: Efficiently scale Large Language Model (#LLM) training across a large GPU cluster. Learn how ALPA and Ray together provide a powerful solution to optimize GPU resource allocation, boost performance, and accelerate #deeplearning workflows. https://nvda.ws/3Mug9wb",2023-05-18T00:00:00,[],https://external.fcai19-7.fna.fbcdn.net/emg1/v/t13/6242057021113856809?url=https%3A%2F%2Fdeveloper-blogs.nvidia.com%2Fwp-content%2Fuploads%2F2023%2F05%2Fllm-graphic-2048x1152.png&fb_obo=1&utld=nvidia.com&stp=c0.5000x0.5000f_dst-jpg_flffffff_p500x261_q75&ccb=13-1&oh=06_AbGSC2cc9IWeEL3v_p7U1VaM-VvPZJYRcv6Xcq3CdViiBg&oe=64E07210&_nc_sid=dbad39,https://www.facebook.com/NVIDIAAI/posts/pfbid0WFTPpXY37xwLzyD5iaQxpnk94GLJ3iaR4R3M6p9grcSUycLnDFqyJWNsCjNjHo6gl?__cft__[0]=AZUhxK2AEwXKhdGeQ6fo59afOfe9k-6438oLMNE-7NYlo3SXHI0Bv-3lmquuaEa52-Isvx8zRG_wvvvQZIKkkRCzlUy8sNnalQEWB3GY2brPHH_CHKVue1vv1sLl0tyb3hLgUTTLvjsaoh-tIr3nbzZdfncWW6zsZWZfF3CAkhYRP_MNIj_m_6D5YUqbmXAIaZV17rI87q_BA8LUp7KN-xhN&__tn__=%2CO%2CP-R,17,0,positive,17
1181307499202184,NVIDIA AI,0,13,1,0,1,0,0,0,15,2,"Join Infosys, NVIDIA , and Quantiphi for this live technical webinar where we will demo how you can empower your contact center agents to deliver the best possible personalized customer experience. https://nvda.ws/3M8HG4M #speechAI #telecommunications",2023-05-18T00:00:00,[],https://scontent.fcai19-7.fna.fbcdn.net/v/t39.30808-6/347642627_768846428208888_9107270112680654750_n.png?stp=dst-png_p526x296&_nc_cat=111&ccb=1-7&_nc_sid=9267fe&_nc_ohc=Gq5cCiXy654AX-m-shO&_nc_ht=scontent.fcai19-7.fna&oh=00_AfCXzkST6okVPdrq-bHwSAEskBlHSAD0xeQS23sZpJdWpA&oe=64E2BCA6,https://www.facebook.com/NVIDIAAI/photos/a.119492422050369/1181307499202184/?__cft__[0]=AZXBP9G9X23r0ti6yvOjY0K8BiDkoSQ-1rLPB8qq2AGOfUGWADxUhdg2COFA226qrVPzMRNIxljLxGwRJ_Er3yndqMDIyb1oyKpU0l4eLBTe_BKWvzDk-jPs1qjSHfMMNkDThO9rQ-QFVRB4DcDmhNCcR_52ycqpLuRzHFNaNkgv0jiBEskemnO-HWhOBaFPFUQE1N0Pg1UaozGllatghaGI&__tn__=%2CO%2CP-R,15,0,positive,15
1181288495870751,NVIDIA AI,0,4,0,0,1,0,0,0,5,0,Maximize your AI applications with NVIDIA AI Enterprise Registry at #MSBuild. Learn about ready-to-deploy NVIDIA AI Enterprise applications for #computervision and model inference optimization hosted in the NVIDIA AI Enterprise Azure Machine Learning Registry.  #NVIDIAonAzureRegister for this free live-stream session: https://nvda.ws/3OiRawX,2023-05-18T00:00:00,[],https://scontent.fcai19-7.fna.fbcdn.net/v/t39.30808-6/347620917_131385956611651_2366788190538386638_n.jpg?stp=dst-jpg_p180x540&_nc_cat=106&ccb=1-7&_nc_sid=9267fe&_nc_ohc=e0gYmKbuKpsAX8LHFLj&_nc_ht=scontent.fcai19-7.fna&oh=00_AfA_wfMrAXWq5_Rw3yKPEvpF0KhC_2bx1T3qhkG4jlHSBw&oe=64E30EB4,https://www.facebook.com/NVIDIAAI/photos/a.119492422050369/1181288495870751/?__cft__[0]=AZXOEi-8EKXbB4FS2Mp0TAJ5zawwHMgjsUVX1TFGgKsWLx00RdglE1T2bXoyQkYqXKUUkW4OTsnLzYhtK_vkD7RUmw_VkipdeQ2PwDuWuuzwWs7HFE_2iG4Q-zJa8jxSsoEDG9LgHGsQ_kZGV17NAIzKEen9uY0ld617QLwnh_rOueu-MaicIG8fOKdsSGG5L29zDSp_apRP1VDcYigqAmF_&__tn__=%2CO%2CP-R,5,0,positive,5
1180963039236630,NVIDIA AI,0,17,1,0,1,0,0,0,19,1,"Hear from BBVA, ING, Swift, and NVIDIA on #generativeAI opportunities for #banks and #fintechs—from asset management to fraud detection to customer service. Join the session at #Money2020 Europe on June 7 at 3:37 p.m. CET: https://nvda.ws/3IgGrQa",2023-05-18T00:00:00,[],https://scontent.fcai19-7.fna.fbcdn.net/v/t39.30808-6/347654935_1323079275303092_8931403989360979896_n.png?stp=dst-png_p526x296&_nc_cat=104&ccb=1-7&_nc_sid=9267fe&_nc_ohc=mzSxpXyTkBYAX_ogVGn&_nc_ht=scontent.fcai19-7.fna&oh=00_AfAqY3rld8iJ4K7QNjWCvMWFWsb3rhwFkXOODyz7eIcwtg&oe=64E3F5A3,https://www.facebook.com/NVIDIAAI/photos/a.119492422050369/1180963039236630/?__cft__[0]=AZW4XoF7qA2LGXfz_N6wPKkEG2LNoD46Bp3MGRQQTgEUgn82sv8By5a4uLhyqx137VLtT2CJNuffBQ9pTul1OQ-PibbjzV-4yBKpCPV9ykO0zaytvjgJ-MMpg55sFm7XjJn940I7_ubIJSYWJQe0c8ovNnBgGfQv16CCuPaR5xXNLnGoHXUqBGKGuXluN6Cvb6yk74o9l7ipy6dNcJunNf6a&__tn__=%2CO%2CP-R,19,0,positive,19
pfbid02Xh7KaYmEpYBw5tubr3HwWVQEQ1cyd9X5YfvuyxtxRkBeg8wo5VtBK2jW6Hm7S1QQl,NVIDIA AI,0,9,0,0,1,0,0,0,10,1,There are many factors to consider when choosing the right real-time #inference option - like varying levels of requirements and service level agreements (SLAs) in terms of latency and throughput. Check out this blog to learn how to host #ML models on @AmazonSageMaker using the #Python backend supported by NVIDIA Triton. https://aws.amazon.com/.../host-ml-models-on-amazon.../,2023-05-18T00:00:00,[],https://external.fcai19-7.fna.fbcdn.net/emg1/v/t13/11900596291588590617?url=https%3A%2F%2Fd2908q01vomqb2.cloudfront.net%2Ff1f836cb4ea6efb2a0b1b99f41ad8b103eff4b59%2F2023%2F05%2F09%2Fhost-ml-models-triton-python-1260x630.jpg&fb_obo=1&utld=cloudfront.net&stp=c0.5000x0.5000f_dst-jpg_flffffff_p500x261_q75&ccb=13-1&oh=06_AbFovboxM1ZlrN6C3oxuWvKRMyJVGTz0sTE6khT7QuLrtw&oe=64E00BCB&_nc_sid=dbad39,https://www.facebook.com/NVIDIAAI/posts/pfbid02Xh7KaYmEpYBw5tubr3HwWVQEQ1cyd9X5YfvuyxtxRkBeg8wo5VtBK2jW6Hm7S1QQl?__cft__[0]=AZVG9AErhSG1E0TAeV8_ctij6RVvBU7o5qgCV3lfbSqe-d3oJ39y6NM64SQ2Qe2u-cx3WSoE86QbccBoY7VFDdDqt3qK3yZ7B4xiYLZFiOo-rjMIzWMdrOGoNiJ3z1QLggsXYEe4yRhB4WR8Ggdp9dCmegI6NSAKEuPZyvY4DcSfh0oEn9mrjCY5rS23xra_goPddfGsL7AYEhq14YpNYABv&__tn__=%2CO%2CP-R,10,0,positive,10
1180916262574641,NVIDIA AI,3,12,1,0,1,0,0,0,14,1,"AI is a voracious, data-hungry beast. Data issues are often behind related problems with regulatory compliance, privacy, scalability, and cost overruns. Learn how to break free in this deep-dive VentureBeat article. https://nvda.ws/3nXz4Wy#MakeAIYourReality #AzureHPCAI #NVIDIAonAzure",2023-05-18T00:00:00,[],https://scontent.fcai19-7.fna.fbcdn.net/v/t39.30808-6/346279625_696604559058415_5449478564238369863_n.jpg?stp=dst-jpg_p180x540&_nc_cat=106&ccb=1-7&_nc_sid=9267fe&_nc_ohc=DvmvMkiNWrcAX_4OJ0O&_nc_ht=scontent.fcai19-7.fna&oh=00_AfARS_Xztjge9XBMbSCsN8MMANoMPGI83JGYN3fkYa-U6w&oe=64E421A2,https://www.facebook.com/NVIDIAAI/photos/a.119492422050369/1180916262574641/?__cft__[0]=AZUpD-nk7GFUQTrlCfKNavo2Gce9WsLMwQKwhWLb_E4u1KRsOXd--y-cBVaji0lzbKVtYNy36sn1oUF_tWV4wuhzLDkCBRYEG5r0rCjX8o3yKelLc2vHZ59sxwQd4gsOMTUYDsb9JMQG7mJYPBwn6xvI1YFDim2YBBZ7YmWi5e1v5I2U3Sbv49erxB6QpTZfMk74c-EGQ9cH9POjH9QJiJx3&__tn__=%2CO%2CP-R,17,0,positive,17
pfbid0oWauRcq9KdXrp3VbJfbQCKTwgNqEnBzqdMWWzi3LQnyeYGTvuwr3SCVQr7jWLVtvl,NVIDIA AI,0,4,0,0,1,0,0,0,5,0,"Join the White House livestream Friday to hear our Senior Director for #AI Research, Anima Anandkumar, present on how AI is enabling science for a positive impact on society.President's Council of Advisors on Science and Technology Meeting: Friday, May 19 at 9:15 a.m. Pacifichttps://nvda.ws/3MARfLh",2023-05-17T00:00:00,[],https://external.fcai19-7.fna.fbcdn.net/emg1/v/t13/8372352745362583054?url=https%3A%2F%2Fwww.whitehouse.gov%2Fwp-content%2Fuploads%2F2021%2F01%2Fwh_social-share.png&fb_obo=1&utld=whitehouse.gov&stp=c0.5000x0.5000f_dst-jpg_flffffff_p500x261_q75&ccb=13-1&oh=06_AbGdmLlJeeWvQJJUZcKxdEwtvh1awUC48cnaUiruhh4Ckg&oe=64E09D57&_nc_sid=dbad39,https://www.facebook.com/NVIDIAAI/posts/pfbid0oWauRcq9KdXrp3VbJfbQCKTwgNqEnBzqdMWWzi3LQnyeYGTvuwr3SCVQr7jWLVtvl?__cft__[0]=AZW45wfNsCuHJZPJiDH8xhOefS-R4rzbzuTu1GZw5961fdb33NA0yrEb0r2LVtQwM4B6HppXXx3Kk-jq0HiDrrr7Ct3KpQQEgmhuYXvq1BMfRjJ7BqGk37sWppF9LANpYAV35V91rWt6MxTaDuKb5fPcm9qOXBjoHq_7IQUkOuZAOO-9jDHSIlo7AyZ3rFpTv1DtYVD9bWAhMV3Rgko4EByH&__tn__=%2CO%2CP-R,5,0,positive,5
pfbid0vkHBYUH33chedPtFyfKgPVpxMkQ5AgXcmCG8Y3VJdsqHza3EuwD1TwCiMv1G8THpl,NVIDIA AI,0,14,2,0,0,0,0,0,16,0,"Today, we announced a partnership with ServiceNow to develop custom large language models built on the ServiceNow platform with NVIDIA #AI software and #NVIDIADGX infrastructure to bring intelligent workflow automation to enterprises.Learn more: https://nvda.ws/433T6xx#IT #GenAI",2023-05-17T00:00:00,[],https://scontent.fcai19-7.fna.fbcdn.net/v/t39.30808-6/346472145_252328967459486_4425041821827178608_n.png?stp=dst-png_p526x296&_nc_cat=100&ccb=1-7&_nc_sid=9267fe&_nc_ohc=yWF3nErb_tUAX9Dw3a2&_nc_ht=scontent.fcai19-7.fna&oh=00_AfCLyhxIOww0imGpJ4fF-K2oZ7NXRZ9Wnbmalm8p2pLbjQ&oe=64E44553,https://www.facebook.com/NVIDIAAI/posts/pfbid0vkHBYUH33chedPtFyfKgPVpxMkQ5AgXcmCG8Y3VJdsqHza3EuwD1TwCiMv1G8THpl?__cft__[0]=AZVPS45C_fb1GCbzE8mJexoAZxMYeNWpw-rvLGaP5sNGG4RPPhV7VYEx00BfICPbcVOepFZoNtQmBCo_2NYY5MsemX6Sx_vYjreIWE-aePDbIryklq4uaY3IJFctsenWT0XhqJLgb7UydFPX-ozW9HFl7k5aXvNv514plcAAci4Q5fo9QkRRzwvRnbHL1t5fSLAxsB3sjiQDqG2jS0erN_d4jfEDkWZVPVAF1RnqF6sQCcz75AeBKaHbdQoZGPTzNVKqTwUYK8YAWvkXrU1Gg2Ih&__tn__=%2CO%2CP-R,16,0,positive,16
1180820995917501,NVIDIA AI,0,10,0,0,1,0,0,0,11,1,"With the rise of OpenAI’s ChatGPT, developers are looking for ways of using #generativeAI to unlock new business opportunities. Engage with NVIDIA and Microsoft experts and discover how to combine the power of NVIDIA AI platform and Azure NDv5 AI supercomputer infrastructure to develop generative AI applications.#MSBuild #NVIDIAonAzureRegister for this free live-stream session. https://nvda.ws/3ohK5lI",2023-05-17T00:00:00,[],https://scontent.fcai19-7.fna.fbcdn.net/v/t39.30808-6/347265660_230927402889272_9159902897145748885_n.jpg?stp=dst-jpg_p180x540&_nc_cat=100&ccb=1-7&_nc_sid=9267fe&_nc_ohc=G6GNaXSWShMAX_oYdpo&_nc_ht=scontent.fcai19-7.fna&oh=00_AfDrXf_9Q4w15NCXV-HPBbiaeDb31YuBLr16h7iKNgN72A&oe=64E3538A,https://www.facebook.com/NVIDIAAI/photos/a.119492422050369/1180820995917501/?__cft__[0]=AZVY-nCrDx7GgYSMLBMv4RPZXsvqSdTY6zjxo5nVym4Qama2eBNR_DqiqyE9VbdPJAbzbxjqAsbwpT5flhpcFVqKpEwcX86rtQ0yl5bgpn4H_tiScSHaM2QobC4CoZ2tA8MR-bvcJcSLt0glEqvNEAu2vUdrOkvnoRn9skKginOcgH4UARH4jBzuGkrioGzAyvg7yZxghmQIhjdsmqHHBK9h&__tn__=%2CO%2CP-R,11,0,positive,11
1180743585925242,NVIDIA AI,0,6,0,0,1,0,0,0,7,0,"Don’t miss our #cybersecurity and #AI in #retail webinar on June 6, where experts will discuss how AI can be used to better detect insider threats, phishing, ransomware, and more. https://bit.ly/3BwWlBT",2023-05-17T00:00:00,[],https://scontent.fcai19-7.fna.fbcdn.net/v/t39.30808-6/347404501_3626415020972747_519974073042176836_n.png?stp=dst-png_p526x296&_nc_cat=106&ccb=1-7&_nc_sid=9267fe&_nc_ohc=mZzlRrCH1YcAX9rFUhg&_nc_ht=scontent.fcai19-7.fna&oh=00_AfCWDeUKjXUgtH02t4knQb0vv2uVOJlKKy_PY90TqpLEZQ&oe=64E38916,https://www.facebook.com/NVIDIAAI/photos/a.119492422050369/1180743585925242/?__cft__[0]=AZXY6OxlgnpNWK4I0mmFTWL6xGDPwbx8RpPkwMPYbThZsDCOgU-BWP2kB4s3OyLIqS0-VGeKLQMCiI--EYXpeng3QW6cnUk4xIxD7-V6bkH7XV85dW3TbWXR71c4qAEBKfoKxInLPWtlDO0q7vbxw9MVsKZVUhcuSXliUJzEdR7prPoqBeGT2ABDsJm9XcWIbPI4Ol21K7BwUxKCGlNP5O9v&__tn__=%2CO%2CP-R,7,0,positive,7
pfbid0356WuRssa1LV9iv1uTyagZr3bdAgDNEXxvT7ptxSLJqZYYEjj1aUr86pid5bwvPsnl,NVIDIA AI,0,6,0,0,1,0,0,0,7,0,Discover how computational biologists are trying to bring back many extinct species with NVIDIA Parabricks software suite for #genomic analysis. #AI #healthcare https://bit.ly/3MwFANC,2023-05-17T00:00:00,[],https://external.fcai19-7.fna.fbcdn.net/emg1/v/t13/4956958457448444837?url=https%3A%2F%2Fblogs.nvidia.com%2Fwp-content%2Fuploads%2F2023%2F05%2F1620px-Woolly_mammoth_model_Royal_BC_Museum_in_Victoria.jpg&fb_obo=1&utld=nvidia.com&stp=c0.5000x0.5000f_dst-jpg_flffffff_p500x261_q75&ccb=13-1&oh=06_AbF9TN_FpsWxfcckeBxlscgxQz8_L6VLMFeS-Yptc9LdpQ&oe=64E07061&_nc_sid=dbad39,https://www.facebook.com/NVIDIAAI/posts/pfbid0356WuRssa1LV9iv1uTyagZr3bdAgDNEXxvT7ptxSLJqZYYEjj1aUr86pid5bwvPsnl?__cft__[0]=AZVa6TH-i4CTb-ZFllK9NInBZOru7-LsJH4IsbUuHVsGQovXPapqFzpCbckG8hyhx4uZd_Q-qaqwVUiMVo0u4EcnISNwBDBBbZs6vrdVAQICwnDM9DFXdpaYP2V5Z4ts6jnLQ9UmcQm4EOAr-pvL-39mpbeUMv0Zty6drHiKns-lF7LE1wy4WsVge7HT0bCVTzQl0hRifussmUMBY9xFsYAq&__tn__=%2CO%2CP-R,7,0,positive,7
pfbid0284xcusrmVigMrHWsW9AAX5gxZ7XmzQfV5xUDACAeQxieJVLmmnVUhmNtPRCfVTPVl,NVIDIA AI,0,6,0,0,1,0,0,0,7,0,"Next week, join us as we discuss how accelerated Spark enables leading retailers to transform their business by enabling workflows that were previously impossible, and more. Register today: https://nvda.ws/3LWousl",2023-05-17T00:00:00,[],https://external.fcai19-7.fna.fbcdn.net/emg1/v/t13/18225403320976267663?url=https%3A%2F%2Fprod2-sprcdn-assets.sprinklr.com%2F50276%2Fc56a483d-6614-4b58-b291-01cc81bb3fc6-1753317338%2Fretail-social-webinar-apache-s.png&fb_obo=1&utld=sprinklr.com&stp=c0.5000x0.5000f_dst-jpg_flffffff_p500x261_q75&ccb=13-1&oh=06_AbHTGjARPn7wUmZd6GEGfhtcX6puPCdCZf20z0MKRDxD0A&oe=64E070AE&_nc_sid=dbad39,https://www.facebook.com/NVIDIAAI/posts/pfbid0284xcusrmVigMrHWsW9AAX5gxZ7XmzQfV5xUDACAeQxieJVLmmnVUhmNtPRCfVTPVl?__cft__[0]=AZUjx3Wxc4z7WhcoIAQPTISUaluFtXbQGm1y-x6sX1Rl8Y33JJjehc1BaBvQnBbICeh0jolqhJiqvezrCEBfz23i-ivAL4vbifGUyJbDiBD0n_QFyDZkFC9VhaAfq9n_IuKLifdeMPF0yh0pi9bkDYvKOt4laqh_Ym1R4jzmRgCTMZEC3yRyJ1K1zKf3q_sD3XiaZmgvzXdUIQwvMYxcuGPu&__tn__=%2CO%2CP-R,7,0,positive,7
pfbid0spgC3jB3HfYn48HKVJZXxVBaQY1q7jb9H6yR3Tv7EuDApBJ3vbLaAH1h1YHqyZZJl,NVIDIA AI,0,6,0,0,0,0,0,0,6,1,"#AI & ML models are transforming the world and #datascience is getting more challenging than ever. Find out how you can stay ahead of the curve at #Rev4, the world's largest Data Science and #MLOps conference. Register now with our promo code NVIDIA50 to get 50% off registration. https://nvda.ws/44PhcOt",2023-05-16T00:00:00,[],https://scontent.fcai19-7.fna.fbcdn.net/v/t39.30808-6/346654008_757251399460669_7828921007428815469_n.jpg?stp=dst-jpg_s960x960&_nc_cat=108&ccb=1-7&_nc_sid=9267fe&_nc_ohc=0i5uuSySOmAAX9E90Bn&_nc_ht=scontent.fcai19-7.fna&oh=00_AfAmvrBjLJAwEyMqguIp6dp3aUXEzvLtyDpoCSYix4lArg&oe=64E3AA3D,https://www.facebook.com/NVIDIAAI/posts/pfbid0spgC3jB3HfYn48HKVJZXxVBaQY1q7jb9H6yR3Tv7EuDApBJ3vbLaAH1h1YHqyZZJl?__cft__[0]=AZXG5VmEYa3m8-vQbFZslzrQu1efZroyC2KPUFbZYESu7di9XuS9FLJLdLsi8rII3kF-V3hgUw4wNQM_Jz4CK319-VeItTRUFlWJP1KRk4idVCuc680aOKOhuU9K8ZOTeFMg_5Hm_jSHPu5oq6Nf2tvhIqPwqmfBghZvrCRy7wA4IE00difa8xFi6T17RmOAOLn-rhQ_Y1tvkjO43uaNp1DUt0h_C9AgQ6-0tVc3VHBeCxcn3RnnnzTApSQyIIaOl2ALAKMd70OliNXUUhrsIYOs&__tn__=%2CO%2CP-R,6,0,positive,6
1180367202629547,NVIDIA AI,0,6,0,0,1,0,0,0,7,0,Read how conversational AI is being used to transform customer experiences for #telecom companies such as AT&T and T-Mobile https://nvda.ws/40G8XRp,2023-05-16T00:00:00,[],https://scontent.fcai19-7.fna.fbcdn.net/v/t39.30808-6/347019335_209862661846835_7678497239107401207_n.jpg?stp=dst-jpg_p180x540&_nc_cat=111&ccb=1-7&_nc_sid=9267fe&_nc_ohc=Td67VQ_k4LUAX8t6FIY&_nc_ht=scontent.fcai19-7.fna&oh=00_AfAwPEvp2emNbvZoc7rzL4awYAhJbWtDdv9wM50xhLeLeg&oe=64E45733,https://www.facebook.com/NVIDIAAI/photos/a.119492422050369/1180367202629547/?__cft__[0]=AZUvw7oKApUmZ8F85XABOr-cbq5Nv9Gdj48fHIYKFOabe0TVO7J-HRznaOuUJnoZHavP64O3Kc2mvpdxwCayyXmdfzZn9PHckdipQZfZ6YffQqFVH0AGku9bVgEMELrQtNVaaFtfAHDF5Xb6n3AcV_QuBStEaRq8XekbsVM5s28bdf9_MMoraILVz0WvvlMW8-RFvE77AEewsPJnNIn6s-WO&__tn__=%2CO%2CP-R,7,0,positive,7
pfbid0F7QZWK78sCjiusoooVNtW9cUrd5FUrvfxDQ38k8RkuvJnwXEeUCmp4KezZ5cYuutl,NVIDIA AI,0,13,0,0,2,0,0,0,15,0,Join this webinar featuring Michael Thomas from NVIDIA and other speakers from Google Cloud to explore how NVIDIA GPUs accelerate AI/ML workloads on Google Cloud and more. Register now > https://nvda.ws/4550cDO,2023-05-16T00:00:00,[],https://external.fcai19-7.fna.fbcdn.net/emg1/v/t13/2688461771101140006?url=https%3A%2F%2Fcloudonair.withgoogle.com%2Fapi%2Fassets%3Fpath%3D%2Fgs%2Fgweb-gc-gather-production.appspot.com%2Ffiles%2FADPycdsn5QpY9ECWqMgb2VeTLhwGFAQJ-OZueSnVDd_OWWDlts8LX6icvqFB79cnJN_68o1p5694cO-ITB3fJzUkMbv_RmDUeg5U.jZEnTUwvz9mTL5KM&fb_obo=1&utld=withgoogle.com&stp=c0.5000x0.5000f_dst-jpg_flffffff_p500x261_q75&ccb=13-1&oh=06_AbHip729AlcQL0ckIoUJ9KROOfb7U4daLcE7vVGo6t_Isg&oe=64E05C05&_nc_sid=dbad39,https://www.facebook.com/NVIDIAAI/posts/pfbid0F7QZWK78sCjiusoooVNtW9cUrd5FUrvfxDQ38k8RkuvJnwXEeUCmp4KezZ5cYuutl?__cft__[0]=AZV84ZOngY1ZXn4e59m7ndJX5p7IIkRTpw9VKTwwe8H0pzf8o7NwEXzLiR8vgYncMycNt71_ET4_uMUe9xk0q28_qseRj0-RnL1AphpfIFrz7v1b6t9q0PfXGMzc6Ges1Mroz3ETd1hJJ8STlZTWfsyFxluaqlqvSatgJZ35MPsjnwwsat-_TSmLeDzwFeu3YFNePxO4acYZ84BrGyppviHo&__tn__=%2CO%2CP-R,15,0,positive,15
1179983556001245,NVIDIA AI,2,16,3,0,1,0,0,0,20,1,Unlock the power of #AI with enterprise-ready accelerated computing solutions from NVIDIA and Dell Technologies at #DellTechWorld. Register now: https://nvda.ws/3Bk1ehN,2023-05-16T00:00:00,[],https://scontent.fcai19-7.fna.fbcdn.net/v/t39.30808-6/346853135_789173652476582_5230588284543556771_n.png?stp=dst-png_p526x296&_nc_cat=110&ccb=1-7&_nc_sid=9267fe&_nc_ohc=QYm3YjzQuEcAX_U3uQs&_nc_ht=scontent.fcai19-7.fna&oh=00_AfDOZs9unA2wtVJhJZXjwB-LnFUXaXJwevw_PzFFRdxjIw&oe=64E48FE2,https://www.facebook.com/NVIDIAAI/photos/a.119492422050369/1179983556001245/?__cft__[0]=AZWFl1Gav2JhVX-EKtczQ2vVyrvUt0ZkuPgga-k2GkP1hkCy0tZMFU-x_yD6Ofn1qHdRwdMAA2q2y1wQD2VZMFdBhiyVQLz7NgSjUX1m3wro2-dckS325PQiOxiqRxjM34QNfVoqSv_AeGbTPrxGR-L1sgySl-oTGrnYNEFJz8lm6_08OnNTYgbUnNIWFLVMYHElvJDGnBd6SkAKsw7UPpRZ&__tn__=%2CO%2CP-R,22,0,positive,22
1179931579339776,NVIDIA AI,0,8,0,0,1,0,0,0,9,1,Join us at #MSBuild and learn how Azure enables autonomous driving development with NVIDIA DRIVE Sim on Omniverse Cloud and DGX Cloud. #NVIDIAonAzureRegister to watch > https://nvda.ws/42n5qcp,2023-05-15T00:00:00,[],https://scontent.fcai19-7.fna.fbcdn.net/v/t39.30808-6/347105823_633139188692259_5933193701447767628_n.jpg?stp=dst-jpg_p180x540&_nc_cat=109&ccb=1-7&_nc_sid=9267fe&_nc_ohc=z4Ju4YXpBVsAX8fPy9F&_nc_ht=scontent.fcai19-7.fna&oh=00_AfARamrE8KMkmaKFCc2PFcd4Sat8ALVXnviBcGwaCIHzcw&oe=64E2C27E,https://www.facebook.com/NVIDIAAI/photos/a.119492422050369/1179931579339776/?__cft__[0]=AZUew1WLl8KOKlKKWIA6veYUQg8jNycmRPtQm8i0Z_-LBKwpNv59myd-lU_3Nc4MRxllvPEXuT-9T5EQBvj21TVULiqzgF7_Fmu-fnp-J2LL4sTbgF1pPN5WssT5tmDlbl1disMlTkaFIuiXnrrD3KCzZH6DAQXAizWqQdHUktM84vRw2Ka_i4KtFVgbgRPC01kDd3usHYQptZClNTzlzb5K&__tn__=%2CO%2CP-R,9,0,positive,9
1179839972682270,NVIDIA AI,0,13,1,0,2,0,0,0,16,1,"Attention educators! Ready to take your classroom to the next level? Join our NVIDIA Omniverse Community stream, hosted by the Deep Learning Institute Teaching Kit program leads! Discover how Omniverse can enhance your syllabus and explore our four new teaching kits designed just for you! https://bit.ly/3BgWb1F",2023-05-15T00:00:00,[],https://scontent.fcai19-7.fna.fbcdn.net/v/t39.30808-6/346317650_972980517043241_558514777147072770_n.jpg?stp=dst-jpg_s960x960&_nc_cat=104&ccb=1-7&_nc_sid=9267fe&_nc_ohc=-But7jbP8EQAX_IJ7t7&_nc_ht=scontent.fcai19-7.fna&oh=00_AfAMtDoJ8d1sYMe3WNF6LB8sig8-gtoHjocMI1UUEbHmnA&oe=64E2DF99,https://www.facebook.com/NVIDIAAI/photos/a.119492422050369/1179839972682270/?__cft__[0]=AZUYT-M6uYVLSsVrPfmg49xldaHjE6Sk45N8yULEgF_X3zY4cWt0ltuxtkAzxBjZtWr0_1Du-Yo_bWCd4qcmrAIGi0Lcl4yMz2NFd-RT8QR5B_SmkcUgdtkcbstpgeLjMnHw5340IOAWCtSKNJriznQCtrwG03rpK5vgM2ghShtFhVYeADRfPjhHK9AM_pjs2hGK-qOvwkX8l9HMd0We3TZQ&__tn__=%2CO%2CP-R,16,0,positive,16
1179462436053357,NVIDIA AI,0,8,0,0,1,0,0,0,9,0,Hear from NVIDIA and Microsoft experts on how to build and simplify custom language and image models at scale. Experience the future of AI with NVIDIA NeMo at #MSBuild. #NVIDIAonAzure #LLMsRegister for this free live-stream session: https://nvda.ws/3NYKUdQ,2023-05-14T00:00:00,[],https://scontent.fcai19-7.fna.fbcdn.net/v/t39.30808-6/346062730_268718058958073_5036314998335316493_n.jpg?stp=dst-jpg_p180x540&_nc_cat=102&ccb=1-7&_nc_sid=9267fe&_nc_ohc=jTOwp0Yy88MAX9-iqpq&_nc_ht=scontent.fcai19-7.fna&oh=00_AfDgkxSAeFTVQAOmjNLD2fqUhNA3m_MN_9sRLPxI0WT1LA&oe=64E3A0AF,https://www.facebook.com/NVIDIAAI/photos/a.119492422050369/1179462436053357/?__cft__[0]=AZXRQ_2teGy_gKB3yyxmyRBuf3CeGvVhCRpIsgwtBeGp2jwzWDg4tLujREu0TVxFggqtXxircjQEZ-e0kd6iCaDm7hVvy_yRos7p9sQWGr2MwmP5P9UFvTys59OdmIgUvSqjN-EqdpTCFRPyk4HAgHzPxNhKMxGobjDQb_JfbrbyFVWAaxDVVANB2w7beRfCCb-bXKMKPEw0lRCRisSmK_Df&__tn__=%2CO%2CP-R,9,0,positive,9
1179347886064812,NVIDIA AI,0,8,0,0,1,0,0,0,9,1,"By investing in #deeplearning models and partnering with NVIDIA and Amazon Web Services, financial services institutions can achieve new levels of accuracy in identifying and preventing fraudulent activities at scale—alleviating the $1 trillion annual global impact of fraud.Read the TechCrunch article: https://nvda.ws/3O5TcAz",2023-05-14T00:00:00,[],https://scontent.fcai19-7.fna.fbcdn.net/v/t39.30808-6/346839218_263890542694092_6135861970423676676_n.jpg?stp=dst-jpg_p180x540&_nc_cat=110&ccb=1-7&_nc_sid=9267fe&_nc_ohc=OcjK04cvaRUAX9isYve&_nc_ht=scontent.fcai19-7.fna&oh=00_AfBGRc-2eQcRHxINjcLPmdrlkH7sPlepEzsBo-0xM69e-w&oe=64E45823,https://www.facebook.com/NVIDIAAI/photos/a.119492422050369/1179347886064812/?__cft__[0]=AZVhgs2GkmiqyfBfNoPRkjqQrlhFyaB3CZMEbU0oNrcFVHQA2ZjQR9u6LeSrEyc-COThCtDZp19KSLbqD4mVhO8LUO9a4o1yMCA9xqYt2ocqMVPbcFOroNt2uPgS_FNznWwDsIhpNpIuqYb5Me9TqwOCd1iS4hl5MS8fElT6ErRl9pA_Nf0xOoeaW3Jc3sdCUka28goPmFhiuI7X4RA9AEGO&__tn__=%2CO%2CP-R,9,0,positive,9
1178881602778107,NVIDIA AI,0,10,0,0,1,0,0,0,11,3,Learn how to build next-gen AI services with NVIDIA AI on Azure Cloud. This session showcases how developers can utilize the NVIDIA AI platform with Azure to accelerate the generation of data and simplify the development and deployment of #AI applications. #MSBuild #NVIDIAonAzureRegister today: https://nvda.ws/42xnQak,2023-05-13T00:00:00,[],https://scontent.fcai19-7.fna.fbcdn.net/v/t39.30808-6/346848716_788559129518396_2188260722392665968_n.jpg?stp=dst-jpg_p180x540&_nc_cat=110&ccb=1-7&_nc_sid=9267fe&_nc_ohc=MnoadhlrcGIAX8kHDSm&_nc_ht=scontent.fcai19-7.fna&oh=00_AfADATY3zR396Vm7fqbNrpZ69tRy6lfGW65ZsiB7DZ8qaw&oe=64E2D25B,https://www.facebook.com/NVIDIAAI/photos/a.119492422050369/1178881602778107/?__cft__[0]=AZXJx31Yj9EmmOKrTqDUGPVmAhVktJms3zxfe0OvsfE96HHjS_1UnOnRwFBmFMm2hCMDi5FgeI-l_802-grf5P9wn32T2NCxFIEfcBJucPPEXqMFYMj-jnF81g6KDJIqPjrn2khBRDzrjoDa4m5vHcVlutX4Woy4hsXXyB3jkSPJPQLk72RO1bwp6niErCLRG8TpN6mnHuExDQomsts7-97T&__tn__=%2CO%2CP-R,11,0,positive,11
1178807276118873,NVIDIA AI,2,23,2,0,0,0,0,0,25,2,"#Energy companies are exploring #generativeAI and large language models for subsurface insights, industrial digital twins, contact center agent assist, and more. Learn how NVIDIA DGX Cloud empowers these enterprises with immediate access to high-performance #AI infrastructure in the cloud at scale: https://nvda.ws/3nMjc9w",2023-05-13T00:00:00,[],https://scontent.fcai19-7.fna.fbcdn.net/v/t39.30808-6/346303867_938882114087831_2290160718506750816_n.jpg?stp=dst-jpg_p526x296&_nc_cat=105&ccb=1-7&_nc_sid=9267fe&_nc_ohc=w4fk5DtiMOEAX9ih1dp&_nc_ht=scontent.fcai19-7.fna&oh=00_AfC0oBc8XhO2ppZA3T83EQDZ1tpAMug6yFjdd7UGDe6RkA&oe=64E3DDC7,https://www.facebook.com/NVIDIAAI/photos/a.119492422050369/1178807276118873/?__cft__[0]=AZWTGvEcMtmF2RLaJs6_FEtNSavzrzh-zS2gyIg5bzQ5otsYlfKZxdsqZtLAw9gGsu_18ptB96UASbXoon8TjvRXrity_LTCnzEOMXZ3e1U4o2qm1oItF3awvbEs4RKWSNFwGEgJuVlp2c5HkdDVSuC08bsHTcYr8gJ5YPe1C9O1i06ABfuh_yf-ZMZYlqDv-4ptXSvvdhVVPbt0-Khqrpr0&__tn__=%2CO%2CP-R,27,0,positive,27
pfbid0g5yD2Vunm5dviQFVcQhtsjixYZL1q8CzXCkcRi5NVAaXhmY13sGs75N2J4hhT3yxl,NVIDIA AI,1,4,0,0,1,0,0,0,5,1,Retailers experience more data breaches than any other industry. Join our #cybersecurity and #AI in #retail webinar on June 6 to learn why cybersecurity threats are increasing and how to adopt an enterprise AI cybersecurity framework. Sign up now: https://nvda.ws/42UVbvT,2023-05-13T00:00:00,[],https://external.fcai19-7.fna.fbcdn.net/emg1/v/t13/15149728999598891175?url=https%3A%2F%2Fprod2-sprcdn-assets.sprinklr.com%2F50276%2Fe0afefc0-d491-4308-94e9-9f61cd5129f6-165420678%2Fsocial-cyber-retail-webinar-ig.png&fb_obo=1&utld=sprinklr.com&stp=c0.5000x0.5000f_dst-jpg_flffffff_p500x261_q75&ccb=13-1&oh=06_AbG9k4xKE2XePYPwpYpwSixfNKX3M3VPJaNZYo1bzDUlcw&oe=64E0334A&_nc_sid=dbad39,https://www.facebook.com/NVIDIAAI/posts/pfbid0g5yD2Vunm5dviQFVcQhtsjixYZL1q8CzXCkcRi5NVAaXhmY13sGs75N2J4hhT3yxl?__cft__[0]=AZVUmct6HRMddp9ISrlOi3itym0UFraG1biNiB1RbRtKtHIAy5yHPBandc2_tRDhc9IlIdXlAEP0nmW-urYMpG80xaNj93sFHFYzCzWmoHSBp1XZkGHWcgwAy6e9Ql-nyKZpexioh4D-yXYbNX71fym_OMhu2PYLFjCfEG4vwgX2fOH5UdzP_POFT_4Yi87J8b5rgdMupREq2d1vbLmGakPz&__tn__=%2CO%2CP-R,6,0,positive,6
pfbid02Go9beUhGKrcbsywQm1uPfjWy4cZQ6j6PT9M7FXz5BwnLCqs4nhmJET11PyenTAqQl,NVIDIA AI,1,8,1,0,1,0,0,0,10,2,"Join the upcoming NVIDIA #RTX Path Tracing AMA on June 6th at 9AM PT and discover how to accurately mimic real-world lighting for lifelike #3D graphics and create high-quality photo modes or real-time, ultra-quality modes. https://bit.ly/3LW6GMH",2023-05-13T00:00:00,[],https://external.fcai19-7.fna.fbcdn.net/emg1/v/t13/6640644162400013726?url=https%3A%2F%2Fprod2-sprcdn-assets.sprinklr.com%2F50276%2F64e1cc13-dcc8-4e3f-bb57-9cf6246ecbb7-522704095%2Frtx_1480x833.png&fb_obo=1&utld=sprinklr.com&stp=c0.5000x0.5000f_dst-jpg_flffffff_p500x261_q75&ccb=13-1&oh=06_AbEoYOfWR6SGOnQ2GWKPEV2Ds1oOQlvRHNRdcby0O3jocA&oe=64E01874&_nc_sid=dbad39,https://www.facebook.com/NVIDIAAI/posts/pfbid02Go9beUhGKrcbsywQm1uPfjWy4cZQ6j6PT9M7FXz5BwnLCqs4nhmJET11PyenTAqQl?__cft__[0]=AZWJ_TgjrNk9wKiKsshu2xQuQ-JKdp-moBlcsWpioYEVAZjn0zLeNNFC1b5xxpo9yrZ68zjcLAOcEX5BVw_lVPuvLO_RrNoT49dc8ZnPQw8SQs41mHdfhJlsdhGhKYG3bncim1YmGsP6BHUTroP603OpV0RbH-UTw9b9I2LlobyF6FWMteQFcyF4I9EG7aS34oQmYACEaMS69G4drVRr2QoL&__tn__=%2CO%2CP-R,11,0,positive,11
pfbid0PNHy71csmSkgeyKrZWNLTWHV9AmrLYN5kq4raq8D1ejfWfMwq2hujuAfZD3j9mrol,NVIDIA AI,0,9,1,0,1,0,0,0,11,0,"Learn how NVIDIA can help retailers run workloads 5x faster with up to 4x cost savings on leading Apache Spark platforms such as Google Cloud Dataproc, Amazon EMR, and Databricks by attending our webinar on 5/23: https://nvda.ws/421Xuxa",2023-05-12T00:00:00,[],https://external.fcai19-7.fna.fbcdn.net/emg1/v/t13/6798212639670657695?url=https%3A%2F%2Fprod2-sprcdn-assets.sprinklr.com%2F50276%2F170cae9c-f86f-449e-b647-abc4a3b738ae-1753317338%2Fretail-social-webinar-apache-s.png&fb_obo=1&utld=sprinklr.com&stp=c0.5000x0.5000f_dst-jpg_flffffff_p500x261_q75&ccb=13-1&oh=06_AbEGMf49hg_GA36ayxnJ-i3__X3YG-qMsuF7yAszRCpnRA&oe=64E01936&_nc_sid=dbad39,https://www.facebook.com/NVIDIAAI/posts/pfbid0PNHy71csmSkgeyKrZWNLTWHV9AmrLYN5kq4raq8D1ejfWfMwq2hujuAfZD3j9mrol?__cft__[0]=AZVXIkGSTHWO5qXI1Ug7_WHQf7epdg08bt5sCVN9-EYWF5EeQyQzEAqZVKnN7gOo3BvEwvs4kyhosAYKQzoapR0QCX71zSN8TvA2UMzt-hA4Z39m6YcapX6M82rTATPxFC3MzhWPy-o-KMu4elZwrj6ejnbRyQFvhZeo7aJqjh7YxMV2SAbkK0-dGz1zLqly3jvSDb2ES1Rk0Mg8Yvq661cF&__tn__=%2CO%2CP-R,11,0,positive,11
1178392366160364,NVIDIA AI,0,6,1,0,1,0,0,0,8,1,NVIDIA Founder and CEO Jensen Huang will join ServiceNow President and COO CJ Desai's keynote on May 17 to discuss #AI-powered transformation. #Know23Register now: https://nvda.ws/41vJ5s3,2023-05-12T00:00:00,[],https://scontent.fcai19-7.fna.fbcdn.net/v/t39.30808-6/345664142_1020425312438506_5778352446427769084_n.png?stp=dst-png_p526x296&_nc_cat=101&ccb=1-7&_nc_sid=9267fe&_nc_ohc=9gWV16nQp4IAX8swhss&_nc_ht=scontent.fcai19-7.fna&oh=00_AfA5PqTqMHhNYzsyXrsbTsaWNIu-WWGMJzWWlXkLB1JZqw&oe=64E35E6C,https://www.facebook.com/NVIDIAAI/photos/a.119492422050369/1178392366160364/?__cft__[0]=AZX5Untfwwg8dPirOHcCwI6uolOEPFiquOJ0bmZzlVfM2tNEizXEmDLpaqbpDkQibt5d6ubNm1q669AphDe4bVNhBKEk0GVjCfb7JOsYi3DXhDN5s621gD_kBe4dISNiac-HTxhoaGV9dTbvSTXQdrqMBiEiXNOWOeqWPRqdlu6wcuP6Wp4245pf2qiTLYEhMOiJi0gP_cir9r4TKhipH-LG&__tn__=%2CO%2CP-R,8,0,positive,8
1178371952829072,NVIDIA AI,0,8,1,0,1,0,0,0,10,0,"Join keynote speaker Bryan Catanzaro, VP of Applied Deep Learning Research at NVIDIA, to discover the power of #generativeAI at the ECE Virtual Summit on May 18. Register to learn how #ChatGPT will help Drive Innovation for the electrical and computer engineering community. Produced by the ECE Foundation in collaboration with the ECEDHA and NVIDIA partnership. https://bit.ly/436gf2H",2023-05-12T00:00:00,[],https://scontent.fcai19-7.fna.fbcdn.net/v/t39.30808-6/346054350_785930649569129_3487497505412483825_n.jpg?stp=dst-jpg_p180x540&_nc_cat=102&ccb=1-7&_nc_sid=9267fe&_nc_ohc=fk_i8v_JCPIAX-TRrDH&_nc_oc=AQl2VxWQdvqXSwunrqz3QAUNG_tDhUb4EzOkDB7so8Ksz4na9n8b_aMtzB6o6sAnMgI&_nc_ht=scontent.fcai19-7.fna&oh=00_AfBusaGE2ddqGWVKiCOhkbrT1n3Yo9FKrSxAkxbcdmnfkQ&oe=64E3BB94,https://www.facebook.com/NVIDIAAI/photos/a.119492422050369/1178371952829072/?__cft__[0]=AZUWLedC2EOKd_LcOIyrjfN1gu53QyMlIGjAv1t0fiEpdcN31Ob2NBU0yTHqNx-6C7fC3xWHbJKBCLSqW7SEcqR-iU070DDj1LwQ3z6u8M7KCLuac6o9GHhxGo7PUDU9ciJZmCvSkUSTW64W1TL34kIN72ZbIKStXqylj6kXzwlemIg9RIWTAcCjArz70bpUhi-Y_qaEYZfBXBiE7DYMGAhe&__tn__=%2CO%2CP-R,10,0,positive,10
pfbid09tgAwHLmawYvcLkTZGMDozoFfFGSb5QVopea8EsyK6nxgK92aet2G5KpvCUmSo9wl,NVIDIA AI,0,5,0,0,1,0,0,0,6,0,Get the latest best practices on how to accelerate your #datascience projects with RAPIDS by checking out the on-demand #GTC2023 sessions: https://nvda.ws/41C3zzr,2023-05-12T00:00:00,[],https://external.fcai19-7.fna.fbcdn.net/emg1/v/t13/5418923484114796189?url=https%3A%2F%2Fprod2-sprcdn-assets.sprinklr.com%2F50276%2Fd0ec2e72-4926-49e1-922a-241f27b3edfd-1577948529%2FRAPIDS_Logo.png&fb_obo=1&utld=sprinklr.com&stp=c0.5000x0.5000f_dst-jpg_flffffff_p500x261_q75&ccb=13-1&oh=06_AbHkTcCBg43yiTvRwDGZBg0NytIyVwjFG9BO6VUvSXAESQ&oe=64E05919&_nc_sid=dbad39,https://www.facebook.com/NVIDIAAI/posts/pfbid09tgAwHLmawYvcLkTZGMDozoFfFGSb5QVopea8EsyK6nxgK92aet2G5KpvCUmSo9wl?__cft__[0]=AZWmRimnm26tdT4aZq8oFFHsL0_n7LOpV1jSGhLlD36GhbSFlDeWnv0suWD9bvdPsCP-kmnfL6RAp8cSYahKeC4wyvAifHN1cr7S3X5DThBTIodSphiIgX9tlXKrdrZ5fWbv_NwffGlad_Pqo5h2cY-f7nhjJ_duVhz4RpmQx9bAQG19h4tl1C22P0FLs7vzue7pi-xY9KGGeoLvFHyS0t4O&__tn__=%2CO%2CP-R,6,0,positive,6
1178330909499843,NVIDIA AI,0,14,2,0,1,0,0,0,17,2,Learn to harness what’s next for devs at #MSBuild. Join experts from NVIDIA and Microsoft in insightful sessions. Don't miss out. #NVIDIAonAzureRegister now: https://nvda.ws/3nW1MqV,2023-05-12T00:00:00,[],https://scontent.fcai19-7.fna.fbcdn.net/v/t39.30808-6/346600872_759306279207507_101726098880523708_n.jpg?stp=dst-jpg_p180x540&_nc_cat=111&ccb=1-7&_nc_sid=9267fe&_nc_ohc=hx3fso0RjPoAX-8Rrlg&_nc_ht=scontent.fcai19-7.fna&oh=00_AfB7ljuBDBtCA2vb2_6YMHROp7gUkKu1CmJrF0-4pI4gqA&oe=64E47153,https://www.facebook.com/NVIDIAAI/photos/a.119492422050369/1178330909499843/?__cft__[0]=AZWkcJh9IhzyMgtLslDJl0RcSONnGjhFvf0bu42f3xySwHrWAZ-yG-ZeKvg4ZbvYHgbIG6nvNF80B-r1JahCIg52AUZYgXy4VQZ-dh9Kr-ZfAvQfFoIiApSQ_jdidbHHunH1CBEh9OlYOO2aPTKf_CxwWEEteJQ06-yBEDJUEPIOF7mc5VJ8JoL6ITHSiZZhnjaLUdro6-yXzjC_ueUe2MLx&__tn__=%2CO%2CP-R,17,0,positive,17
pfbid0L2fRxSqMvw5AbkuDvZidS96Th5jKWZxMQF7iEViUuELRgDgX1wPvfYxQF6BRz427l,NVIDIA AI,0,5,0,0,0,0,0,0,5,0,"Today, innovation begins at the Edge. Learn how AI at the #Edge can transform your business through Product development Customer interaction Operational efficiency https://lnv.gy/3GVZApICC: NVIDIA AI#TheDataCentered #ThinkInnovation #AI",2023-05-11T00:00:00,['https://video.fcai19-7.fna.fbcdn.net/v/t42.1790-2/345213291_3095746724051276_8204320006863640905_n.mp4?_nc_cat=103&ccb=1-7&_nc_sid=985c63&efg=eyJybHIiOjQ4MCwicmxhIjo1MTIsInZlbmNvZGVfdGFnIjoic3ZlX3NkIn0%3D&_nc_ohc=zClKuR6oAGAAX8x8yig&rl=480&vabr=267&_nc_ht=video.fcai19-7.fna&oh=00_AfBqEhbF2CZWrfnCQGl2AtgXiOu-gxOMLjRuqozgSq2Vrw&oe=64E42436'],,https://www.facebook.com/NVIDIAAI/posts/pfbid0L2fRxSqMvw5AbkuDvZidS96Th5jKWZxMQF7iEViUuELRgDgX1wPvfYxQF6BRz427l?__cft__[0]=AZXHlTTW3fshaPV-bQEKpYloUCHS0HoMThO_nMSRjXDuCvxxR1_KxGOT7OsyYuDu52TAx-rMhwrGEHnJswDbIIotReZtiAHf6Xwv4hebgiujAqRXEMYvUoUTN2ZDEhjvV7D9C_F5DpATENgN8Kf0uR6QhTaWNggdg2fL6XMFFF4hc14VLSu5g8dreFqU32u-nVihi1UNldXBD7uL28_mYaFHgN5qHtiwnDsonNlaBo4Dc1w4A7xT5q-G1utartYHBbk&__tn__=%2CO%2CP-R,5,0,positive,5
1177920782874189,NVIDIA AI,0,9,0,0,1,0,0,0,10,1,"Get ready for Microsoft Build, May 23-25! Explore the power of AI with NVIDIA's Virtual Showcase for free developer resources, demos, and the latest AI news. Check it out. https://nvda.ws/3nWKgTt#MSBuild #NVIDIAonAzure",2023-05-11T00:00:00,[],https://scontent.fcai19-7.fna.fbcdn.net/v/t39.30808-6/344817933_802982744678390_1337158705986213774_n.jpg?stp=dst-jpg_p180x540&_nc_cat=100&ccb=1-7&_nc_sid=9267fe&_nc_ohc=0aq9eRwuxXkAX_LpTzy&_nc_ht=scontent.fcai19-7.fna&oh=00_AfBmgP1q_Op8PiZHG44QGir-HMbNvsxhzqIvEd12OBUqBA&oe=64E3C57F,https://www.facebook.com/NVIDIAAI/photos/a.119492422050369/1177920782874189/?__cft__[0]=AZVbKNP1wo1TpHk-xgcecYCwUt1-GmtSzGp35bOM7WWknbO1KCMH2LTsgAeo_t42PDXAHi3BJbbRdnmHUv8k_qiiIPei7IGfOU_BUSkdws9Md5pXw6MW8t8luO6UWQwrjDFJ-EMG3esvEq5iOJyjy1pE8GbTKgOf_9RnHhscs-B0Ajj5AmVK-_jaxLBHy9FW8lHt_xHX-VD1qep4kqrw6P6F&__tn__=%2CO%2CP-R,10,0,positive,10
pfbid022HddZwhmcW9ZxYQuY551cNfiM5UUFKfiuVCyvMZWFogMZBBPxy1zgzaY6E7Sqfpl,NVIDIA AI,0,14,0,0,1,0,0,0,15,2,Learn from experts on how to optimize a data pipeline or use ML for anomaly detection with 15 educational sessions from #GTC23: https://nvda.ws/3NUrs1P,2023-05-11T00:00:00,[],https://external.fcai19-7.fna.fbcdn.net/emg1/v/t13/18434591278288843050?url=https%3A%2F%2Fprod2-sprcdn-assets.sprinklr.com%2F50276%2Fe7df455b-4de0-40fb-b1f5-b8c334707238-1963641077%2Fnvidia-anacondacon-virtual-boo.jpg&fb_obo=1&utld=sprinklr.com&stp=c0.5000x0.5000f_dst-jpg_flffffff_p500x261_q75&ccb=13-1&oh=06_AbEuMaLXoFcZGxyGfqdeL33SmZIKlQ2ZWeoEbem1srx9Hw&oe=64E08FF7&_nc_sid=dbad39,https://www.facebook.com/NVIDIAAI/posts/pfbid022HddZwhmcW9ZxYQuY551cNfiM5UUFKfiuVCyvMZWFogMZBBPxy1zgzaY6E7Sqfpl?__cft__[0]=AZV7OG1n85wDKhB3GAM2JT60ST5cHmOCwd1NwG7BJ74FSr0szTkm0Y93UfVCByonB-U0nOlDM4vOeixJMhOuS1keJM8XHNOeP5ioarjfvpqnGxb99Nec0_LdggT3R9Qcs4zSyOA_dRX15_PFJ35gdwwWyuFO7WxS8df7qN10AUP_bavmZsXztGgB40_1wWFSsFEM2ckZs6Ild2dRipg_hSWb&__tn__=%2CO%2CP-R,15,0,positive,15
pfbid0SkS9BmV1HDC9fi8aGxJzcKzii5n2yDkLfaLD4BcmD9Xe7MgSX6JTieHZWhZP9A1hl,NVIDIA AI,0,14,0,0,1,0,0,0,15,0,"NVIDIA Founder and CEO, Jensen Huang, will join ServiceNow President and COO, CJ Desai's keynote on May 17 to discuss #AI-powered transformation. #Know23 Register now: https://nvda.ws/3BfPa0Q",2023-05-11T00:00:00,[],https://scontent.fcai19-7.fna.fbcdn.net/v/t39.30808-6/345651551_904621663985209_1667018761928423939_n.png?stp=dst-png_p526x296&_nc_cat=105&ccb=1-7&_nc_sid=9267fe&_nc_ohc=KqJAsxp9G_AAX_zMIJs&_nc_ht=scontent.fcai19-7.fna&oh=00_AfAntCAAR_PnUwoFLUsZ-T0XM8yv11i5E_MohCqPEok_gQ&oe=64E47D9C,https://www.facebook.com/NVIDIAAI/posts/pfbid0SkS9BmV1HDC9fi8aGxJzcKzii5n2yDkLfaLD4BcmD9Xe7MgSX6JTieHZWhZP9A1hl?__cft__[0]=AZUyQhNPna-GeV7MNcceF0f3Z5G6q3NKsboj2tG6qfD_pRyjNAoaWGc0uL_sjoRofr323UNhQoBjs0_JMPO8JuKEoRdUGeMOKYZlF45-5gc67EtxlhjjQwPtPGB2i3KQ7xDDmD7m9FcD245UnOqnDnXv3IKsAPoxVHURIqFYlGDGIdZ4eLULt-B4BanqJahea60zARDsDfvuEqF14SBw75GxPTo71ryD0r9tZOSy_YqOdHNoX3j3EnpS4qjXOszX83fDK15CGzjJb6VqsjBp28FW&__tn__=%2CO%2CP-R,15,0,positive,15
1177826779550256,NVIDIA AI,0,11,0,0,1,0,0,0,12,2,"What is agent assist technology, how does it work, and how can it help improve customer experiences in contact centers? Read our blog to find out! https://nvda.ws/3AwqO2z #agentassist #transcription",2023-05-11T00:00:00,[],https://scontent.fcai19-7.fna.fbcdn.net/v/t39.30808-6/345915220_636151571232494_7176925630916068005_n.jpg?stp=dst-jpg_p526x296&_nc_cat=106&ccb=1-7&_nc_sid=9267fe&_nc_ohc=yxx3eLrrOMMAX-LU3nj&_nc_ht=scontent.fcai19-7.fna&oh=00_AfAEyoczdM54mqq5QPE-UeSQJkklbbFmS9eZqgTorbGIIA&oe=64E3C4F8,https://www.facebook.com/NVIDIAAI/photos/a.119492422050369/1177826779550256/?__cft__[0]=AZVsnf2Czrqss0psswaN3MIhKcl0e1y8IvBhdB_iVE_OjCVAvh-0zsmHKM59jhgojPt0SzjC5QCMLkiFX8oCNF-vQ54TTXmORtmrHttJHpaeTJqNdY80_6fazPacAIEpGz46pObDsUnjxcrUssLOJSqsi_VgcVLKxX9bHaoR3vt__piC72eCsjE0DSr4DEBdmwodCij6nk-RcfHMXxdDF0Lo&__tn__=%2CO%2CP-R,12,0,positive,12
1177511449581789,NVIDIA AI,0,8,0,0,1,0,0,0,9,3,"#GenerativeAI is driving transformation across financial services, including fraud detection, algorithmic trading, risk, and more. On May 25, join Malcolm deMayo, VP, Financial Services, NVIDIA at the AWS FSI Cloud Symposium in New York City to learn how financial services firms can navigate generative AI challenges and opportunities. Reserve your seat today: https://nvda.ws/3nKstib",2023-05-11T00:00:00,[],https://scontent.fcai19-7.fna.fbcdn.net/v/t39.30808-6/345289585_170170189327113_3134141414230134835_n.png?stp=dst-png_s960x960&_nc_cat=106&ccb=1-7&_nc_sid=9267fe&_nc_ohc=rmNxIDq1gBEAX_nYPHe&_nc_ht=scontent.fcai19-7.fna&oh=00_AfCh8XEEXfL1ZoZeiW42km1_vZcmxyxanr9lbKD8071ozA&oe=64E342AD,https://www.facebook.com/NVIDIAAI/photos/a.119492422050369/1177511449581789/?__cft__[0]=AZU898zKcr11h5DM1LZzXhZRbemTSv7Y4hJh-scHrpLhMZgz78ur1N3Lm_-a1oiXmt2hfS_8448wbhZNW9RqgnQ6O4gikZqpPCbO7Yw8QMAevcAi12z7bGPYL7QlTWw5p28HWg2sIHNZooJXu7CddZFue5d7wiIZmnpjmlAgtz8EnF1v6J5kddZlMqJEe0KDws03QxcR5XE0ZTTuv6JEJNMA&__tn__=%2CO%2CP-R,9,0,positive,9
1177464709586463,NVIDIA AI,0,6,0,0,1,0,0,0,7,0,"Read this MarTech360 interview with Hemant Dhulla, where he highlights the work NVIDIA is doing on #AI software including #conversationalai and how #cloudcomputing is addressing some of the roadblocks to adoption. https://nvda.ws/3LRl9t7",2023-05-10T00:00:00,[],https://scontent.fcai19-7.fna.fbcdn.net/v/t39.30808-6/346315456_6915245035171577_186571627427669922_n.jpg?stp=dst-jpg_p180x540&_nc_cat=104&ccb=1-7&_nc_sid=9267fe&_nc_ohc=C-be8sCzWEoAX8jGPnb&_nc_ht=scontent.fcai19-7.fna&oh=00_AfCYNZ3f0NlFvqCMfRkR8HvNSPwpd2goBGJuonTlEDSHmw&oe=64E495BB,https://www.facebook.com/NVIDIAAI/photos/a.119492422050369/1177464709586463/?__cft__[0]=AZXIIZOclisJ1qwyBSbHuy23qgOPuimVX-QbWoU6GKBCq6HpUJpbCiI1SjNuc5Ztq9odP3P7uNO066-CkQGeCApdbvIjFuSumiOok6GR4efFardYw5Wb7WVd17x5mlc0olfj6H6u8Fuq9bcwczk95l_BoAJafbY1mcsiPEqa3FAPBan_XOJREF3046p7q_ikQaCB8n_8mxbKGNHLzII0CRXs&__tn__=%2CO%2CP-R,7,0,positive,7
pfbid036miL8FazFiYRSn2wQYLyxoUWqZkcUsXiVAvnEkdMtwEqejXNcCkkMVkpv8hZBjbVl,NVIDIA AI,0,17,0,0,1,0,0,0,18,2,"As global #energy demands increase, distributed intelligence at the grid-edge is critical to ensure reliable and resilient power for homes and businesses. On the Li-MITLESS ENERGY Podcast, NVIDIA shares how accelerated computing is helping advance the energy transition and improve #sustainability. Listen in: https://nvda.ws/42IPNM7",2023-05-10T00:00:00,[],https://external.fcai19-7.fna.fbcdn.net/emg1/v/t13/16028270979987290424?url=https%3A%2F%2Fi.ytimg.com%2Fvi%2FQBQgx_w4_OY%2Fmaxresdefault.jpg&fb_obo=1&utld=ytimg.com&stp=c0.5000x0.5000f_dst-jpg_flffffff_p500x261_q75&ccb=13-1&oh=06_AbEgDzA50Ikbd9cpY_U4CAc1qUiAmXFeElDyqaeAcvcp2Q&oe=64E0488E&_nc_sid=dbad39,https://www.facebook.com/NVIDIAAI/posts/pfbid036miL8FazFiYRSn2wQYLyxoUWqZkcUsXiVAvnEkdMtwEqejXNcCkkMVkpv8hZBjbVl?__cft__[0]=AZUMCLUG8DiFKrQuw5Jjn4GillNMiWs--FYLj3dTFvPY8hb36QWdz1IPWpRgxF8bYC3NlpO6TBGXt9GOfd4WEtUSEn_7YHHaQyvg-R539lk-m0RqxJyDeEr8LwM24xufXlS2VK2BXGAqIRLxAABptVHlvQwuGH8db-UqiwispuTHIssjJtFbMoh21rQCW_WIZJio2NQ76jFwXOyj7z1t_SYT&__tn__=%2CO%2CP-R,18,0,positive,18
1177425769590357,NVIDIA AI,0,6,0,0,1,0,0,0,7,2,"Register for our webinar with Infosys , NVIDIA, and Quantiphi June 7 to learn how to use speech and translation AI to improve agent assist solutions in multiple languages.https://bit.ly/3n0wNcZ #speechAI #telecommunications",2023-05-10T00:00:00,[],https://scontent.fcai19-7.fna.fbcdn.net/v/t39.30808-6/344988166_585662136762213_4642989265375047470_n.png?stp=dst-png_p526x296&_nc_cat=101&ccb=1-7&_nc_sid=9267fe&_nc_ohc=dfEYjUQRbxUAX_eFV9T&_nc_ht=scontent.fcai19-7.fna&oh=00_AfA2H1YLPISFMTUsEfdixzPcdxQowBGf2saxU2ow9N-jlw&oe=64E2E502,https://www.facebook.com/NVIDIAAI/photos/a.119492422050369/1177425769590357/?__cft__[0]=AZXI2HEl6sFGrSiS4PS4cd6UFWo9NJG4ZYk4I8vrN-xwAd-ll-2_9H2TJFdW4Eq4ufnxdHuOYyNGtaH7Et06AmTY3CVFrPqPAITY2S8iFVIhLRGxxrshwMtjTByCe_eMVUv7QU0Y-AWC7ldqecZwmfXLJLpU15Us2CE9D6LpQgO18_aiAKoWCRYvgPPnkQStIIgXO3-VpWY4RhkPQ5O1Djyr&__tn__=%2CO%2CP-R,7,0,positive,7
1177390472927220,NVIDIA AI,0,10,0,0,1,0,0,0,11,1,"Discover how we’re revolutionizing AI with our AI platform optimized for Azure cloud, enabling you to build and deploy AI models with cutting-edge innovation. Read the latest blog to learn what NVIDIA will be sharing at Microsoft Build on May 23-25! https://nvda.ws/3NV0F5l#MSBuild #NVIDIAonAzure",2023-05-10T00:00:00,[],https://scontent.fcai19-7.fna.fbcdn.net/v/t39.30808-6/345263156_189934130656295_1058903371214218968_n.jpg?stp=dst-jpg_p180x540&_nc_cat=100&ccb=1-7&_nc_sid=9267fe&_nc_ohc=HUdobEINkrQAX8OTgao&_nc_oc=AQlKIdK3Itq6jTAiMf-5Oa9Ooivbaw-8Ii_f3Hi2ZnLwO3x2qpM_Rj6SvI-5ydsZJ4Q&_nc_ht=scontent.fcai19-7.fna&oh=00_AfCKaXxAmsB-UF0MNMnzSx4Vpm2-z-2JcFhFwhPeZNevmQ&oe=64E40BD8,https://www.facebook.com/NVIDIAAI/photos/a.119492422050369/1177390472927220/?__cft__[0]=AZU00CuuWZ609qfsvgsnK2Z2kaiLWx4h6fvMlQQD8hlj31j_3v_GE9zylVUjLkfWrdEyvI89k3DfYeWkGaWp2toCAA5T5HdOFcUUs70cFdjV2hTarto65z_hhVbf1fnr--0AuEsVe7ojF5s8-KWeD81Z4oj-_t1Aak8DnkGdaJpzb0GB2YuITNK6qotpYBhkbMTP3I6j3f_bGXLMMydrqbCA&__tn__=%2CO%2CP-R,11,0,positive,11
1176956652970602,NVIDIA AI,2,15,4,0,1,0,0,0,20,2," Now Available for Download: CV-CUDA Beta ReleaseCV-CUDA optimizes real-time pre- and post-processing for up to 49X end-to-end #AI #computervision throughput improvement over CPU. Download the open source library for your real-world mapping, automotive, generative AI, and image understanding use cases. https://github.com/CVCUDA/CV-CUDA",2023-08-18T01:53:46.247202,[],https://scontent.fcai19-7.fna.fbcdn.net/v/t39.30808-6/345659296_630512992436153_949695445487638955_n.png?stp=dst-png_p180x540&_nc_cat=107&ccb=1-7&_nc_sid=9267fe&_nc_ohc=01WdZ09dgCQAX8mESkJ&_nc_ht=scontent.fcai19-7.fna&oh=00_AfCU_vAnz1nTFRZBqNf0LEGPR7jfoRqNrRbsB65G_HfrCg&oe=64E45243 https://static.xx.fbcdn.net/rsrc.php/v3/yw/r/8iuTX4LlGZO.png https://external.fcai19-7.fna.fbcdn.net/emg1/v/t13/1623099203063611531?url=https%3A%2F%2Fopengraph.githubassets.com%2Fe350fb8bc923e97c098e0d037249ad2a32ab00230bb4a7e48f00ca01f0091ede%2FCVCUDA%2FCV-CUDA&fb_obo=1&utld=githubassets.com&stp=c0.5000x0.5000f_dst-emg0_p98x98_q75&ccb=13-1&oh=06_AbGAXK8lkwJsWZ2gWJYrQGv5gbR8nklxj4vYCWgfyx6Wsw&oe=64E09015&_nc_sid=dbad39,https://www.facebook.com/NVIDIAAI/photos/a.119492422050369/1176956652970602/?__cft__[0]=AZUtRSQvmWUqh6mmpcUD7uO6NGmILGEdhG6CxzYr80fi66aIKVN_G1rc58zCXTKsQhST1mAAC5aSt9XEwhCdvo8HoJrIun9nDEOTU5v274ECXs-DJmEaxM7P6f7yzSOuYFQg6irDyse-2DrA5YcIa2WRK3TMEad4IzekrwEYJRZAsmXGHq3XeKTMCrLu_xgcXp9YK-V6GdVCWInVwri7OO64&__tn__=%2CO%2CP-R,22,0,positive,22
pfbid0k4jLtjfaQYUW29MWa6VxYJEPVWVN3QC3Ke4kHegE7canbB7Cqe9mYxBd6ymLHkrql,NVIDIA AI,0,15,1,0,1,0,0,0,17,0,"Check out this new toolkit for easily developing trustworthy large language model-based conversational applications. NeMo Guardrails works with all #LLMs and natively supports #LangChain, adding a layer of safety, security, and topical guardrails to existing applications. https://bit.ly/3HfLiAz",2023-08-18T01:53:46.310490,[],https://external.fcai19-7.fna.fbcdn.net/emg1/v/t13/4762358106469486331?url=https%3A%2F%2Fblogs.nvidia.com%2Fwp-content%2Fuploads%2F2023%2F04%2FNeMo-Guardrails-KV-x1280.jpg&fb_obo=1&utld=nvidia.com&stp=c0.5000x0.5000f_dst-jpg_flffffff_p500x261_q75&ccb=13-1&oh=06_AbHGT2YOXgyfjrM1OV4F3cGIDghiA8rXLAJa0spTWo_DKw&oe=64E07CC8&_nc_sid=dbad39,https://www.facebook.com/NVIDIAAI/posts/pfbid0k4jLtjfaQYUW29MWa6VxYJEPVWVN3QC3Ke4kHegE7canbB7Cqe9mYxBd6ymLHkrql?__cft__[0]=AZWk-VGcRh7h9DydlMOc5SyrMe3iLUehv_jOnA0RY8_9qCTb2FM4crggAT8LiekuexoNYSLAUo6mcif7QqSbVXEvY7Q8sTXFNMJ25T6evXooPhBtkt8UFdLfhfhp3sk_ZOi-ez_jPOHDLEUyKMSSU7CyiAN15rPmcMZX_w-pBQMwcHfTj94G0NNfqlZRT1vjPV8x0tH-qK1BawyHUBr2YbNL&__tn__=%2CO%2CP-R,17,0,positive,17
pfbid02iyVmLw8ocPCQBiJSdcusNMipovyrsSah13WfcDNUpnCDKzaTVc8Rmp8tk1iDj5zCl,NVIDIA AI,0,9,0,0,1,0,0,0,10,1,Apache Spark has become the leading framework for large-scale distributed data processing and retailers are already using it to reduce costs while obtaining results faster. Join us on 5/23 to learn more: https://nvda.ws/3nm5F8x,2023-08-18T01:53:46.356694,[],https://external.fcai19-7.fna.fbcdn.net/emg1/v/t13/8486446806818673374?url=https%3A%2F%2Fprod2-sprcdn-assets.sprinklr.com%2F50276%2F03807e47-129f-4723-ab26-443ffda5e4a9-1753317338%2Fretail-social-webinar-apache-s.png&fb_obo=1&utld=sprinklr.com&stp=c0.5000x0.5000f_dst-jpg_flffffff_p500x261_q75&ccb=13-1&oh=06_AbHTEeB05fQIeklbKNsP3EKTZ4O7QiM3k1nrfGJkzPk2ug&oe=64E00945&_nc_sid=dbad39,https://www.facebook.com/NVIDIAAI/posts/pfbid02iyVmLw8ocPCQBiJSdcusNMipovyrsSah13WfcDNUpnCDKzaTVc8Rmp8tk1iDj5zCl?__cft__[0]=AZWFVHNMlSAfxCsXLpT2Dm7XNyHRVKbKdebLNOgCYfqJkqEuIlSrBvEDca5H3y1t-9NvQLo-172BBo8l7BRtJpWtwZSgdaPaymHNuZq6mXLkVCeq-No_zdzcG0yv02tzgS1wlAR_UNU6DrxesWdIZgl60vGqYRRqH49nvlbElFs03XTlGXswD-lBb-xtcxV0p5_XbLLp_uMmYDlGtrQeXEvh&__tn__=%2CO%2CP-R,10,0,positive,10
pfbid02JSi1bp64egjK38zShTSywpX9ujaKBvU7TDXVj44sMvcKW2hP1zefedhJV1euThPCl,NVIDIA AI,0,9,0,0,1,0,0,0,10,0,"Fintechs and incumbent banks are turning to generative AI and LLMs—powered by Amazon Web Services and NVIDIA platforms—to enhance customer experience including chatbots, digital avatars, hyper-personalization, and automated text summary and document search. Read the TechCrunch article: https://nvda.ws/3HSfths",2023-08-18T01:53:51.551416,[],https://external.fcai19-7.fna.fbcdn.net/emg1/v/t13/18266877400411826646?url=https%3A%2F%2Ftechcrunch.com%2Fwp-content%2Fuploads%2F2023%2F04%2FGettyImages-1456589557.jpg%3Fresize%3D1200%2C633&fb_obo=1&utld=techcrunch.com&stp=c0.5000x0.5000f_dst-jpg_flffffff_p500x261_q75&ccb=13-1&oh=06_AbHIAfiwrzRu0tKo-Q9BJPceXzz4XUcI26AuX7HTsWQbEw&oe=64E0587D&_nc_sid=dbad39,https://www.facebook.com/NVIDIAAI/posts/pfbid02JSi1bp64egjK38zShTSywpX9ujaKBvU7TDXVj44sMvcKW2hP1zefedhJV1euThPCl?__cft__[0]=AZXRQZ_xdQNHsKgCyYkWZLQjOBJxNXUKlB2sFS6NZn8V87nDkSrrL3ifx656y96hCkpoWYEM-QwQrYtOR2TgugrxK7RziM14dHwxYLCCw0MfH9HsRxsUADBPUMf6EfXmYwTqU9HgbpEA6vfVbQTiW7ek9oXmOFM1USM__knhrQOw0dFpEZJRpypq3d94tKljWqHne-7HK-Z8NaZvIE6OUYDz&__tn__=%2CO%2CP-R,10,0,positive,10
pfbid02zwvh7QC4ooLkgQ6v4Huq1oRVj1m4gktXuPcpnfs3cDeXfrrds9M5Jh6YWo7Tqp69l,NVIDIA AI,0,11,0,0,1,0,0,0,12,4,#Energy companies are utilizing #edgecomputing to improve data collection and analysis. Learn how Crystal Group is building edge computing solutions using the NVIDIA L4 Tensor Core GPU for #AI and machine learning-powered operations in oil and gas: https://nvda.ws/42xDq5u,2023-08-18T01:53:51.599139,[],https://external.fcai19-7.fna.fbcdn.net/emg1/v/t13/4500937347006013640?url=https%3A%2F%2Fwww.crystalrugged.com%2Fwp-content%2Fuploads%2F2020%2F12%2FIndustrial-Server-oil-1.jpg&fb_obo=1&utld=crystalrugged.com&stp=c0.5000x0.5000f_dst-jpg_flffffff_p500x261_q75&ccb=13-1&oh=06_AbGoweOV_NP_MxdOMoYGXIf0bQRjmP4sGg9_zCZaKEpVDw&oe=64E02995&_nc_sid=dbad39,https://www.facebook.com/NVIDIAAI/posts/pfbid02zwvh7QC4ooLkgQ6v4Huq1oRVj1m4gktXuPcpnfs3cDeXfrrds9M5Jh6YWo7Tqp69l?__cft__[0]=AZViUZEHAuIJRsBjk4PwKhbM-OKZh1K_DOgxd1rGHtjnBnBn68wxuDGi-gtLJMphUNLEpyb-P7GFpdYZ1ojzGWQmD_QVKPf3xd0_9wvjzIiMP9xnVwmaG3ZR3bS0zbnIAxZprkAd3rD-r0O3B6N_ymSyLlKwikB7przl1fveSBzS1SH22s7rVaJQ3BLJGIjnJx2pqTznKF_BKhPG4HDLtrH9&__tn__=%2CO%2CP-R,12,0,positive,12
pfbid02Aw4vA8oyYWUy9bXdd1d3eVVncEDEJn7xizcvUX9yrB2tPbs93X4VJA5tokRN3y2Yl,NVIDIA AI,5,36,3,0,0,0,0,0,39,3,"Join our founder and CEO, Jensen Huang, at #COMPUTEX2023 for a special keynote address streaming online on Sunday, May 28, at 8 p.m. PT. https://nvda.ws/3AtBUVX",2023-08-18T01:54:51.651332,[],https://scontent.fcai19-7.fna.fbcdn.net/v/t39.30808-6/342992621_6133605183385429_5624082612945386259_n.png?stp=dst-png_p526x296&_nc_cat=101&ccb=1-7&_nc_sid=9267fe&_nc_ohc=9qja6bRM-UAAX_l0aRJ&_nc_ht=scontent.fcai19-7.fna&oh=00_AfDcLuQZ3MwbFMkzVIzMQJzAf3c22ps4zk9hc5EBh9TGsQ&oe=64E2AAAF,https://www.facebook.com/NVIDIAAI/posts/pfbid02Aw4vA8oyYWUy9bXdd1d3eVVncEDEJn7xizcvUX9yrB2tPbs93X4VJA5tokRN3y2Yl?__cft__[0]=AZX9zA9ymDsMibJdNbBmtOQlFwBNXFtmv-bEnHDkQRH1sWXqQ6H1nl_mKNDLwWs_FVTQ4Ye2WmkLVbhlqPX4BereieCqWVa-GYf2m-9cyCpBXai2AosO_Llh1Y6E0w-AAlhhZ9s55KvGWNxAXgvCxrHgGkVthgulZcyMMkJb72Gu_wvlnPtDYbr01yAzDEzfqpIJZqody-EDRlhmF-uGFju2StjDxo-AtOaeZH5vsfUBTCO2L7_sttEiP442A2KYAKRngzL8IjICDbKoQc0FZ4WH&__tn__=%2CO%2CP-R,44,0,positive,44
pfbid0ZLT9fwBkZAo1Anct9jyVuhBJ7q8KJ1UE7UipDqtcguo2csTT7vdqQ5hv8DJD5wVjl,NVIDIA AI,0,14,0,0,1,0,0,0,15,0,"Many analysts estimate #EdgeComputing to be the fastest growing technology segment in the retail and restaurant industries.Learn how Lenovo & NVIDIA AI are helping these businesses satisfy customers, enhance operations, reduce costs, and more: https://lnv.gy/3GVZApI#ThinkInnovation #TheDataCentered",2023-08-18T01:54:57.891145,[],https://scontent.fcai19-7.fna.fbcdn.net/v/t39.30808-6/345603484_1289745241900674_7192012912909447865_n.jpg?stp=dst-jpg_s960x960&_nc_cat=105&ccb=1-7&_nc_sid=730e14&_nc_ohc=UhQCUuz-FGIAX_FxqDA&_nc_ht=scontent.fcai19-7.fna&oh=00_AfBs9vayLdFQ87DV9gVX_v-oN-iwpdRCT-CvIZwqDzuUgA&oe=64E3CDBF,https://www.facebook.com/NVIDIAAI/posts/pfbid0ZLT9fwBkZAo1Anct9jyVuhBJ7q8KJ1UE7UipDqtcguo2csTT7vdqQ5hv8DJD5wVjl?__cft__[0]=AZUEMY_OqyrdDsD7uGBumzcEXpQWTsfpx0D0ww184Jn8BtPgeDY91ipNmUO3ndrUDGBSyLktfVNmuarOjiFrD-5c40mG0AjZEACTiqddKSyLk-PQHQ_SHzN5rnBD5RVNZm7yNutEh1uatQRPhVyrS7plw1PWRc4927Bj_95sCGD3voQ5QmkghHr4B2dHs-ncSJzS_gN1rAsSVWA0MnbzkaDAow5pQvu3pqXp4MaV32b6BjFintYrzzn5cuAiONgP4GM&__tn__=%2CO%2CP-R,15,0,positive,15
1174989796500621,NVIDIA AI,0,19,0,0,1,0,0,0,20,0,"Join NVIDIA and Oracle at the Open Data Science Conference 2023 from May 9-10, showcasing demos of Stable Diffusion and NVIDIA Live Portrait. Learn about the benefits of both products in accelerating your #AI projects. https://nvda.ws/3VwNz0b",2023-08-18T01:56:57.942260,[],https://scontent.fcai19-7.fna.fbcdn.net/v/t39.30808-6/345429138_759003682488484_7220004965872944888_n.png?stp=dst-png_s960x960&_nc_cat=103&ccb=1-7&_nc_sid=9267fe&_nc_ohc=9_8Xt6iOCeIAX9mHwYR&_nc_oc=AQnaMe0AqBxzOX7Q_VIsm7oluRE7lU697Xu4PvvWp__gi4OJ_jRt2zM21QK4I0qttpI&_nc_ht=scontent.fcai19-7.fna&oh=00_AfDpETPGXSemScklNffhNihrS-bgfK12RA8ojKeCc0AtYQ&oe=64E438B8,https://www.facebook.com/NVIDIAAI/photos/a.119492422050369/1174989796500621/?__cft__[0]=AZUspyOSANBsHsJq93a6fUGrdGHKlJjshbfYt0KXNKCa6Ixek5nJQq36yzHQ-LwiDEHif8W8g-sunCa7EU7zgV3-skgZaFze-ZW7DnKcW-4-P5iLogU86wpgk_Nhq0Ahq_5OcDkDYl_weNFquicGcu5txmeOc7JGgWF0urLoAoxtReWIV3G1yWIHpx_4ETAtk6T3NEu-F8oWeb_RcmkBmydx&__tn__=%2CO%2CP-R,20,0,positive,20
1174906536508947,NVIDIA AI,0,18,1,0,1,0,0,0,20,1,"ICYMI: 3D by AI: Learn how #AI and #InstantNeRF will enable us to build #3D virtual worlds bigger, faster, and easier than ever before. Now available on-demand from #GTC23.  https://nvda.ws/40PuCqu",2023-08-18T01:57:57.997287,[],https://scontent.fcai19-7.fna.fbcdn.net/v/t39.30808-6/344326807_569993174988204_7348532493582833857_n.jpg?stp=dst-jpg_p526x296&_nc_cat=101&ccb=1-7&_nc_sid=9267fe&_nc_ohc=xbgOoSJo9D8AX-xvnVp&_nc_ht=scontent.fcai19-7.fna&oh=00_AfBTgrmYafieW4iFGGTTl8tjg8iYKd_v1pvRt5crNt1T_Q&oe=64E3ACE9,https://www.facebook.com/NVIDIAAI/photos/a.119492422050369/1174906536508947/?__cft__[0]=AZVIYymTgK-QupTcrDnQVA6c9adFFFjME5bLQSG-Wppo2Pnax21ziMFRkf226Fr6U_fQUiGkUAi0F3mlEi5w5WrKoN08bKZqV905C5OKugQDOJUwEHZ1g3GeATi1jIDySqjpja8VK-szBM5oUibvxYpPfTwVj5Th36KWm8R4FXARwxXQZOJOiktOzVeJPhKRJ8sJE_Bv1UOnH6jnKxYAUGnV&__tn__=%2CO%2CP-R,20,0,positive,20
pfbid027u8Ztsa9nCDLhrw8sKu3W6iC235gYngR37LnzA2zjXy5jGz4addW1YHnfYrJmVsQl,NVIDIA AI,0,6,0,0,1,0,0,0,7,0,Join our webinar on May 23 to learn how NVIDIA can help retailers run workloads 5x faster with up to 4x cost savings on leading Apache Spark platforms. Register here: https://nvda.ws/44tkyq3,2023-08-18T01:58:03.254461,[],https://external.fcai19-7.fna.fbcdn.net/emg1/v/t13/16011327915491933124?url=https%3A%2F%2Fprod2-sprcdn-assets.sprinklr.com%2F50276%2F6b7ca7f3-f344-4a85-b40d-faedec93f751-1753317338%2Fretail-social-webinar-apache-s.png&fb_obo=1&utld=sprinklr.com&stp=c0.5000x0.5000f_dst-jpg_flffffff_p500x261_q75&ccb=13-1&oh=06_AbF-ul5TXuqr7bpOxV1piAtB3iCIXOch1utNLkgrkrzSvw&oe=64E04B94&_nc_sid=dbad39,https://www.facebook.com/NVIDIAAI/posts/pfbid027u8Ztsa9nCDLhrw8sKu3W6iC235gYngR37LnzA2zjXy5jGz4addW1YHnfYrJmVsQl?__cft__[0]=AZVDFSYJyy-Z08tLjErhYg5M1jI7AJL9XxGV3liDvCNGVxwqDk3Ndr0Ii3M1LQ1NgE6OrYsnoJp6lKcmvG0NkN8xCpoDetm0-AnSE-r5-U99NBHYQqEksh1BALBywTEz2OuKzcDNWrICnBgjQp8EH0QsJOQGqXx_1uutQgyrvQ99-WA7ogSDJv3-1rQ7ZlD7cABGJM1CSP4ZnIvykztLSpBU&__tn__=%2CO%2CP-R,7,0,positive,7
1174472619885672,NVIDIA AI,0,15,0,0,1,0,0,0,16,1,"Learn how to port #Python data science and data engineering projects to the open-source, GPU-accelerated RAPIDS suite with minimal code changes. Watch this #GTC23 session on-demand covering practical advice on how to accelerate workloads and discussing data analytics, machine learning, and user-defined functions. https://nvda.ws/3HpBZhw",2023-08-18T01:58:03.306543,[],https://scontent.fcai19-7.fna.fbcdn.net/v/t39.30808-6/344838621_191632057068914_1282788237902146975_n.jpg?stp=dst-jpg_p526x296&_nc_cat=110&ccb=1-7&_nc_sid=9267fe&_nc_ohc=wd9JSsijD-UAX-JRPN_&_nc_ht=scontent.fcai19-7.fna&oh=00_AfDIYFC3rVJFGeDyD6kfa0Ucl2mP3vK2ZNLHHGYzvg7eEQ&oe=64E35EA0,https://www.facebook.com/NVIDIAAI/photos/a.119492422050369/1174472619885672/?__cft__[0]=AZX9qriDUqoXhL1J2hpAaF5uMJBLMUoN6_D_mGVSGvppOorJbx0KU39oJ72Sy3ehdG2H-EdRVNKfOXns8S22ei1sWdGwPcx3YKZnDjJssHMuX1INsIlMtQcd7K99dQtiOjzFMuHzwt5F6fa1pKiw_KqIqivbsK8Vk5e6v5-EMmm62WX3RK16OMXEQH8hjdkMjeLeIzz-lXkIm7VB9tdVf6KJ&__tn__=%2CO%2CP-R,16,0,positive,16
1174407029892231,NVIDIA AI,0,7,0,0,1,0,0,0,8,0,"Some of today’s most innovative and effective approaches for moving AI into production come from healthcare. Join Elekta, a leader in AI-powered radiation therapy, and Microsoft to learn proven best practices. Watch the VentureBeat webinar. https://nvda.ws/4132wYV#MakeAIYourReality #AzureHPCAI #NVIDIAonAzure",2023-08-18T01:59:03.350476,[],https://scontent.fcai19-7.fna.fbcdn.net/v/t39.30808-6/344318773_178869328438675_5434358839706786498_n.png?stp=dst-png_p180x540&_nc_cat=108&ccb=1-7&_nc_sid=9267fe&_nc_ohc=89UZNkIdZKEAX9m2UHA&_nc_ht=scontent.fcai19-7.fna&oh=00_AfBYeMt1Hr_RhUByhUs-VDvFni4ewz-EO2mr99AmkUzRPg&oe=64E4394C,https://www.facebook.com/NVIDIAAI/photos/a.119492422050369/1174407029892231/?__cft__[0]=AZV3idFbpJC6Gf6yADwnEdtwHxPHy0365TLBE0oXgiuwpXqIPraQMtNAuXVioCttC_2UV6tiUTNGWd7j4pmyrzE72Y2QtplFIK72sIiZiLlth6rzTo54f4V1N_z1moB8cpl6oF6dVpLkGhYoKtWOYdQ1Os1djajWjhPiiE7O26VKH2noKLHDGePD2CNolqHFtamVlkqHXiCn37pIMS-STLgE&__tn__=%2CO%2CP-R,8,0,positive,8
1174365873229680,NVIDIA AI,0,17,0,0,1,0,0,0,18,1,Explore the transformative influence of Artificial Intelligence on Hollywood. Join NVIDIA on May 16 as explore how to leverage generative AI in your existing creative workflows.  Apply now: https://nvda.ws/3LyOs3G,2023-08-18T01:59:08.640270,[],https://scontent.fcai19-7.fna.fbcdn.net/v/t39.30808-6/344816075_597152662357855_3563691269824426906_n.jpg?stp=dst-jpg_s960x960&_nc_cat=109&ccb=1-7&_nc_sid=9267fe&_nc_ohc=0V93vTLEH6IAX-oXxAA&_nc_ht=scontent.fcai19-7.fna&oh=00_AfCsfJKB_FRWKRMXkOO26xsdFZtCB92pt5btv2fqKLv9iA&oe=64E2C0FE,https://www.facebook.com/NVIDIAAI/photos/a.119492422050369/1174365873229680/?__cft__[0]=AZWw1xtSSr0epH1I9PWx3lbNQAocR8Gt0SfyIwXpi6XMkL1Us_xerEqoQS7uUuTmRiNANh7lzvYra8S6CIQ-7fJl2fMowkyLP8-df9UNlCKlefGG2Ta2ypwMYSJEZh-DIWeU209DMq5jR6bE9ccQcyKcxzawS1BBdBxXhYkl0PUGfkEGyv-khughezXL4IpB2eilZEeK-jN8j7wEXB_DyKNE&__tn__=%2CO%2CP-R,18,0,positive,18
pfbid097MV5B8JKAFW8bEh5sn7RkcsF7Qd4aWcbXspoRzzAvNQ22vaqw4FME5uM61HB78Tl,NVIDIA AI,0,8,0,0,1,0,0,0,9,1,Learn how Notch is using the NVIDIA Maxine #AR SDK for real-time #AI face tracking to create captivating performances with live video effects.,2023-08-18T01:59:08.687820,[],https://external.fcai19-7.fna.fbcdn.net/emg1/v/t13/11744173582234171577?url=https%3A%2F%2Fprod2-sprcdn-assets.sprinklr.com%2F50276%2Fdb82ac11-6553-4c39-8fe4-7149885c745c-473213664%2FNotch_Maxine_2D_6.png&fb_obo=1&utld=sprinklr.com&stp=c0.5000x0.5000f_dst-jpg_flffffff_p500x261_q75&ccb=13-1&oh=06_AbEU1ZOjh0Xw8gv620otxiHy8fXxxtM4m9E5puNLxdxVFw&oe=64E02912&_nc_sid=dbad39,https://www.facebook.com/NVIDIAAI/posts/pfbid097MV5B8JKAFW8bEh5sn7RkcsF7Qd4aWcbXspoRzzAvNQ22vaqw4FME5uM61HB78Tl?__cft__[0]=AZXIxVZ2FfwBCaY6BXthfh0BuTVaSuaYccyixNLIG7ZFAfNa54JEktL3TDTHxIU0OGdiKsgs4UeplrARZg-0xRTdbjfNiqTd5R9MZnr-r8AbxtS3ua1yDG0FrqG2gIzv0OYEB_2gBxAQLR8u06A3I1vZwaLpb1lW68zbAIp_xttaKjJ32FN1TKSnLIv3tguR5s79VcCVILNIHdCOepAxlVPB&__tn__=%2CO%2CP-R,9,0,positive,9
pfbid0VfATctYocNHXwRMNB1m6pRWFSySU7B21yVoXDbsXtqjbBzm8a1VzuU4TULktGgRcl,NVIDIA AI,0,15,0,0,1,0,0,0,16,0,"Understanding the performance of your #ROS 2 application is an essential step in building better #robots. ros2_benchmark, launched with the latest Isaac ROS release, is the ideal tool for this measurement and is available now in #opensource. Join us in this technical webinar to learn more > https://nvda.ws/442ejcr",2023-08-18T02:00:08.765209,[],https://scontent.fcai19-7.fna.fbcdn.net/v/t39.30808-6/343324475_1882613782108560_4122941263097658817_n.jpg?stp=dst-jpg_p526x296&_nc_cat=108&ccb=1-7&_nc_sid=9267fe&_nc_ohc=9VH9iQuluEgAX_vxdM6&_nc_ht=scontent.fcai19-7.fna&oh=00_AfD2F63m5e9UWqbJv2qbtPAJ-Q-tVTFOdKeXAE9xYjcLlg&oe=64E35F4F,https://www.facebook.com/NVIDIAAI/posts/pfbid0VfATctYocNHXwRMNB1m6pRWFSySU7B21yVoXDbsXtqjbBzm8a1VzuU4TULktGgRcl?__cft__[0]=AZVljycCeOBz_Zk-dMBet1qtVc5C5rqbuD-Qxwa5tqr0Xo5_TX_8S87F5mpdTElGDehK-VUHy4wIgU6Bon9w3pttJyXgpJpFDPaMHimTNWBD6s1W0ghSv2HmDIjDEagRcLdVpoVNJ0R23-kImV7XSqId__IwQ0ANSLNbKx7bYtLU76gtyvWAYCRgLzf244uESkAnq-2kjt4q9ZFDQ955Db5USawZ_OYaE47kOpFUtkYP9DxJVlOwxcoC0elReNZfgKSMYP2JumVMQb1PL0N2so7U&__tn__=%2CO%2CP-R,16,0,positive,16
pfbid034ookRdkx8Gewx4MLzAmoELycKwjtQ5RXmyeJ5udvU6jRzJhRojDUUMMBicnBKPmwl,NVIDIA AI,0,8,0,0,1,0,0,0,9,1,Is your startup developing an edge AI solution? Join NVIDIA Inception to supercharge your deployment with NVIDIA Jetson Orin devices. Members get an exclusive deal on Jetson Orin Developer Kits.Already a member of Inception? Reach out to your Inception partner manager to learn more about the offer. https://bit.ly/3UCtJjo,2023-08-18T02:00:15.020543,[],https://external.fcai19-7.fna.fbcdn.net/emg1/v/t13/16237004932187090673?url=https%3A%2F%2Fprod2-sprcdn-assets.sprinklr.com%2F50276%2F3b2210ab-18d0-4717-8b24-5e60dba14999-617097148%2Fdli-social-jetson-orin-dev-kit.png&fb_obo=1&utld=sprinklr.com&stp=c0.5000x0.5000f_dst-jpg_flffffff_p500x261_q75&ccb=13-1&oh=06_AbEROlKGrGpP7aNIJuTgy1muSBYSO0FNLZvwYJKnAT4NeA&oe=64E0159F&_nc_sid=dbad39,https://www.facebook.com/NVIDIAAI/posts/pfbid034ookRdkx8Gewx4MLzAmoELycKwjtQ5RXmyeJ5udvU6jRzJhRojDUUMMBicnBKPmwl?__cft__[0]=AZUeOU78NQ1PVVlXvzbbnVWAYlEQPWCHgkKFi55W4kDHfPqWlfrh5OWKxD_kaZ0TvYZjztBaR49KyUnx5vl4uhehtxOloJWCE6Ng35L4TLF30FNuPkiiKbNcex-xEoOGAIAsw5qecSjC46LXgC6b4JrOD4qW4FhfNjgnqjfOBZ61EpcHOI0j7oDul2a2nLuGaEC7_a1mBb8KYv7nv-fgbmlR&__tn__=%2CO%2CP-R,9,0,positive,9
1173812319951702,NVIDIA AI,0,9,0,0,1,0,0,0,10,0,"Join @Infosys, @Quantiphi, @Talkmap, and NVIDIA on May 31 for a live webinar to learn how #telecommunications companies are using #AI to improve operational efficiency and enhance customer engagement. https://nvda.ws/3L98Fwz #speechAI",2023-08-18T02:00:15.065901,[],https://scontent.fcai19-7.fna.fbcdn.net/v/t39.30808-6/344835303_166430926375330_2425582259708303040_n.png?stp=dst-png_s640x640&_nc_cat=101&ccb=1-7&_nc_sid=9267fe&_nc_ohc=YUvygPQVul8AX9DHbvr&_nc_oc=AQla31H43drOxdSWGvmH9g2FRe_j4x1_rybckGvhnw7ULwrI9ifhzk6xdm3TfHoxwEw&_nc_ht=scontent.fcai19-7.fna&oh=00_AfBCtlNbvP6MlGNT415ZVWJADrHlRmEvCzOew_H3JdElhA&oe=64E3DB6B,https://www.facebook.com/NVIDIAAI/photos/a.119492422050369/1173812319951702/?__cft__[0]=AZUzQGk6yWawpySEcmGB5WyADu6Y8ToErO6n5rIEpvfLB9tIRjr5WFW0HZFkfTdXe-lMANXdxKNa7h-YuDIne4wccaO0Sb3DXMd1uv3ncoH7kS8Xadep40vRuKkiZJIaspryn332h86TvYP0QlXveGvFOXAmQSsrz101ul9pTlAnZeE0w9xGMrgfrrmjV1XDvNSxJzaoaeMRgJKYv8-XFEic&__tn__=%2CO%2CP-R,10,0,positive,10
pfbid0LSMyTfFZE1hg9xagCQvxehhFdXyPmhfC42YBeZkGJMNNJ6U61SoLNQx1qx8Xqfx5l,NVIDIA AI,0,15,1,0,1,0,0,0,17,2,"Exelon, the largest regulated electric #utility in the US, is using #NVIDIAOmniverse to automatically create 1000's of grid asset defect examples for real-time drone inspection models—enhancing grid reliability and resiliency. Learn more: https://nvda.ws/3VmleJR",2023-08-18T02:00:15.119091,[],https://external.fcai19-7.fna.fbcdn.net/emg1/v/t13/1301368489097844436?url=https%3A%2F%2Fdeveloper-blogs.nvidia.com%2Fwp-content%2Fuploads%2F2023%2F04%2Fexelon-sdg-utility-poles-featured-image-copy.jpg&fb_obo=1&utld=nvidia.com&stp=c0.5000x0.5000f_dst-jpg_flffffff_p500x261_q75&ccb=13-1&oh=06_AbFiFlWU9FgtN46XcjLZ0dEEfRHdQrdPkJOZSWfY0UkW3A&oe=64E01929&_nc_sid=dbad39,https://www.facebook.com/NVIDIAAI/posts/pfbid0LSMyTfFZE1hg9xagCQvxehhFdXyPmhfC42YBeZkGJMNNJ6U61SoLNQx1qx8Xqfx5l?__cft__[0]=AZVU-3v1Efg_3MWJVbj5Jk9Im6uOUK9_XnEqCft0wWQXEIZD8l8Q_rA0ff_y_25YJ-Xg4H13iLxQ6iT4y06vEI6foYOi0KOue9Rojl4gTVcoxldxm7Xvx88qb5-vYB2ssq7K3hAn11q5WPQTmGRgXIS0jVf4SWwyuNdUSPd9F9ZR0owjOhDUuR3w33z_MTask9kd5UYZaCXCdVDnEUrJZzSp&__tn__=%2CO%2CP-R,17,0,positive,17
pfbid02VV1KYpTbqqrWnMabe29MGoP55sMSM5UdJgKomU9nUZv9jkJ8tkWFLM5XVCR1B4T2l,NVIDIA AI,126,118,21,21,0,0,0,0,160,16,"From interactive hair simulation to an #AI system that can auto-generate realistic 3D character motion by watching 2D videos, check out the 19 papers from #NVIDIAResearch accepted into #SIGGRAPH2023. Read the blog with links to each paper: https://nvda.ws/42iqxwc",2023-08-18T02:01:21.384656,['blob:https://www.facebook.com/cc09f3f1-016d-4cee-bc10-0a1f1df0ba05'],https://scontent.fcai19-7.fna.fbcdn.net/v/t15.5256-10/344567447_959278011755502_4906067130839621550_n.jpg?stp=dst-jpg_p180x540&_nc_cat=108&ccb=1-7&_nc_sid=ad6a45&_nc_ohc=x0VOtoI5tw0AX-r-EOG&_nc_ht=scontent.fcai19-7.fna&oh=00_AfD9ygeLaaqzvMZMI-59bFaNiZKcNvba_SvyRUDoL7CXaA&oe=64E2F5DA,https://www.facebook.com/NVIDIAAI/posts/pfbid02VV1KYpTbqqrWnMabe29MGoP55sMSM5UdJgKomU9nUZv9jkJ8tkWFLM5XVCR1B4T2l?__cft__[0]=AZVNsSDWZ2OI_cg7FzXvxLg9L5kKmiwBqcfcZGKfmTgTq2E9lqLYP7Ed_PNJ27IoB9XqemB3hAsJ5Eve2i1uaBm1r9reeob7HvyJXzjzX_zAmOTqRomyn5p8m0UBUgQc8c1w0Jsscevn3qojM0v79YEWwG2A_71nCQuw0VNNnIm3rNXPOZnJklXjI2XDQ5Yusbb6dn9bqwkRkCmdzc1N-X5hRdBlv2bv9AaAGLZLik_MCw&__tn__=%2CO%2CP-R,286,0,positive,286
1173293860003548,NVIDIA AI,0,14,0,0,1,0,0,0,15,0,Delve into how #telecommunication industry leaders such as AT&T and T-Mobile harness the power of #speechrecognition to deliver unparalleled customer experiences in their call centers.https://nvda.ws/3VbNw9N  #speechAI,2023-08-18T02:01:21.439106,[],https://scontent.fcai19-7.fna.fbcdn.net/v/t39.30808-6/343669094_239648018742574_8867124185273015755_n.jpg?stp=dst-jpg_p180x540&_nc_cat=104&ccb=1-7&_nc_sid=9267fe&_nc_ohc=8WV8ANOULwoAX943CYK&_nc_ht=scontent.fcai19-7.fna&oh=00_AfCaf4jZzsfP7_KwjvZuiuaYeV7IsIbXelsPmkETtylz7Q&oe=64E38C90,https://www.facebook.com/NVIDIAAI/photos/a.119492422050369/1173293860003548/?__cft__[0]=AZWEZZf4Fl9vCW51ZSabYrhbuCkUzMnZZUpYpfwm2lJpL4bJj_HIfSJI6O4lrkdPuXBaeHA70UuFSHIj1bGOzwqSsrmkYHnqDi2I8V15zN6PJ-PWU62LCoLhPuSvtm4-HISpN8IvIjcmkhkgkEfoId40d_rWvZPq51_qeSb1n_JbPC6Tx8YJuaXEAwf1XKhmbwtuw_PqblJFTlioq0NUHwuS&__tn__=%2CO%2CP-R,15,0,positive,15
1172866793379588,NVIDIA AI,0,11,0,0,2,0,0,0,13,0,"Domino Data Lab is helping #energy companies, such as AES, deploy enterprise #AI and ML with automated DevOps, a shared platform, and standardized workflows to manage models. Read the solution brief: https://nvda.ws/3nltxc4",2023-08-18T02:01:21.496386,[],https://scontent.fcai19-7.fna.fbcdn.net/v/t39.30808-6/344432492_193721090190095_4947870995355301495_n.jpg?stp=dst-jpg_p526x296&_nc_cat=108&ccb=1-7&_nc_sid=9267fe&_nc_ohc=jXayvCVE6hEAX-7aLb9&_nc_ht=scontent.fcai19-7.fna&oh=00_AfDJVonQ_QY3LgjcFONwSd3HW4x3tTV5w0mc6EMA3we0sg&oe=64E2F422,https://www.facebook.com/NVIDIAAI/photos/a.119492422050369/1172866793379588/?__cft__[0]=AZVMajIXX07biD0CQ9LU0KFD5vF_R-Oe14Hi-Vwr6ALFwHMqvpbUhOEYPOYVRVsisOw3PDcTQYfAZWS6tMv2WErEmpcbtPUrXdQ2YEhzsrgXewNqrPuPyRQ7jw1fmwyUWQFW7yLe9UyDLtbBJ23O_6xzYGlwBnQEWDUo92lArD9BxoG0kJqF-shABdsskj1lnYn0C-rQ3rG8ezSWPAS3lkum&__tn__=%2CO%2CP-R,13,0,positive,13
pfbid078TvMy9PfnPr4knB7TsHaKtBGPiKk1uZH34FkRdzYonVrgHXhXdzvpag2wHNsAKyl,NVIDIA AI,0,23,0,0,0,0,0,0,23,0,Calling all #roboticists! Please share your feedback to help us understand how you use #IsaacROS now and how we can improve it in the future. Every valid entry will be entered into a raffle to win an NVIDIA Jetson AGX Orin Developer Kit or Jetson Orin Nano Developer Kit. https://nvda.ws/3Azyv8k #GoROS,2023-08-18T02:02:27.870611,[],https://scontent.fcai19-7.fna.fbcdn.net/v/t39.30808-6/343933330_1671194386635696_7595919662183146947_n.jpg?stp=dst-jpg_p526x296&_nc_cat=103&ccb=1-7&_nc_sid=9267fe&_nc_ohc=UcJfB97o414AX_wX5v3&_nc_ht=scontent.fcai19-7.fna&oh=00_AfCA4T0CcSqLS11HH7Wu-3UbukAw2_NQw64Tdkk0xJDh8A&oe=64E46A2A,https://www.facebook.com/NVIDIAAI/posts/pfbid078TvMy9PfnPr4knB7TsHaKtBGPiKk1uZH34FkRdzYonVrgHXhXdzvpag2wHNsAKyl?__cft__[0]=AZVzZfxYf9wKO9q6DvLS4siQBpVGwhCONgE5eQE65QyyoiKk8B0RjzmHAhoNQaAj3318zALGJZ_HNypVHLn2OfY3nnPUuK-eXzSy_Hqk2QsrDktL_0UKFVdPXw-OjMD8f3KO8NrbuMGDcoBiYwfTEYR-ZNLSkO4FHnWpCNy_1jucLyrToF4qIrqN8sFU7hs-bVysB9YOaMf58I_4Sqg2Twq0sm4FfYCfvmiRzOmwM9uvb7d5SpD1DSUPuytRcWJO-hqc4lQGJuziZVr-7hcIMOZA&__tn__=%2CO%2CP-R,23,0,positive,23
pfbid02nbqQdGkjehr59jbJpKmNZu73EA9mfMEkZKo1ra7Dy5LQQAfNTH3ii5XmTtQ3UqPql,NVIDIA AI,0,5,0,0,1,0,0,0,6,0,Watch this on-demand session to learn how T-Mobile is scaling #speechtotext in their call center. https://nvda.ws/3VpQI1x #speechAI,2023-08-18T02:02:27.919995,['https://video.fcai19-7.fna.fbcdn.net/v/t42.1790-2/343514046_181410608171843_5026636125926834022_n.mp4?_nc_cat=110&ccb=1-7&_nc_sid=985c63&efg=eyJybHIiOjMwMCwicmxhIjo1MTIsInZlbmNvZGVfdGFnIjoic3ZlX3NkIn0%3D&_nc_ohc=Z1xZR426hvkAX8G-Rcs&rl=300&vabr=75&_nc_ht=video.fcai19-7.fna&oh=00_AfDKVvLWp0j3howT5lWVxK__-2KyIePAFSaCcMvILi7raA&oe=64E306F8'],https://scontent.fcai19-7.fna.fbcdn.net/v/t15.5256-10/343755321_552270163725828_3204589322576983303_n.jpg?stp=dst-jpg_p180x540&_nc_cat=108&ccb=1-7&_nc_sid=ad6a45&_nc_ohc=IZqt0fk2ajsAX_yDVGC&_nc_ht=scontent.fcai19-7.fna&oh=00_AfC0oU8MI8_cs5q6koOJosntRylu_u6zfzMCjphoYvK_tQ&oe=64E3C499,https://www.facebook.com/NVIDIAAI/posts/pfbid02nbqQdGkjehr59jbJpKmNZu73EA9mfMEkZKo1ra7Dy5LQQAfNTH3ii5XmTtQ3UqPql?__cft__[0]=AZVGufzKJufoa3PaOwsG5PKgab1IyM-Qa4ETgNlSe_6NR9Vseqy3XWr-QO_yuOBXfnY_VYM73M2-Eeenr9wf8N3WywNpmiwYejTNdu-ojIVBurasqUq_rFPOtLh40LxqB76dP9AZRDHr2PYTKIHnrt2FLlmEuypVdeI36R7UQVtfBjkc9uOigyzbKTVH-d-WscBeR3wOLmRTmiyuDPUPRH-wkfh_mbE3kpDmAXINNFLtUw&__tn__=%2CO%2CP-R,6,0,positive,6
pfbid0kWqDPB3iHdm5WdGH8sQyu7jUnRCZJR8sCvwrJj8TFog57qEJgn9FXn4CR35HVkdWl,NVIDIA AI,0,13,0,0,1,0,0,0,14,1,Looking to maximize the quality and performance of #AI applications with NVIDIA GPUs?Learn how to transition from FP32 to FP16 in part 7 of our end-to-end AI blog series: https://nvda.ws/3HkmNSG,2023-08-18T02:02:27.978802,[],https://external.fcai19-7.fna.fbcdn.net/emg1/v/t13/10547519496460092007?url=https%3A%2F%2Fdeveloper-blogs.nvidia.com%2Fwp-content%2Fuploads%2F2023%2F04%2Fproviz-dev-aaai-featured-image-part7-1920x1080-1.jpg&fb_obo=1&utld=nvidia.com&stp=c0.5000x0.5000f_dst-jpg_flffffff_p500x261_q75&ccb=13-1&oh=06_AbEmcQPyjIO5yH9GPIbS5Hp5ptCgZbrVSGP4vV0thfZUzw&oe=64E00126&_nc_sid=dbad39,https://www.facebook.com/NVIDIAAI/posts/pfbid0kWqDPB3iHdm5WdGH8sQyu7jUnRCZJR8sCvwrJj8TFog57qEJgn9FXn4CR35HVkdWl?__cft__[0]=AZX8ewK6bAeHD7dvos_2hIHlvUB4NcyQU2C3mWY1zQaxSeKCQQYeKJT-pCagwTrQpGoYj0v4Z8jtgVF9VzBIkQ-QwjloEiQazCrWLN-E_1Eknw7s3TRh_f-nkODYt1eeqzGK9uBqVfZFKGe2t9fsVW68Zh6c9h2nBsvqAmrLPypJF590DmpZsKzZaMycXtVTY4LcQpKrJgdgd6Pi55mvQaHq&__tn__=%2CO%2CP-R,14,0,positive,14
pfbid02RbGaj94YjsjQZe4kHrtBwuJ9dvt6Bstuqb5qy6vG2hU13bkpE6T3cCPv31wsErR2l,NVIDIA AI,0,10,0,0,1,0,0,0,11,2,"From AI to the metaverse, this playlist of Top Developer Sessions from GTC 2023 has it all. Don't miss out on the chance to learn from some of the brightest minds in tech. https://bit.ly/3UQRvse",2023-04-29T00:00:00,[],https://external.fcai19-7.fna.fbcdn.net/emg1/v/t13/2092180741693131214?url=https%3A%2F%2Fprod2-sprcdn-assets.sprinklr.com%2F50276%2Faf44bd93-b14b-47da-b4a6-19b5bc1dbdf9-603866279%2FCopy_of_dev-programs-gtcs23-so.jpg&fb_obo=1&utld=sprinklr.com&stp=c0.5000x0.5000f_dst-jpg_flffffff_p500x261_q75&ccb=13-1&oh=06_AbEzyqItcTWLoSutNAzwA_LRmbGoKWPyl2bs8uEkiUbBWg&oe=64E02BDD&_nc_sid=dbad39,https://www.facebook.com/NVIDIAAI/posts/pfbid02RbGaj94YjsjQZe4kHrtBwuJ9dvt6Bstuqb5qy6vG2hU13bkpE6T3cCPv31wsErR2l?__cft__[0]=AZWW2AQv2ZZ-IycearczBEEbhNXb5RtxCED-Fnf-4_onsUvHoYEFBsaEGB5neFi5iz5dmKbYxGfBhVFkkudpi0dUun3oEYnaWI9FgpPk4eF-jJ6Aa71HCwcwn2edTOLy7cwjlL5djSLLvz5HhwdkJweQh59CzDHoEnOLr1TRMC-yjI5PG6gEBSukl21K-oqev_h43RRNqavgQ2NQfVMgifIV&__tn__=%2CO%2CP-R,11,0,positive,11
pfbid02djZkS9M7oEEjds6b2yD2xV1UdKHFhPDMSoa3Nv7YYpHS1pNnVarke8CcbLxRCwFtl,NVIDIA AI,0,7,2,0,1,0,0,0,10,2,"Learn how TempoQuest, Inc. leveraged accelerated computing from NVIDIA on Microsoft Azure to move the traditional Weather Research and Forecasting (WRF) software to #GPUs, enabling faster predictions of power generated by renewable wind and solar resources: https://nvda.ws/429QVIz",2023-04-29T00:00:00,[],https://external.fcai19-7.fna.fbcdn.net/emg1/v/t13/8698427877721925397?url=https%3A%2F%2Fdeveloper-blogs.nvidia.com%2Fwp-content%2Fuploads%2F2023%2F04%2FMicrosoft-and-TempoQuest-Accelerate-Wind-Energy-Forecasts-with-AceCast.jpg&fb_obo=1&utld=nvidia.com&stp=c0.5000x0.5000f_dst-jpg_flffffff_p500x261_q75&ccb=13-1&oh=06_AbEa4YxX3jHhUJJeJT1bqLboWJi2klCvevYBwgG1o3We6Q&oe=64E09B4E&_nc_sid=dbad39,https://www.facebook.com/NVIDIAAI/posts/pfbid02djZkS9M7oEEjds6b2yD2xV1UdKHFhPDMSoa3Nv7YYpHS1pNnVarke8CcbLxRCwFtl?__cft__[0]=AZUr0LV7-hIMvw5ya7XK_lx93s7YeqDCslWyObUmcKoaVpH1c2FHaNs_lPUhj2uEOpYD9d79Ix_fKfKgaC1u2muBBk_PvgsVPNiGOLXaYg1JXAbPCKUeJ5cq7I7TP8YrqdOmDeFpKhhFu2slLjaUKNRqX35eK3UrkpdKFyr0yf6Myj9A3w6FA9wsPudP2Yb0x9RpJpmOqy_3Z8jPY3jmXTVJ&__tn__=%2CO%2CP-R,10,0,positive,10
pfbid0p4Fo1A4giEV5kdYbMd7XPEvdrpsuvP1hZ5Hc4zMZvZptbLztTEGmbUFgBqU5Rv2Al,NVIDIA AI,0,14,1,0,2,0,0,0,17,1,Interested in learning how to propel your AI #startup? Advance your solution with these top #GTC23 sessions for #startups. Watch now: https://bit.ly/3KWQqun #NVIDIAInception #startups,2023-04-28T00:00:00,[],https://external.fcai19-7.fna.fbcdn.net/emg1/v/t13/3380803190526973007?url=https%3A%2F%2Fwww.nvidia.com%2Fcontent%2Fdam%2Fen-zz%2FSolutions%2Fon-demand%2FNVOD-OG-TWITTER-image-1200x630.jpg&fb_obo=1&utld=nvidia.com&stp=c0.5000x0.5000f_dst-jpg_flffffff_p500x261_q75&ccb=13-1&oh=06_AbHWn9PHvKUJQwCuoopwoDMEbKo3Ty9QR8G0vHd40UZM-w&oe=64E04090&_nc_sid=dbad39,https://www.facebook.com/NVIDIAAI/posts/pfbid0p4Fo1A4giEV5kdYbMd7XPEvdrpsuvP1hZ5Hc4zMZvZptbLztTEGmbUFgBqU5Rv2Al?__cft__[0]=AZXJ6HPAc1hr51K2Dy2y1kaloZ8k-REXCjvcZIU9LADpVtmy4igz9RRknTXeJQZIISMH_JBjieYWJEI6EmDSwBkTigCQ01qA5YuZVMxOGw2VZq7AfdhaB5zspumo1p288XJH9QSWkPExWVFYoYlHUv_XHNhj3z9y8BhiqVzJlzuJ2I7OjaRilT_MyhHju7nBgdDR6-8JTLbHa3vxiKO5T0lL&__tn__=%2CO%2CP-R,17,0,positive,17
pfbid0c4G2PZ8zDDvgidKxjgxYMQ3X9FcGUo5ZnaXb4RZYkeASNijAAhQ2VMTKbLthsCfrl,NVIDIA AI,4,15,2,0,1,0,0,0,18,2,"#NVIDIADGX H100 is an #AI powerhouse that lets enterprises expand the frontiers of business innovation and optimization. The latest iteration of NVIDIA’s legendary DGX systems, DGX H100 is powered by the groundbreaking NVIDIA H100 Tensor Core GPU. Learn more about the gold standard for AI infrastructure. https://nvda.ws/3LCYGBn",2023-04-28T00:00:00,['blob:https://www.facebook.com/cf6a3538-ee78-400f-b579-1dd5af00c54b'],https://scontent.fcai19-7.fna.fbcdn.net/v/t15.5256-10/341336143_564371885803456_8116890530335002653_n.jpg?stp=dst-jpg_p180x540&_nc_cat=103&ccb=1-7&_nc_sid=ad6a45&_nc_ohc=UDUxZck-Uf0AX-J_Pmc&_nc_ht=scontent.fcai19-7.fna&oh=00_AfD8gZq4QckbJs2CUgfOB5cQC6ZN1fa1n145wGtdXZvS3g&oe=64E42782,https://www.facebook.com/NVIDIAAI/posts/pfbid0c4G2PZ8zDDvgidKxjgxYMQ3X9FcGUo5ZnaXb4RZYkeASNijAAhQ2VMTKbLthsCfrl?__cft__[0]=AZXTQDhBxYMLTDCRXCVE3dpPTPq0E22pPLYvfkvBEhJhdL_SnzVnJKPJadooGllrDCJyRvNbzBdfoahXhOfP8r6kC9W1umeS2eJvzp0sJjQTpYCIa9aqZabj_qd4qJjTHBzFRBYlVJg3HR6zJQoLMdCU-5XiJjuivJgUocB_RyUBCX3p7jOBO8FOOQ6UP71WPRpbcB1jZeTNFXOfhYYqxAm3Nl4CicreEBk1fFMQD96Qse_FdnrPt3f_5qErojxVcuo&__tn__=%2CO%2CP-R,22,0,positive,22
pfbid02btRtU6K7E1nY1eq668pnNM2ghvg9MKDPRsbHbF41TmzAxMBAERPhZPoMwz9WZDWhl,NVIDIA AI,7,10,0,0,1,0,0,0,11,1,"Take this self-paced DLI course and learn the basic concepts, implementations, and applications of graph neural networks. Be able to build and efficiently train GNN-based models. Enroll now: https://bit.ly/3NfIOWA",2023-04-28T00:00:00,[],https://external.fcai19-7.fna.fbcdn.net/emg1/v/t13/3924176094016001429?url=https%3A%2F%2Fprod2-sprcdn-assets.sprinklr.com%2F50276%2F0b9f8544-4f24-4254-8a7e-336017ccc4bf-476299824%2Fdli-gnn-course-social-li-tw-20.jpg&fb_obo=1&utld=sprinklr.com&stp=c0.5000x0.5000f_dst-jpg_flffffff_p500x261_q75&ccb=13-1&oh=06_AbHYXgcM-Lu4HXHizN5CBOKiwze37CrL4q5QNM6-sVZxlA&oe=64E01752&_nc_sid=dbad39,https://www.facebook.com/NVIDIAAI/posts/pfbid02btRtU6K7E1nY1eq668pnNM2ghvg9MKDPRsbHbF41TmzAxMBAERPhZPoMwz9WZDWhl?__cft__[0]=AZWfySGh1vQjUiQFKMTfsAkWpJimu_m91QmI5JBjJgPfe3uGaHQoa7HI0p4HhHpKa3g-XJo1Q10XJKpINkHpROM7hIjZUgsZ3Xix4gXgvUSPC7jTdST23qqmqyMAONdRMb-6NhFLHIvzqDx-YkrssY9NUwUt_NXFLU5yVLC-_jqDDYLuaw6RXfw48nsWqZt2l-nvZaZ44_7XCF0eWOcBu5UF&__tn__=%2CO%2CP-R,18,0,positive,18
pfbid0WB63wez9pnVnh2LsJAYfuZ1TUysyivzyiGR4REFLj2jNfznWnuh3d6W4bJiY3gSHl,NVIDIA AI,0,6,0,0,1,0,0,0,7,1,What is p-tuning? And prompt engineering? Why should I use a large language model? This blog answers these questions and more. Check it out: https://nvda.ws/3oGmOKd,2023-04-27T00:00:00,[],https://external.fcai19-7.fna.fbcdn.net/emg1/v/t13/7259010481539387352?url=https%3A%2F%2Fdeveloper-blogs.nvidia.com%2Fwp-content%2Fuploads%2F2023%2F04%2Fllm-social-working-with-llms-2694250-1920x1080-1.png&fb_obo=1&utld=nvidia.com&stp=c0.5000x0.5000f_dst-jpg_flffffff_p500x261_q75&ccb=13-1&oh=06_AbEScSTa4rajdhdTsIAw_2Cwa6GrxGcYdGrDXYfRY4axEQ&oe=64E02A16&_nc_sid=dbad39,https://www.facebook.com/NVIDIAAI/posts/pfbid0WB63wez9pnVnh2LsJAYfuZ1TUysyivzyiGR4REFLj2jNfznWnuh3d6W4bJiY3gSHl?__cft__[0]=AZXw-kkaOdPN7_yyp1be7kYizDcx1L7BXA_klMyLjaALBA4T6VpusHF9q-KF3rM6uh0rBZMAX1E18_IrpO0p-FmJRAzaLYMVzgYqqMSytC4BWxbPyg9IQboNT0Mt5GMnSRR-A3STebAKF23btTMJMBaay09adSVGOx1HucHa4hbYwWRZZndCrMknkKxLXNjImo1HFavBW9Db__a93rDG0WdB&__tn__=%2CO%2CP-R,7,0,positive,7
1170666623599605,NVIDIA AI,0,16,0,0,1,0,0,0,17,2,"What is agent assist technology, how does it work, and how can it help improve customer experiences in contact centers? Read our blog to find out! https://nvda.ws/3HfYqp8 #agentassist #transcription #NVIDIAInception",2023-04-27T00:00:00,[],https://scontent.fcai19-7.fna.fbcdn.net/v/t39.30808-6/343561521_257514210169526_1048841018385136533_n.jpg?stp=dst-jpg_p526x296&_nc_cat=101&ccb=1-7&_nc_sid=9267fe&_nc_ohc=tB55Wy-INIoAX9Oby61&_nc_ht=scontent.fcai19-7.fna&oh=00_AfDtv3Fc3qsga8C5MCuFkZd-peWLyzb801_h9pASPR2zEg&oe=64E2B344,https://www.facebook.com/NVIDIAAI/photos/a.119492422050369/1170666623599605/?__cft__[0]=AZWcJz7nufZZHicapb2Pff8bimB3epTvjhfwMEUYKBTDzDKC25GqZd7rbK3VxKRFsu8Tavo1YljOKguA6bxRyxYWmLqBi-vKY1Swqsnoi3Fz5wTzL_FQF10NQcgs_R1INoKjuPe7Y_w34AnZzfFViBRUDCj5ip9i2FxaNX7SX8ojfZoItA_qzh1nyTTNtPQPMpTQFRX_RNkPSh9VnzwLfCPo&__tn__=%2CO%2CP-R,17,0,positive,17
1170621520270782,NVIDIA AI,0,19,0,0,0,0,0,0,19,1,"NEW Omniverse Teaching Kits are specifically designed for college and university educators! Get access to the latest tools and technologies for teaching cutting-edge courses in a variety of disciplines including Digital Humans, Industrial Metaverse, Architecture, Engineering, Construction and Operations (AECO), and Media and Entertainment. Join today: https://bit.ly/3Nz3Ob9",2023-04-27T00:00:00,[],https://scontent.fcai19-7.fna.fbcdn.net/v/t39.30808-6/343622870_779793637099984_2647537763277279527_n.jpg?stp=dst-jpg_p180x540&_nc_cat=103&ccb=1-7&_nc_sid=9267fe&_nc_ohc=824PaEi5WgMAX_lWLqZ&_nc_ht=scontent.fcai19-7.fna&oh=00_AfCS47PprQ1giEjjCD23bnSUn8XrExfeL3osufyAY2Yd6Q&oe=64E2BA8D,https://www.facebook.com/NVIDIAAI/photos/a.119492422050369/1170621520270782/?__cft__[0]=AZWu1PTOM7Ed60zQePeOPgCn6jV4wU-Hlge66gYc3w73mbu1bPwoiduIvDlA4eMU_kGuPUadBdwMGcT5sB_Wa_WLnM0gLcf7h_FYyhYsElTGx0dgVgTcVLYbt6Bo46VzcvWRJpdcNVCxs3YZo-1IrurrT7f9MzsIv42xlkALTe64zInMDb-V8B3JDQrKCXkfMaD-gaiOGGVCRWPpM0BEAjyW&__tn__=%2CO%2CP-R,19,0,positive,19
pfbid0MaKoEqUL7xceAuaAvAMamLV36fZnutDD7XhzkysGCfkspi17yVPvMf2H8HWRmDKal,NVIDIA AI,0,5,0,0,1,0,0,0,6,0,Trying to figure out which sorting algorithm is right for your data? Run through an explainer by Richmond Alake for an introduction to the bubble sort algorithm — a great option for beginners learning about data structure fundamentals: https://nvda.ws/422Qakw #DataScience,2023-04-27T00:00:00,[],https://external.fcai19-7.fna.fbcdn.net/emg1/v/t13/6714307843707304443?url=https%3A%2F%2Fmiro.medium.com%2Fv2%2Fresize%3Afit%3A587%2F0%2ArH9Awac19RPyvkJ7&fb_obo=1&utld=medium.com&stp=c0.5000x0.5000f_dst-jpg_flffffff_p139x139_q75&ccb=13-1&oh=06_AbHKi9cVVrjtvWkeYOROZEJNcwmUj_oLF6te_0GJYhw9ug&oe=64E02696&_nc_sid=dbad39,https://www.facebook.com/NVIDIAAI/posts/pfbid0MaKoEqUL7xceAuaAvAMamLV36fZnutDD7XhzkysGCfkspi17yVPvMf2H8HWRmDKal?__cft__[0]=AZWb26kmYG8AdE2cmm9LEfTUgm-Rfhr47bpGCg3vQoM_svhFyIOqjbejmgowGZqkGiyNPGaOn9Iy-7jiaM4tb10Sj-yCVmeOeDWMPPOHIOyAfwUD9NlE38OSBv7-hVJA-WIQQ4itJ0H2RXc2uYVknkGHFWgNqmQtFPUOT_en8CRA3C737WGaXSHF53FtctfOXrAS-pKmmFmoYALMpvWqtT41&__tn__=%2CO%2CP-R,6,0,positive,6
pfbid0h2MdfRmZ68cv789Akyk25yK5khXZUAx3K1xKKiBMspEv4LjkoUVTMTSw3oozqvH7l,NVIDIA AI,2,23,0,0,0,0,0,0,23,1,"Christof Henkel, Senior Deep Learning Data Scientist at NVIDIA and Kaggle Grandmaster, joined the Practical AI podcast and shared his approach to maximizing #AI productivity by using GPU-accelerated tools like RAPIDS. Listen to the podcast to learn more: https://nvda.ws/3LxAO24",2023-04-27T00:00:00,[],https://external.fcai19-7.fna.fbcdn.net/emg1/v/t13/8947028306908883944?url=https%3A%2F%2Fcdn.changelog.com%2Fstatic%2Fimages%2Fshare%2Ftwitter-practicalai-ff85309a94aa4ecf9ae0b4d3e4065b92.png&fb_obo=1&utld=changelog.com&stp=c0.5000x0.5000f_dst-jpg_flffffff_p500x261_q75&ccb=13-1&oh=06_AbHEWQhZhYNZznKaXdel1j2V0UnKqAG3mpmn-1kOhDWx4Q&oe=64E095AE&_nc_sid=dbad39,https://www.facebook.com/NVIDIAAI/posts/pfbid0h2MdfRmZ68cv789Akyk25yK5khXZUAx3K1xKKiBMspEv4LjkoUVTMTSw3oozqvH7l?__cft__[0]=AZWY-Xxl_IhtN5KkRVbWbqlZ4UTBNljaSLSuN5dIGUf5CcosBemzBRQYI0_GY7ZXy7RmCfzyPtT9p9ZzUoeGpR39eBI24ZxNMNsBMFTpaVm8i6eZBCtE3VaO0wn8R-3c_VPybEicEZI41XwGSi6BzekzdGkLlz_GmYDv6Du0iOvCsDsKJ87HgVkDRv7SqadcfYndbJnnYxzLTwxc9MA3RQj4&__tn__=%2CO%2CP-R,25,0,positive,25
pfbid027naWviHg5aiRcqbRFiXnYNh7D694fhtSYwjkvvBfkZq9HWfHwe5ajqixTAzL7xJ1l,NVIDIA AI,2,15,0,0,1,0,0,0,16,1,Pro Tip: Make your linear model more flexible with interaction terms.Adding these new variables will help you measure the effects of their interaction with the target: https://nvda.ws/40AUkyQ#DataAnalysis #LinearRegression,2023-04-26T00:00:00,[],https://external.fcai19-7.fna.fbcdn.net/emg1/v/t13/11542454175539088045?url=https%3A%2F%2Fdeveloper-blogs.nvidia.com%2Fwp-content%2Fuploads%2F2023%2F04%2FAdobeStock_311230118-2048x1151.jpg&fb_obo=1&utld=nvidia.com&stp=c0.5000x0.5000f_dst-jpg_flffffff_p500x261_q75&ccb=13-1&oh=06_AbFN05Ri0DZ9GFQq3J4TsoKQIG17go22ILrBnhibT9IrKA&oe=64E05FFC&_nc_sid=dbad39,https://www.facebook.com/NVIDIAAI/posts/pfbid027naWviHg5aiRcqbRFiXnYNh7D694fhtSYwjkvvBfkZq9HWfHwe5ajqixTAzL7xJ1l?__cft__[0]=AZX_7ySrfq2EF5LbkSJFUEdwd57eMzQm9qyw8HlJNI6fMOmGvUxYr2m2LrohNAFCghFMnS1Xj93YDqfqCp0pH7vemxAxeVWNwExcdthiWk5a2eQhHuVeSdRTF5MlKKEGksv0x5yg1t_a2CxkLRqcJvkz85PUSaErsyUDJMBzJTcvEprki-Yovh-uBxHfIInAhMo4U9F7gyRORqEF_A7QRAtg&__tn__=%2CO%2CP-R,18,0,positive,18
pfbid027ywFJZ98npkgbBuFGdUw6pdrr2mDbnrPfoSBJBgWxQfWEtkFffJZpV8YuvNVbjHEl,NVIDIA AI,0,14,0,0,1,0,0,0,15,1,"Learn how to increase #ONNXRuntime and #DirectML performance to make the most of your NVIDIA hardware.Get a technical walkthrough, including example code, in part 6 of our optimizing end-to-end #AI blog series.",2023-04-26T00:00:00,[],https://external.fcai19-7.fna.fbcdn.net/emg1/v/t13/10434687020277815218?url=https%3A%2F%2Fdeveloper-blogs.nvidia.com%2Fwp-content%2Fuploads%2F2023%2F04%2Fproviz-dev-aaai-featured-image-part6-1920x1080-1.jpg&fb_obo=1&utld=nvidia.com&stp=c0.5000x0.5000f_dst-jpg_flffffff_p500x261_q75&ccb=13-1&oh=06_AbFiGRtWAgpRY8OR7z4rTvqNVTAKg69IPO91GVuWr0httw&oe=64E089BA&_nc_sid=dbad39,https://www.facebook.com/NVIDIAAI/posts/pfbid027ywFJZ98npkgbBuFGdUw6pdrr2mDbnrPfoSBJBgWxQfWEtkFffJZpV8YuvNVbjHEl?__cft__[0]=AZXsQ0pbkIJwtB5bQZWYjh7LbJnFvVlDF54c4usGcAn43XSlakCqCoY08ALIK2aijnGVnNsXoUdIt3kAGJrS2U_NRMOkfTmAGrOl53a3W0jNmIaTn5O0u5iL7K9M0BUU3RE9hooIAwCWItf1VuAHtyYRk5-JRX3FBYeHJJl-bCqvG3gMc540TSMiZpmoBQJ7-PdeY9FkH5tnOY2xh0rW1tLH&__tn__=%2CO%2CP-R,15,0,positive,15
pfbid0aCMrBKTeyuE5XXacghdwqBqLEofQc8Lk9rM9zneg29gaPgi91HdANsxfqdnH7GKBl,NVIDIA AI,0,9,0,0,1,0,0,0,10,3,"What’s causing financial service companies to pick up on the adoption of #AI-enabled applications? Learn how FSI companies are beginning to reimagine their customer experience and revenue growth with next-gen autonomous, cloud-based helpers. Read the VentureBeat article: https://nvda.ws/3AtczeQ",2023-04-26T00:00:00,[],https://external.fcai19-7.fna.fbcdn.net/emg1/v/t13/17206995859918069075?url=https%3A%2F%2Fventurebeat.com%2Fwp-content%2Fuploads%2F2023%2F04%2Fspeech-ai-social-riva-launchpad-lab-tw-li-2048x1024-1.jpg%3Fw%3D1200%26strip%3Dall&fb_obo=1&utld=venturebeat.com&stp=c0.5000x0.5000f_dst-jpg_flffffff_p500x261_q75&ccb=13-1&oh=06_AbHkUFPTIkjjLYvG3oAqUFFiBn6Vd9w90biGZJ89fBX9wA&oe=64E06BA5&_nc_sid=dbad39,https://www.facebook.com/NVIDIAAI/posts/pfbid0aCMrBKTeyuE5XXacghdwqBqLEofQc8Lk9rM9zneg29gaPgi91HdANsxfqdnH7GKBl?__cft__[0]=AZWYG0Jc3c2ilUtIGJeK3XN8gyxIGqn_LBMackrUiUDy8SIJK3WJScvzE6h8oDh-mZ71HToM-udg1yAQUuLDNpOG98eEhRTsXHPTsmuGQyKxgv9AvOVOJ96qNeIBCrcwiLFNc-r1D_mctNmRy4ZDehk92oLTvsBl_0nhREZEM_qROa6hPBLgUyUgYEOofDYrxu0FLbAmlRPOnO1JJD4XdKjf&__tn__=%2CO%2CP-R,10,0,positive,10
pfbid02Sbv1rjiRS8tGXosKFqyz3kRqt6EuJb6mWHtdWptzsqDVyW2vHYeXJvkCZ6NzPAUdl,NVIDIA AI,0,5,1,0,1,0,0,0,7,1,"Try the new toolkit that adds a layer of safety, security, and topical guardrails to existing LLM-based conversational applications. NeMo Guardrails works with all #LLMs and natively supports #LangChain. https://bit.ly/3Lpqadw",2023-04-26T00:00:00,['blob:https://www.facebook.com/b9ba5f35-a4fa-454d-92b3-d16888f2782d'],https://scontent.fcai19-7.fna.fbcdn.net/v/t15.5256-10/342255711_1707652086353198_6044444521779711943_n.jpg?stp=dst-jpg_p960x960&_nc_cat=106&ccb=1-7&_nc_sid=ad6a45&_nc_ohc=m_nJSVCctQQAX_FzHMn&_nc_ht=scontent.fcai19-7.fna&oh=00_AfDwH8BX5Iy5NjlDZxGv_GikFy7xG2ftGEkozCW_JSnv_w&oe=64E3C604,https://www.facebook.com/NVIDIAAI/posts/pfbid02Sbv1rjiRS8tGXosKFqyz3kRqt6EuJb6mWHtdWptzsqDVyW2vHYeXJvkCZ6NzPAUdl?__cft__[0]=AZXf3evahaGwk3VaTGXJBtroQHbcTgpi9Uxyf1UQi9T-I-Y-RbSes0w1SkD8dQIZZ6EvDVxKIOROZvqliiThVIO3g0d3xrNfD3jp234KHrarFnaZs5gGYcWXKPNTZRyGHOY4sGUAYXbSEAiBqUk24rq2Bvloa3myDatddRPGuJGWyGAo4pJCA_AruAGZmGdiTtiO7yM63aoEoWA7rcf-5GJPK_kKdKma5sVpiwJJXiI__A&__tn__=%2CO%2CP-R,7,0,positive,7
1169698487029752,NVIDIA AI,1,26,0,0,0,0,0,0,26,4,"Just Launched...NeMo Guardrails - a toolkit for easily developing trustworthy large language model-based conversational applications. It works with all #LLMs and natively supports #LangChain, adding a layer of safety, security, and topical guardrails to existing applications. https://bit.ly/3Lpqadw",2023-04-25T00:00:00,[],https://scontent.fcai19-7.fna.fbcdn.net/v/t39.30808-6/343308466_187835044077607_1544748958560619837_n.png?stp=dst-png_p526x296&_nc_cat=101&ccb=1-7&_nc_sid=9267fe&_nc_ohc=ypmyd19oHqAAX90K5Mf&_nc_ht=scontent.fcai19-7.fna&oh=00_AfBzc64KJyDbpzrvuIZDm48inBN6Cq8Zy1JEF9sEH70XYg&oe=64E2A7F2,https://www.facebook.com/NVIDIAAI/photos/a.119492422050369/1169698487029752/?__cft__[0]=AZV1_t-SnSQ4YBVM66ZWONl2FQG8w2_VFbALdvgfBuldOiLqh4NMiWBo3yJRXvJKRRxnLx2X5m1s4ulTO5jdy-CAzDQgMN4sCsxMziwwD-NPbLGyywgQn5HqLzZSOoXM0N-z-Kzz_xbsAehKEb0Z54Tajle2npH8swiAjYDu68SRY6FjJTqU4oCa14HoqsRqLN8KXM5Zsov5c6WGNHd3AYma&__tn__=%2CO%2CP-R,27,0,positive,27
pfbid0Ycd8d5Uy9rV5VJfzqPPrpmCpdRWQfZWAj3fYErQf7UaVoY9W6JT5BXfBkkw73kuol,NVIDIA AI,0,7,0,0,1,0,0,0,8,1,"#AI enables #wealthmanagement firms to glean market intelligence and provide personalized recommendations that improve investment returns, better serve clients, and increase assets under management. Read the article from Bloomberg: https://nvda.ws/3NfuehX",2023-04-24T00:00:00,[],https://external.fcai19-7.fna.fbcdn.net/emg1/v/t13/7420040987116982254?url=https%3A%2F%2Fassets.bwbx.io%2Fimages%2Fusers%2FiqjWHBFdfxIU%2Fi9xtzcuabs28%2Fv0%2F1200x630.jpg&fb_obo=1&utld=bwbx.io&stp=c0.5000x0.5000f_dst-jpg_flffffff_p500x261_q75&ccb=13-1&oh=06_AbE7nf5m3MNkeO93MXXVlRdgAHbsgO4mrlFchkafE0UZiw&oe=64DFFED0&_nc_sid=dbad39,https://www.facebook.com/NVIDIAAI/posts/pfbid0Ycd8d5Uy9rV5VJfzqPPrpmCpdRWQfZWAj3fYErQf7UaVoY9W6JT5BXfBkkw73kuol?__cft__[0]=AZU2XskXBymTnFrU8Hnfwz_1wXJqoi61XtM1U5IpKygZce0Aa-I6ENLqGRgN0hM6qDxmo3M8KdTrS1XbkaqovOnqTEr8u0Ws3UER-BrAXYY3LraBgOIYF0LqM9CBaG8JuhrG1huUGvyc23h2jyHKflZSGSa2Hdegpu5j-vu4UYn1tQao1SJyx-je8PPwja4HvCwSUxdbX1-WkU33fovHSGSC&__tn__=%2CO%2CP-R,8,0,positive,8
1169299867069614,NVIDIA AI,0,16,0,0,2,0,0,0,18,2,"CPFD Software is helping refiners and #energy industry technology developers accelerate CFD simulations with accelerated computing, powered by NVIDIA. Download the solution brief: https://nvda.ws/41qLGnL",2023-04-24T00:00:00,[],https://scontent.fcai19-7.fna.fbcdn.net/v/t39.30808-6/342751084_559636399594515_2403669631729915687_n.jpg?stp=dst-jpg_p180x540&_nc_cat=111&ccb=1-7&_nc_sid=9267fe&_nc_ohc=VfhYxVEd6BUAX9vYHP8&_nc_ht=scontent.fcai19-7.fna&oh=00_AfBj2X5OL5mherc_60EVIFZQEhnJrzTEAXQw6Tp9ox93TQ&oe=64E3819F,https://www.facebook.com/NVIDIAAI/photos/a.119492422050369/1169299867069614/?__cft__[0]=AZWDDP4h1tcCIgNAnPFjdptnIvit_lt1QktYyNjaaXe5GIz9Y585oBXV_VtjBV91AkoK2EbRTMNzUvVid6Tn9mtMDsZS9WUGxBDeoF7BxN30ylzHFeC3-reWlpZzGynuGg1dzFDiYC4NkbkrW5nqrJdoq5YYf6k7qWBpUhN8vTcD_r2gCA0PITNnQUa0F8q8H5U-zcdwrvrTFBMZhvDy9hqB&__tn__=%2CO%2CP-R,18,0,positive,18
pfbid02bKmzSjHbV1FYrie6aTVYdwwJJ4a6PXe3xUgacodTGTaFt3CoAn9uJEJvqp7RMvnUl,NVIDIA AI,0,9,0,0,1,0,0,0,10,3,Debugging mixed languages across many devices?Delve into how one bug required a multifaceted development team dozens of engineering hours to resolve -- from insight on the process to debugging lessons learned: https://nvda.ws/3oAX3ej,2023-04-24T00:00:00,[],https://external.fcai19-7.fna.fbcdn.net/emg1/v/t13/5328882353876491944?url=https%3A%2F%2Fdeveloper-blogs.nvidia.com%2Fwp-content%2Fuploads%2F2023%2F04%2Fdebugging-python-c-screenshot.png&fb_obo=1&utld=nvidia.com&stp=c0.5000x0.5000f_dst-jpg_flffffff_p500x261_q75&ccb=13-1&oh=06_AbHHfRDlysluVdxWka-acoeSf_0cWDDN-XLTmAvNFD_7_g&oe=64E09C95&_nc_sid=dbad39,https://www.facebook.com/NVIDIAAI/posts/pfbid02bKmzSjHbV1FYrie6aTVYdwwJJ4a6PXe3xUgacodTGTaFt3CoAn9uJEJvqp7RMvnUl?__cft__[0]=AZUFsvoUj_ppUMt3LcnJStyw8PnTiqmm9_8Rj9I9Ow9iAG1KY8UFl9C5IQc7svfEvx1nCMCS1xbhqPCITgrhK06Fh9TJU70FsKAN0NgbjkqRHSe8Lv9G817mNRIUiV89bCuTcY1GxOjJ899etH8gRi6qXRPE5UWOPdkS8YyJk7jinZqWuC0pfZfu178SdFg32qF4drhhNjhLx7jpz9vso_0I&__tn__=%2CO%2CP-R,10,0,positive,10
pfbid02LK9qHpuAgNur7XgRX38TV2p86XQKZKDJYVXGNNENadHbPR56FBT7T7TZ663mqxurl,NVIDIA AI,0,4,0,0,1,0,0,0,5,0,Ready to dive into the cutting-edge world of #GenerativeAI? Watch this #GTC23 session to hear how gen AI is driving innovation in businesses all around the world. https://bit.ly/3mOJ18e,2023-04-24T00:00:00,[],https://external.fcai19-7.fna.fbcdn.net/emg1/v/t13/10057332092478821817?url=https%3A%2F%2Fprod2-sprcdn-assets.sprinklr.com%2F50276%2F2f9c03e6-d724-4b06-a061-fd126d80680e-143510139%2Fdev-programs-gtcs23-social-nvo.jpg&fb_obo=1&utld=sprinklr.com&stp=c0.5000x0.5000f_dst-jpg_flffffff_p500x261_q75&ccb=13-1&oh=06_AbEBc9bVg1d8i6k6A8rFjg_jUWWj93zpCFU_nQkdoPx71A&oe=64E01C6B&_nc_sid=dbad39,https://www.facebook.com/NVIDIAAI/posts/pfbid02LK9qHpuAgNur7XgRX38TV2p86XQKZKDJYVXGNNENadHbPR56FBT7T7TZ663mqxurl?__cft__[0]=AZWMke1gD7O0LLve7A5PyMyedGOtOdnI4tAE6Qr9OAk1K8AXYRUD96SxT75w5f7J5IKyj3h5GCoA-l-GXL_x292PQUIfL6o56l0T505avjlFRLCQUnXv1Zs4AYThD8cmnRSicGqygsj_-2gb107sf-7lj9Qbie_hARlH_69ib8p_VjqTrkNULSt3c1OVgfOpIs74F_ymlt15xhTFV5FBYHkb&__tn__=%2CO%2CP-R,5,0,positive,5
1169213777078223,NVIDIA AI,0,10,0,0,1,0,0,0,11,0,"Check out NVIDIA's latest on-demand playlist for researchers and educators! Hear from industry experts and thought leaders on the latest trends and innovations in generative AI, deep learning, and more. https://bit.ly/3USb9E1",2023-04-24T00:00:00,[],https://scontent.fcai19-7.fna.fbcdn.net/v/t39.30808-6/343439363_609609107774113_1125270794064656326_n.jpg?stp=dst-jpg_p180x540&_nc_cat=101&ccb=1-7&_nc_sid=9267fe&_nc_ohc=d8WI61hXmq8AX9NA_cY&_nc_ht=scontent.fcai19-7.fna&oh=00_AfCXhdR0ffnbtFXBVLjwTcGSx0a6yVXb_wG44bkX67bENQ&oe=64E3F722,https://www.facebook.com/NVIDIAAI/photos/a.119492422050369/1169213777078223/?__cft__[0]=AZUDwpAd4df7-LN7nC8LtKEGxPKzNtgk42L2GAXfefV0B4cA_sbKOBko4h2rWQfGpxLX59yHaQim8nbjIR0-kkc2NP_9iYAe3MuPSKuzQlPxTKRmqHP8suAbo20R-H6OOP-U41QmMxmILKm20XaSWtP_n3Iji_RC90SwxvJPPHmFF85PAgrFFmoPb9tu7o-0ix3Ejg2tC8dfkPLj1PrfG-Gm&__tn__=%2CO%2CP-R,11,0,positive,11
pfbid0XHQryntJo7PQ2TyqdFvRciGZtF5SxDt2Mq9iEiw3h7boPWUC6kXnwQmGHWVmHH49l,NVIDIA AI,0,11,0,0,1,0,0,0,12,0,This is a must-attend session for all #startups. Learn how from these #NVIDIAInception members Agtech OS and Nota Incorporated are accelerating their solution to market and reducing costs. Watch now: https://bit.ly/3mSDihF#GTC23 #AI #GenerativeAI #developer,2023-04-24T00:00:00,[],https://external.fcai19-7.fna.fbcdn.net/emg1/v/t13/12708914495093534025?url=https%3A%2F%2Fprod2-sprcdn-assets.sprinklr.com%2F50276%2F4eb089c5-3250-46ce-b6c2-68217d767dba-581483982%2Fgtcs23-inception-social-conten.png&fb_obo=1&utld=sprinklr.com&stp=c0.5000x0.5000f_dst-jpg_flffffff_p500x261_q75&ccb=13-1&oh=06_AbH2YFM07R6TGyV5sAgSFDigTTwkx0uqdZH3IJidzBTsbg&oe=64E044A7&_nc_sid=dbad39,https://www.facebook.com/NVIDIAAI/posts/pfbid0XHQryntJo7PQ2TyqdFvRciGZtF5SxDt2Mq9iEiw3h7boPWUC6kXnwQmGHWVmHH49l?__cft__[0]=AZWkZ34OfodeFcqfmKFnUaJi8CpO9KubiYrSVzVamu4tNxJ4HlqCw678ftKOqjRYNO04GupPwqKL9wYbH4O9JEuQ5SIrYcIMCdp-UH89LXDTAuYgcOp73vr6D4yS5eFFwa6IWsYIs425pZjc-Hh9lcwy0Xp81JCtGaLL4D1FT2qdAjDV37F7tqSt4NLSRpCDXLz3-VCg-3KKXvCuZIC1O9Oz&__tn__=%2CO%2CP-R,12,0,positive,12
pfbid02D94aofMqbR6Q1ggeyX4KypdNvDPt9Y34mvVytXpyaMhQsbYXyg1aezpTHxR5Tfg5l,NVIDIA AI,0,11,0,1,1,0,0,0,13,3,Interested in learning about metaverse for your solution?  Tune in to hear from #startups Madrona Venture Group and Radical Ventures who are using #NVIDIAOmniverse to accelerate their AI solution and create whole new opportunities. Watch now: https://bit.ly/3GYos0d#NVIDIAInception #motioncapture #facescanning #developer #metaverse #GTC23,2023-04-22T00:00:00,[],https://external.fcai19-7.fna.fbcdn.net/emg1/v/t13/10841061318096472715?url=https%3A%2F%2Fprod2-sprcdn-assets.sprinklr.com%2F50276%2F49dab1ac-0508-4097-908e-42100c75bc23-132427436%2Fgtcs23-inception-social-speake.png&fb_obo=1&utld=sprinklr.com&stp=c0.5000x0.5000f_dst-jpg_flffffff_p500x261_q75&ccb=13-1&oh=06_AbGwE1bOGRaR3nEj47I16id6Ead67Ngi6D5NjEe82Tr41w&oe=64E037B1&_nc_sid=dbad39,https://www.facebook.com/NVIDIAAI/posts/pfbid02D94aofMqbR6Q1ggeyX4KypdNvDPt9Y34mvVytXpyaMhQsbYXyg1aezpTHxR5Tfg5l?__cft__[0]=AZUqgRIMlmMu0aziXurn9fce3h0MEINMqET5eL5hFnTC9RJT_9ovq9ONmXOPScs65dOg3k7cfKxjBjJvhXgWvpSlKtYpvuyUDk9SXUwxTW1O64oMS7MiTXOkG4JmQ4_0TyWLDF82ecIomIUgDEyAjQYTiAupA0rlY7Iyh7ku-RFI9Khq6IcZBq6KNb8wWnUKM-eMYNsUlSVfjAv8d9GBgVCI&__tn__=%2CO%2CP-R,13,0,positive,13
pfbid02MbrSZgn7XPY8g9bQKYzm9QvYSywQotu9xFqZingXmEFh5vxUL81zsDBGGvYaBDd8l,NVIDIA AI,0,13,0,0,1,0,0,0,14,3,"As a data scientist, evaluating #ML model performance is a must. Whether you're predicting the price of a house or forecasting company sales, a regression analysis is helpful to ensure your model is performing optimally: https://nvda.ws/3Lj2jw8",2023-04-21T00:00:00,[],https://external.fcai19-7.fna.fbcdn.net/emg1/v/t13/17234252555535071942?url=https%3A%2F%2Fdeveloper-blogs.nvidia.com%2Fwp-content%2Fuploads%2F2023%2F04%2Fregression-evaluation-metrics.png&fb_obo=1&utld=nvidia.com&stp=c0.5000x0.5000f_dst-jpg_flffffff_p500x261_q75&ccb=13-1&oh=06_AbGVZOOf2vX5PKS889XwMNKnyy6twfiRX-9vHrU1DZiEFA&oe=64E08CF2&_nc_sid=dbad39,https://www.facebook.com/NVIDIAAI/posts/pfbid02MbrSZgn7XPY8g9bQKYzm9QvYSywQotu9xFqZingXmEFh5vxUL81zsDBGGvYaBDd8l?__cft__[0]=AZVlsfumQSjeoENEmT0LXTtmJTibuKe2QHodOk5c1_dPvol1UR8yThqqdmNK7D8Na04-lQ6li21_t55E6aLcZRAVTSmxJKc6hgmJE0qLJKTteK1hoY4gknWSgmEn8-s_3Rmzzr_MOd-OLxIl23bCpbBfyt7XQO5gWMiuyPS-tdOviNW_IOyLVYnq-gsB38gLKg4tP2cU2aH_XXWcyZNCMiif&__tn__=%2CO%2CP-R,14,0,positive,14
pfbid0qG9hS6jYi35A618tpRc6m6w2eWYXLazA9R4be6f982HCnEpinQPPELKXhyh9AuHUl,NVIDIA AI,0,7,0,0,1,0,0,0,8,1,NVIDIA Optical Flow SDK 5.0 now supports generating optical flow in #Vulkan applications. Tap in to our Optical Flow accelerator with #computervision and frame interpolation for increased performance and fluidity. Learn more: https://nvda.ws/40usQuy,2023-04-21T00:00:00,['blob:https://www.facebook.com/4668ef67-3e86-4c82-a176-e5730a868eca'],,https://www.facebook.com/NVIDIAAI/posts/pfbid0qG9hS6jYi35A618tpRc6m6w2eWYXLazA9R4be6f982HCnEpinQPPELKXhyh9AuHUl?__cft__[0]=AZXKnkyjOlEGE9mrLYNcwEaqXISo9NjmLyAhxeKMnoZJuBcvRNAw-L4vvjemKMfetUldT85EE_ANTv--STviCvfMZMJaVy3QW7DR2iFvH7pQpCqqQi3rZZz8HDc0xSiJGdOgXUO-qbHVhjHa4F0LT2fRBDVFaayDR3LXQnvI3FIHwiefj56N2G8yr1Q5CIdDGpRKc1fGSVfMHF8fjPobbcRSbwSw2P3oirE-GrOaoHrCHw&__tn__=%2CO%2CP-R,8,0,positive,8
pfbid0H5RRifQkFKbhXP5uimUKUxLiNHtnPaUj9VJuSJpar2Y3SztDji68HY9ZCVJFCGNBl,NVIDIA AI,0,5,1,0,1,0,0,0,7,1,"Catch this top session from #GTC23 and discover how to develop your next #GenerativeAI solution, and navigate a rapidly changing ecosystem. Hear from these innovative NVIDIA Inception #startups WOMBO, Irreverent Labs, and Writer AI who are making waves in the space. https://bit.ly/3ovHODy",2023-04-21T00:00:00,[],https://external.fcai19-7.fna.fbcdn.net/emg1/v/t13/16770868276997270871?url=https%3A%2F%2Fprod2-sprcdn-assets.sprinklr.com%2F50276%2F4f5d3a87-0330-47cb-8540-c1ce802dbcfa-156516442%2Fgtcs23-social-inception-sessio.png&fb_obo=1&utld=sprinklr.com&stp=c0.5000x0.5000f_dst-jpg_flffffff_p500x261_q75&ccb=13-1&oh=06_AbExDKJgTvrHyXGApUnfr4ytEbQ79antTN_4XoIoE6j7pQ&oe=64E03DB6&_nc_sid=dbad39 https://external.fcai19-7.fna.fbcdn.net/emg1/v/t13/17256222450935664528?url=https%3A%2F%2Fi.ytimg.com%2Fvi%2FG1pv8Atl8eI%2Fmaxresdefault_live.jpg&fb_obo=1&utld=ytimg.com&stp=c0.5000x0.5000f_dst-emg0_p98x98_q75&ccb=13-1&oh=06_AbF1j-2SBQPTiZsLjhfTbkf9UPmevor2lcWeM3Y6vD7swA&oe=64E07CC7&_nc_sid=dbad39,https://www.facebook.com/NVIDIAAI/posts/pfbid0H5RRifQkFKbhXP5uimUKUxLiNHtnPaUj9VJuSJpar2Y3SztDji68HY9ZCVJFCGNBl?__cft__[0]=AZVWUQnXX5ARBvNiwYdIjPWdHBmiEr-KgSpd4OHU4trx61W4rH9vUvouGyf0LvOoEtJGR_0h04lEA4Z1X3DSx7GQ5EXQLVIqTnFh1qrPJShajdCc0yJxuPAEYlGS3NLImUBXLGeywwFsxx5RyFgIb69xCMjLM_sRdLzHrDFB7BlqgiJEg3cqfyEyd_4m_ibX0-b3q_W5mslc04BdEx4Q_rWz&__tn__=%2CO%2CP-R,7,0,positive,7
1167727873893480,NVIDIA AI,0,7,0,0,1,0,0,0,8,0,"Attention all students! Explore the future of #AI with this NVIDIA on-demand playlist! Discover the latest advancements in generative AI, deep learning, and virtual reality that are transforming industries and creating new opportunities for innovation. https://bit.ly/43MW6Q9",2023-04-21T00:00:00,[],https://scontent.fcai19-7.fna.fbcdn.net/v/t39.30808-6/342535690_194300856708107_1467638610301462186_n.jpg?stp=dst-jpg_p180x540&_nc_cat=109&ccb=1-7&_nc_sid=9267fe&_nc_ohc=qQVF4GnSAV4AX-OfUF5&_nc_ht=scontent.fcai19-7.fna&oh=00_AfCmRDnKZITN4BD4SN5IXlqcVNt9hSvL-BEC0JikWY1KGA&oe=64E33CA2,https://www.facebook.com/NVIDIAAI/photos/a.119492422050369/1167727873893480/?__cft__[0]=AZW4lckA6o9lylxOLNw2hBT9lIGn1ZOG0PoEhT0ga9R2hDoNMFVKD2otIoxLQnhIQncSLrUSeo_G1sWmsHutA_cba02tLMcdUEH5k9AFrDAOgkjuiekNzHw4VqU5Kzw9Fcd3PKJnggXQoLN7n-BSj77BKKwQoLH_oNfgZulEnYK3fZ9ywbdv33IMw_FWGOJUftXfUYcp6qh7ST3mbkMT2PvB&__tn__=%2CO%2CP-R,8,0,positive,8
pfbid02phdtU4pVBMCSLHmYiEPjJXesefryQYQGrGPBLahkn1RAicqxfgmCSXYb35wFU9Sl,NVIDIA AI,0,9,0,0,0,0,0,0,9,1,"Take a look at how NVIDIA Maxine brings real-time, AI-powered face tracking to DenchiSoft's #VTubeStudio.",2023-04-20T00:00:00,[],https://external.fcai19-7.fna.fbcdn.net/emg1/v/t13/283468409297456025?url=https%3A%2F%2Fprod2-sprcdn-assets.sprinklr.com%2F50276%2Fcb3d0237-1fd8-4eab-a4fa-8c2840e440e0-996498226%2FScreenshot_2023-04-20_090856.jpg&fb_obo=1&utld=sprinklr.com&stp=c0.5000x0.5000f_dst-jpg_flffffff_p458x239_q75&ccb=13-1&oh=06_AbEgCslhXS7oxrJoOA-MFzL2gMSB8RhiNLNCsVLMLnzcVA&oe=64E07713&_nc_sid=dbad39,https://www.facebook.com/NVIDIAAI/posts/pfbid02phdtU4pVBMCSLHmYiEPjJXesefryQYQGrGPBLahkn1RAicqxfgmCSXYb35wFU9Sl?__cft__[0]=AZXCcfBTYscu9X1nheuDcDr48aDNGIOGIdDkfh48XXEcfT0Bxb-7sjlJwiN94UNUxSb0z3hSoVYpVjZlsrqVDGrhxvOxSGq-u_sfVsYy5DPmEOtAN2Zv8T62nNtCLy1ar5bNvDggVdv_IRHulPJrtLak0VZL2WYlPG5T-EdZe_1Ot76PesNy0Nrt6JdYLnFEdloYI-B3Ne0yOd7wxPH85Csy&__tn__=%2CO%2CP-R,9,0,positive,9
1167249290608005,NVIDIA AI,1,17,0,0,2,0,0,0,19,1,"The way #banks are using #AI is evolving—according to a recent report from NVIDIA—including adopting hybrid cloud, preventing fraud, personalizing customer experiences, and scaling AI talent. Read the article from Financial It: https://nvda.ws/3AeovB0",2023-04-20T00:00:00,[],https://scontent.fcai19-7.fna.fbcdn.net/v/t39.30808-6/342363253_770666874440690_6931776954857530106_n.jpg?stp=dst-jpg_p526x296&_nc_cat=108&ccb=1-7&_nc_sid=9267fe&_nc_ohc=iPMz8SplzvwAX9KPBjA&_nc_ht=scontent.fcai19-7.fna&oh=00_AfDBz9zVmRE-AwB9mDMX3bBb_o7vRsi7P8QOpbH_tdi2AA&oe=64E3C143,https://www.facebook.com/NVIDIAAI/photos/a.119492422050369/1167249290608005/?__cft__[0]=AZW2lM6WD2uUhnovlvDYG0Bc-AyViPupuDvWkhMh6UIG_JlYxpNUTgDfqMbrD-4ZV4ce1O9ADKQNupPmX692P-tyr6KLY9nvSugKGPgQ1I0reUeEtJMAIVGTnjPzLEWu2Kq_K4GrHNgEvimOrzqHfjGyfrhHegcl9GtZZUp8FAJq5BfJg2-irmzUJ4d8_g8LIk2ZBywIz4_oJI70a78KcQgl&__tn__=%2CO%2CP-R,20,0,positive,20
pfbid0QAhzo9P6KvEYs9Dtx8HP4xhysjpN6YkqJZeNqdJ4RK37GK3Gti94SUaeeAiGxyrtl,NVIDIA AI,0,22,0,0,0,0,0,0,22,4,Try the new open-source Spark RAPIDS ML Python package for GPU acceleration! Read a quick overview of how you can dramatically speed up your Spark #ML applications with a one-line code change and reduce your computing costs: https://nvda.ws/41lENnB,2023-04-19T00:00:00,[],https://external.fcai19-7.fna.fbcdn.net/emg1/v/t13/1362701085835241940?url=https%3A%2F%2Fdeveloper-blogs.nvidia.com%2Fwp-content%2Fuploads%2F2023%2F04%2Fspark-rapids-ml-library-featured.png&fb_obo=1&utld=nvidia.com&stp=c0.5000x0.5000f_dst-jpg_flffffff_p500x261_q75&ccb=13-1&oh=06_AbEQ0PWRyc7J64-zkEYqdToSAtZcAbD2bd9tvWEvsPWW_Q&oe=64E04BD3&_nc_sid=dbad39,https://www.facebook.com/NVIDIAAI/posts/pfbid0QAhzo9P6KvEYs9Dtx8HP4xhysjpN6YkqJZeNqdJ4RK37GK3Gti94SUaeeAiGxyrtl?__cft__[0]=AZXJai7BFDD2TdTxgA7HClrOv8FFn-U91bvVyGJrqHrY7dMpQIUkJFunw8oayML5j3Ofhp_766igXQdN4uwnFOYwwlC7sFGmDlE8nkxdnt8qP9qP-xcCkY467pvoEJiIEZVrunnyxwKMof0OMBKTo9GyZfvi9DF0rc_rnTKYxLiaM-SQ-vQxqE3MWij3v9C-uQ2eeTiK-ulMaR3R7FEmczsd&__tn__=%2CO%2CP-R,22,0,positive,22
1166801127319488,NVIDIA AI,0,10,0,0,1,0,0,0,11,0,"Join NVIDIA’s Jeremy Krinitt to learn how Generative AI can transform your business, including new business models and improving operational efficiency. https://nvda.ws/3ZZCyF3",2023-04-19T00:00:00,[],https://scontent.fcai19-7.fna.fbcdn.net/v/t39.30808-6/342166977_130780836563170_2631877993976431693_n.jpg?stp=dst-jpg_p180x540&_nc_cat=103&ccb=1-7&_nc_sid=9267fe&_nc_ohc=9ifu_i01yrwAX_vgMGQ&_nc_ht=scontent.fcai19-7.fna&oh=00_AfC9rAKmFOhsp-Un07stloCIBRLoyi_qgURcbXT6eknsWQ&oe=64E42685,https://www.facebook.com/NVIDIAAI/photos/a.119492422050369/1166801127319488/?__cft__[0]=AZXESeDqql1J9Ihacsu3x5JI2Ql4IRYe6VdOyyYxeL_vm8cWU_cf4ngau5572P3w9YQGuLXFcifCGpNhIBJLfTqOTgK-x5yF9B5MnAT3bVD88LMVaCpyI0P_s1g-rHLR_HAdGBdE_Thud0kvlbxrMCW5H3ArYtwuhFxJoUPukF_SfrNpQv1XmemH9pMwK-h89SF5TSflSVtGfAsRW1-eeSPt&__tn__=%2CO%2CP-R,11,0,positive,11
1166395124026755,NVIDIA AI,0,13,0,0,1,0,0,0,14,2,"It’s go-time for mainstreaming AI. In this in-depth coverage, VentureBeat looks at AI expansion across industries, including impressive gains achieved by Wayve, the global pioneer working to scale next-gen autonomous vehicles. Read the article. https://nvda.ws/41rJagM#MakeAIYourReality #AzureHPCAI #NVIDIAonAzure",2023-04-18T00:00:00,[],https://scontent.fcai19-7.fna.fbcdn.net/v/t39.30808-6/342210227_922518622202080_5933942592129655348_n.png?stp=dst-png_p180x540&_nc_cat=111&ccb=1-7&_nc_sid=9267fe&_nc_ohc=fs2kqbJJUO8AX_BoyKS&_nc_ht=scontent.fcai19-7.fna&oh=00_AfDWxZBsh6cTZItjnA7uYVN_RazdyhvYRVnJ1UZN7bPeRw&oe=64E487A3,https://www.facebook.com/NVIDIAAI/photos/a.119492422050369/1166395124026755/?__cft__[0]=AZXo04ozyaYAh1EC4FZRTLi_H1O8UkAOtIVFElofl48eMIx58ExfQTssKF_uNo0Fh6Pq4ImLRgK7Puu7d3sFdYPsFSiHemuBGZpxixsCCZxAHiPKB88bZCD5OZoVcXR8xwYkmOUzsOAfrZdftEvn-A66OS1PAcsJoi1aXLaVbKoFbgA9cGLvFv_ZSjl0M1dwpz2EtpcstkbAOqx-Qz8FPQ5r&__tn__=%2CO%2CP-R,14,0,positive,14
pfbid0cvPR6aZYLMtCHRMni8iayhM71EV9CeXkUToh15pyQYxCJ8E1zNhcU8V5C6bUANC6l,NVIDIA AI,3,22,0,0,0,0,0,0,22,3,Discover the power of #texttospeech technology: from content creation to digital humans. Learn how #TTS can be applied to various applications in our latest blog post. #speechAI #NVIDIA https://bit.ly/3GMffaZ,2023-04-17T00:00:00,[],https://external.fcai19-7.fna.fbcdn.net/emg1/v/t13/8655027854577680434?url=https%3A%2F%2Fdeveloper-blogs.nvidia.com%2Fwp-content%2Fuploads%2F2023%2F03%2Funique-tts-apps-featured.jpg&fb_obo=1&utld=nvidia.com&stp=c0.5000x0.5000f_dst-jpg_flffffff_p500x261_q75&ccb=13-1&oh=06_AbHSohj-5AUEvkteL2GIxv5iVebSSpBokn2QD--6ANeMUw&oe=64E04490&_nc_sid=dbad39,https://www.facebook.com/NVIDIAAI/posts/pfbid0cvPR6aZYLMtCHRMni8iayhM71EV9CeXkUToh15pyQYxCJ8E1zNhcU8V5C6bUANC6l?__cft__[0]=AZUgTDU6MYve9P_kfLaNLpopgYHAP5X3GDvnBn6rJO-rMwnecbjlNYNMDUnrFE30u7IH5P0Fciexa1qMnonDOCLizjGA-vvtxmiQF9b8bhOnLxlArfgTRmlnspzW11KSCXQvB8UhxHpETgwOYhiMuGHsT5bwiLfOlvHS9OBbFGq92OA2kTfT4f9cx6XcS_aSuUUw81R4871nanjxlhxGR3qn&__tn__=%2CO%2CP-R,25,0,positive,25
pfbid0Xie4QcEFFGmdbZVEWPLSKvkSqDbBpPgXgbZ9kPg77Hjp2bnc7rU8vYm5wDPre2XSl,NVIDIA AI,0,22,0,0,2,0,0,0,24,1,Is your startup developing an edge AI solution? Join NVIDIA Inception to supercharge your deployment with NVIDIA Jetson Orin devices. Program members are now getting an exclusive deal on Jetson Orin Developer Kits.Already a member of Inception? Reach out to your Inception partner manager to learn more about the offer. https://bit.ly/3N4OiDg #NVIDIAInception #startups #AI #jetson #developer,2023-04-17T00:00:00,[],https://external.fcai19-7.fna.fbcdn.net/emg1/v/t13/8341315298866820520?url=https%3A%2F%2Fwww.nvidia.com%2Fcontent%2Fdam%2Fen-zz%2FSolutions%2Fgtcf22%2Fembedded-systems%2Fjetson-orin%2Fnvidia-jetson-orin-nano-developer-kit-og-100%2525.jpg&fb_obo=1&utld=nvidia.com&stp=c0.5000x0.5000f_dst-jpg_flffffff_p500x261_q75&ccb=13-1&oh=06_AbEdxzT3BjxA9yi-NM79cFUw5cq1s4MCIKH84V-ixKxzTA&oe=64E09FAF&_nc_sid=dbad39 https://static.xx.fbcdn.net/rsrc.php/v3/y9/r/Z-dbClQDXLv.png,https://www.facebook.com/NVIDIAAI/posts/pfbid0Xie4QcEFFGmdbZVEWPLSKvkSqDbBpPgXgbZ9kPg77Hjp2bnc7rU8vYm5wDPre2XSl?__cft__[0]=AZUxS5W115tEPNdyj5PP8j6OW3TTVyxvlALQCAQpnyk3-XmyQ7P2Zxj2G5txFSoZmL9BMs7im3ElGBOleFIwUxWFyaItnx4GeX_G7ftJhvgKT_gP-fqQTFAgnPS8-MjVLF6X2pnVVkWBeeraGTmntYcCXew-Or157bZkd3ta2ZbII7eI2aJp7H2ims_MH50zorClHPv9E-8r0gj455GZxdeP&__tn__=%2CO%2CP-R,24,0,positive,24
pfbid02ibevnQBsw9Hb8mmXZutHFnbkpot1s6TzPhesusygf2DGccJBRvjwQWLBS69vjKenl,NVIDIA AI,0,23,0,0,0,0,0,0,23,5,"#Fintechs are driving innovation across the customer journey—including onboarding, workflow automation, risk management, fraud prevention, and personalized recommendations service—by teaming with Amazon Web Services and NVIDIA. Learn more in the new TechCrunch article: https://nvda.ws/3o90gBz",2023-04-14T00:00:00,[],https://external.fcai19-7.fna.fbcdn.net/emg1/v/t13/1570965571697927066?url=https%3A%2F%2Ftechcrunch.com%2Fwp-content%2Fuploads%2F2023%2F03%2FGettyImages-1370451643.jpg%3Fresize%3D1200%2C800&fb_obo=1&utld=techcrunch.com&stp=c0.5000x0.5000f_dst-jpg_flffffff_p500x261_q75&ccb=13-1&oh=06_AbFSQ7XUGx9u6MOTfLCK7Eu2AG6Z1iRI1Y7yRxVbIxjAtg&oe=64E039FB&_nc_sid=dbad39,https://www.facebook.com/NVIDIAAI/posts/pfbid02ibevnQBsw9Hb8mmXZutHFnbkpot1s6TzPhesusygf2DGccJBRvjwQWLBS69vjKenl?__cft__[0]=AZWbX6YJH00LfGuf7Y_ALr6S_fs-aykI5nUMgAUOrVwyQCZYV-CoOU4vxN2radT0opzAR2he80ZvRwEVpXEx4WDiFchAvkWWxwrEo5lYqkdJ0Y4mhX5rPBIvcGW1YYIpvSOrmETZKkX8T8CoJPqiCc4IS7rbH4-WXSJ0TolQLVTwIU4eac-A2Mi-XlSY0cbygyRgs_2xgETwU09FToKkLGwP&__tn__=%2CO%2CP-R,23,0,positive,23
1164483424217925,NVIDIA AI,0,9,0,0,1,0,0,0,10,1,"Check out the top talks from #GTC23 now available on-demand.Get caught up on the latest #AI breakthroughs and training in #GenAI, #speechAI, using AI in scientific discovery, and building 3D worlds with neural radiance fields (and more).  https://nvda.ws/3A1FPZO",2023-04-14T00:00:00,[],https://scontent.fcai19-7.fna.fbcdn.net/v/t39.30808-6/341267842_239884825205812_3861077951618373863_n.jpg?stp=dst-jpg_p526x296&_nc_cat=100&ccb=1-7&_nc_sid=9267fe&_nc_ohc=h5GSq6GvMZUAX9Mc8Un&_nc_ht=scontent.fcai19-7.fna&oh=00_AfDU1dl0QMhcx3CZ-3gWVRAy7QAAFIoWfFVLToUs6Qco5A&oe=64E45B8B,https://www.facebook.com/NVIDIAAI/photos/a.119492422050369/1164483424217925/?__cft__[0]=AZWGfGnchljzsiGkK3vGbGKS8oozWeoaQAvcWyE3yZN-hlbeCfawkcgFSKFrKgxq0XWgG279kVxj8N14ZLk8aFyKZgVWMxH28z2DBnApwRG6kPGDGAXEU5RQ6Jm6m3xxR4ousY3ca91nGgoAXsZ77eRl6H5SAx_P5D1UxnF9kCR1Vek9Oouo8PPi8ehmu9uOR1b9-buv0AjyCENk4gLcmbk6&__tn__=%2CO%2CP-R,10,0,positive,10
pfbid02qncrLBmQT9QnEwAFzdwHLsmdstVs1o9NZjw1Q1iWRfppj3oyAPcPBWNDGtxx2Muzl,NVIDIA AI,2,20,0,0,0,0,0,0,20,1,Check out this video from Tech with Tim showing us how to run stable diffusion and any AI model in #Python with PyTriton. #tritoninferenceserver https://bit.ly/3zTA9RQ,2023-04-14T00:00:00,[],https://external.fcai19-7.fna.fbcdn.net/emg1/v/t13/6534716929608750533?url=https%3A%2F%2Fi.ytimg.com%2Fvi%2F6sUDDsHVM90%2Fmaxresdefault.jpg&fb_obo=1&utld=ytimg.com&stp=c0.5000x0.5000f_dst-jpg_flffffff_p500x261_q75&ccb=13-1&oh=06_AbGvo63tLpiZsJ21CfOiy5TqV6WvfAsDwhHeRNGeaybkHA&oe=64E02ED0&_nc_sid=dbad39,https://www.facebook.com/NVIDIAAI/posts/pfbid02qncrLBmQT9QnEwAFzdwHLsmdstVs1o9NZjw1Q1iWRfppj3oyAPcPBWNDGtxx2Muzl?__cft__[0]=AZVNZW0C9YbNdz8v0q5eGJIpUQZcSAklZZ2zBEay7Ykd8BMYKSb3CcisoY6_lcopaJd0MuCyWMRH0RhM6kb75yoEMsPDVIp-p55v2OE45igIrkfP2Yl4vfpbsULyHtuN1luFDVOgAGKb6-rdWnijz-9cUcCcUojt9XTJdrYEhqfC5x2h38kn79hdGyeGvn_rXoU7TtqW9iJPa_3AeHjjygRb&__tn__=%2CO%2CP-R,22,0,positive,22
1164417630891171,NVIDIA AI,0,5,0,0,1,0,0,0,6,2,"Should securing AI systems be seen as a #responsibleAI task?Hear what a panel of experts, including NVIDIAs Daniel Rohrer, think at #RSAC https://nvda.ws/3GGyJOr",2023-04-14T00:00:00,[],https://scontent.fcai19-7.fna.fbcdn.net/v/t39.30808-6/341209692_602344008437927_6631329527023548176_n.png?_nc_cat=104&ccb=1-7&_nc_sid=9267fe&_nc_ohc=36vExADQoN0AX_-jy3n&_nc_ht=scontent.fcai19-7.fna&oh=00_AfAuiyIsnYUQ3L6vawmI8fn-crRgNbtORfOxgqvftMMANA&oe=64E4795D,https://www.facebook.com/NVIDIAAI/photos/a.119492422050369/1164417630891171/?__cft__[0]=AZUzf_yN2lOrEBatHJ2U_461696Z8oT_EClI2tKFeDJxKtEomvin9tEEEncJ_RAMQAP7-vth5kNVQgdjLOkX8NdQz8vbYOaloQ0z65NmTlADoWkQknCJUC6-u1uwDSLLPV4gmiTYz3qbam-BIxRm2b_sq0T7wNEmurviaaRGAAAMep3bXhQ9HxNcGkC5TNu9ONTfOOF8-mxnPQ_M416cOren&__tn__=%2CO%2CP-R,6,0,positive,6
1164400517559549,NVIDIA AI,0,23,0,0,0,0,0,0,23,4,"How can computer vision help retailers grow? Get the answer in our free online workshop where you will learn how to deploy computer vision at scale in retail with NVIDIA & Dive, on April 18 @ 11am CET. Register now. https://bit.ly/43t33WB#IVA #computervision",2023-04-14T00:00:00,[],https://scontent.fcai19-7.fna.fbcdn.net/v/t39.30808-6/341085020_171059558809175_8263771504575893443_n.png?_nc_cat=111&ccb=1-7&_nc_sid=9267fe&_nc_ohc=nlSIHekxBy8AX8jx03_&_nc_ht=scontent.fcai19-7.fna&oh=00_AfCeMg5_7oTppTNkiescMbdE2MrhZTEWGEUPqca9cKydJw&oe=64E42AAD,https://www.facebook.com/NVIDIAAI/photos/a.119492422050369/1164400517559549/?__cft__[0]=AZWf5hcnuQJZC4MfD6m5Vt0K27Hzt0ZE6zYTqsAaKgzGofszV1UlpwY1IjxN3OC9txXFWF7c29qmxee51HdQvV_bzPm-AQ6XUQ6d9wcl2lwyvCiyDidL9h_dxPh6D8QroPILjl0Kq90Qxm_CrH66ePySm82EF3XMrC_qvWn-xFwRH1zxqlg7q37Cuqi5pOx-5s4ufNFOatf5jLXJXv1JgT9m&__tn__=%2CO%2CP-R,23,0,positive,23
1163995174266750,NVIDIA AI,0,6,0,0,1,0,0,0,7,3,Mapping network devices using #AI can preempt cyber threats.Check out examples of this open-source technique at #RSA https://nvda.ws/43xXypg,2023-04-13T00:00:00,[],https://scontent.fcai19-7.fna.fbcdn.net/v/t39.30808-6/341097658_759080929216102_3717657249017588829_n.png?_nc_cat=108&ccb=1-7&_nc_sid=9267fe&_nc_ohc=ms4KrzlQCZgAX-bFxY9&_nc_ht=scontent.fcai19-7.fna&oh=00_AfCqF52xjhMkN24_ZdBhAZgixw9nC6Z-JlK3fYe6BP-LMw&oe=64E2B00E,https://www.facebook.com/NVIDIAAI/photos/a.119492422050369/1163995174266750/?__cft__[0]=AZVxAdv6GdGmeM6_E16T9NSnaQDjN67sHzC_OSl4l1qfAD39aFAVQdbQJeHCfqny1QiURLAJoEhWIGUFkM94tLNcApayhm2jG52nQea1g0qqzfzwTEDLoImJypGFGfpjM-0y0XTa69WXyTTEVUHZ2daQ7Sk15VBWLxVWwnMCrmTJiQuTxWxohKtbv34wEfdeRAOUUdOBdCoZlxXiwN2WS0u4&__tn__=%2CO%2CP-R,7,0,positive,7
1163977887601812,NVIDIA AI,0,24,0,0,0,0,0,0,24,3,"CV-CUDA Beta announced at #GTC23 optimizes pre- and post-processing for higher cloud throughput at a quarter of the cost and energy.  Read how @Microsoft, @Tencent, @Baidu, and @Runway are adopting CV-CUDA: https://nvda.ws/3KzWY1B",2023-04-13T00:00:00,[],https://scontent.fcai19-7.fna.fbcdn.net/v/t39.30808-6/340787180_744901363839755_5454592423606764270_n.jpg?stp=dst-jpg_p180x540&_nc_cat=105&ccb=1-7&_nc_sid=9267fe&_nc_ohc=GAChWlZQCjAAX-KejjS&_nc_ht=scontent.fcai19-7.fna&oh=00_AfA3R6-7NkevQ0XL-PwopCvCMbg2m4wuTLzf5_Q3wQcjyw&oe=64E439A2,https://www.facebook.com/NVIDIAAI/photos/a.119492422050369/1163977887601812/?__cft__[0]=AZV52DGCiSGN7g7FAfqsDlqddldI6g3ET-DXpQhadcFrSNDTGKVI-S29OBNKsVEXXloUcXyhd6qqlKoVM4v_BYtCKoJVrgeWy4sr8pGKqzQN7TWOzJZfDvvrLCc99SMYBbqsUB5EnP6EA-5W2jFKli6MCQa2jR8xgwyarqyAI8wraaMGzpCgTu46t8TonkMkgSf3iUFX1F4kKoJsmnxtyV4M&__tn__=%2CO%2CP-R,24,0,positive,24
1163527874313480,NVIDIA AI,0,13,0,0,1,0,0,0,14,0,Learn how to bring Generative AI applications to life with NVIDIA on Google Cloud with examples from companies Descript and Writer. Register now. https://nvda.ws/3mqFQnb,2023-04-13T00:00:00,[],https://scontent.fcai19-7.fna.fbcdn.net/v/t39.30808-6/341260568_1709977202766341_8398531150249886197_n.jpg?stp=dst-jpg_p180x540&_nc_cat=103&ccb=1-7&_nc_sid=9267fe&_nc_ohc=BkidXmGef_AAX_QgsnC&_nc_ht=scontent.fcai19-7.fna&oh=00_AfB33s7kxIxKUfTj7jcTsC_HT8qFuSy2jlY_ALVg2uEYHQ&oe=64E35A49,https://www.facebook.com/NVIDIAAI/photos/a.119492422050369/1163527874313480/?__cft__[0]=AZWRZKHMFbuNCJvylyuVL7I91gxziVCFfus1qv0SOhI0II7SU604KuuZAeW_Rpmb3A7-FgY8M1O3W4jrx2kAPgynWApm_lynXhLDiwOcT1sc7l9yEWgjUTsfP5wtW5zk_-DhChvRR46zGgDxIbUTD6KDyC2YozgSjllIrYZh_H58tJV9TbbECHKhjukix9QJp4tDGbQf0Ay8JnnWN5Q0bjmN&__tn__=%2CO%2CP-R,14,0,positive,14
1163451177654483,NVIDIA AI,0,16,0,0,1,0,0,0,17,0,Learn how to quickly build and deploy production quality conversational AI applications with real-time transcription and natural language capabilities. Register now for the May 23rd workshop: https://nvda.ws/3ZZ98Xx,2023-04-12T00:00:00,[],https://scontent.fcai19-7.fna.fbcdn.net/v/t39.30808-6/340784152_770075588048943_1169411995246546953_n.jpg?stp=dst-jpg_p526x296&_nc_cat=111&ccb=1-7&_nc_sid=9267fe&_nc_ohc=dlUGAbWjiO4AX9LJgzW&_nc_ht=scontent.fcai19-7.fna&oh=00_AfBL2dB2Ba6RPSseZYPMik3IQKAkecpQuhBKR8RoInzKvw&oe=64E2E6B1,https://www.facebook.com/NVIDIAAI/photos/a.119492422050369/1163451177654483/?__cft__[0]=AZWo9UarAjq0hwl2r44DrtYTl1d5NeV3mCgwVdoyHIVGODLnWLzrY05dsjzhDjNQxalRaiNEOd0rgTh7EbysRz3OvUBaGYD46PRpuUQqPvXRxKoyCTYfqMcSuVyQB4uVKnKURi2F1QV1mi7fXc5BtKuqGPgnJhbrjwdlaiRCp6yDLPEjwA3IKoqsHil4ScQg9QH1x0NJfXfccscoI-sFQLNF&__tn__=%2CO%2CP-R,17,0,positive,17
1163049554361312,NVIDIA AI,0,12,0,0,1,0,0,0,13,0,"Learn how an integration between Nextspace’s platform and #NVIDIAOmniverse has created new capabilities for engineers in real-world asset management, infrastructure, engineering, and business data optimization, including industrial power plants.Download the solution brief: https://nvda.ws/3zQRjPY",2023-04-11T00:00:00,[],https://scontent.fcai19-7.fna.fbcdn.net/v/t39.30808-6/341029237_756163436155039_4536201236623401192_n.png?stp=dst-png_p180x540&_nc_cat=110&ccb=1-7&_nc_sid=9267fe&_nc_ohc=GBgyhjmx-iUAX83DmHM&_nc_ht=scontent.fcai19-7.fna&oh=00_AfAkN_zNsh2afUr_WyLMvY2bYVp08Nl6yiTZUkeQrzgSRA&oe=64E4611B,https://www.facebook.com/NVIDIAAI/photos/a.119492422050369/1163049554361312/?__cft__[0]=AZVGYmPE5qN3Uj4lMBqBs9uw_tVn3rQ6P-WTsQT2LSGWDqS8nfk8-QRx3KAElfInLZ-4IqPJcEiFBCgpoYvc5yffLh6grFhUwT0Kt9q95_nx1glI36R2YDnDGCLOLlV9SkBHdjtMMeVJmjM_hGXguSo_dKV5qFG38ronpPCQlcAfRyznFeJ5tRrc1rrbsQANGt1RR9bOrXkfJWopBFvDSZcw&__tn__=%2CO%2CP-R,13,0,positive,13
1163015657698035,NVIDIA AI,0,15,0,0,1,0,0,0,16,3,"Quick-service #restaurants are turning to #AI to become more agile and efficient. Learn how they’re deploying solutions for speech-enabled ordering kiosks, restaurant analytics, and forecasting. https://bit.ly/3MD2sLN",2023-04-11T00:00:00,[],https://scontent.fcai19-7.fna.fbcdn.net/v/t39.30808-6/340766658_543425337704233_1677449111763864694_n.png?stp=dst-png_s960x960&_nc_cat=106&ccb=1-7&_nc_sid=9267fe&_nc_ohc=bJW-82gmPC8AX_TS5S1&_nc_ht=scontent.fcai19-7.fna&oh=00_AfBQeyimyiH73s6B_jkJSJ3oc2-zTuxxpl2UWIiFTny-4g&oe=64E340A5,https://www.facebook.com/NVIDIAAI/photos/a.119492422050369/1163015657698035/?__cft__[0]=AZX_JIurcjk9mQhwmOmBOZNHpPjjk0zdFNKZyF1H2v7GFVZHld_U9OcRdC2-_1npiAsC2F6AXzglHIO2eriOwgIPGv57EANKXNEZ9rZJFKaZgMWFKQnXPBxWydC_y2wuu8dMGaLT-vBBUHtW_Z0ULKbIfx4PSk-w-m5XhQnlWK68pNBbOS71aB2JtJSJAv0VXDCRP-kQpOO4BMtJzhNS6Sdr&__tn__=%2CO%2CP-R,16,0,positive,16
pfbid036BK4YQqypTJ1tgnCydXdjQSRGgcKTckeWxBoJcWDKa32nLvpKw8a2J6VjVEakjXol,NVIDIA AI,0,7,0,0,1,0,0,0,8,1,Don't miss the #DOCA webinar on April 11. Discover how DOCA and data processing units can optimize your #datacenter and help you solve critical network and infrastructure challenges. Register now: https://bit.ly/41g4fdL #NVIDIAInception #networking #finance #cybersecurity #telco #startups,2023-04-10T00:00:00,[],https://external.fcai19-7.fna.fbcdn.net/emg1/v/t13/6512800290124901019?url=https%3A%2F%2Fprod2-sprcdn-assets.sprinklr.com%2F50276%2F487efd45-98bc-4137-83bc-f7c9ef5cb0ff-543651610%2Finception-q4-webinar-doca-tw-l.jpg&fb_obo=1&utld=sprinklr.com&stp=c0.5000x0.5000f_dst-jpg_flffffff_p500x261_q75&ccb=13-1&oh=06_AbGupBCvNKM6QTkFIjNvj2eXdVXLdcsTOYTDVpVb1vDicw&oe=64E08009&_nc_sid=dbad39,https://www.facebook.com/NVIDIAAI/posts/pfbid036BK4YQqypTJ1tgnCydXdjQSRGgcKTckeWxBoJcWDKa32nLvpKw8a2J6VjVEakjXol?__cft__[0]=AZWdz4IjhhNHKPJsfrwJrStfs8zf8fgZVkKLBzm834P-ASl_Tho_sYWQXfOW_cRTehy95IWFegvjv6A8mvBuh2tY85b1wNExzmH39VAr-1YdINqIxS7FHUAxRpk9TJzTAwUMYFChXmThHPUEgGkkUr2gQgWcnUolahKvBlMgzS9nC4PS_QeUHLkNSyMRzipMnMYHa_Gh2yv_EiChTxuHkSLl&__tn__=%2CO%2CP-R,8,0,positive,8
pfbid02dWMK7d2PTw5AiJP5b4tKsRYuXcPqVR4hvZhYAaacEhFSZQRBoFGPdxT56mK3pSv2l,NVIDIA AI,0,21,0,0,0,0,0,0,21,1,"Powered by the NVIDIA L4 GPUs, NVIDIA and Google Cloud collaborate on the G2 to deliver cutting-edge performance for large inference #AI workloads to run GPUs in the #cloud. Learn more > https://nvda.ws/416Cswg",2023-04-10T00:00:00,[],https://external.fcai19-7.fna.fbcdn.net/emg1/v/t13/7609081556760435413?url=https%3A%2F%2Fstorage.googleapis.com%2Fgweb-cloudblog-publish%2Fimages%2Fgoogle_cloud_2022_H7glFJz.max-2500x2500.jpg&fb_obo=1&utld=googleapis.com&stp=c0.5000x0.5000f_dst-jpg_flffffff_p500x261_q75&ccb=13-1&oh=06_AbF0sLWEyuNKek3wbiXoajytmzcvRtHVvnELiqah7BsR4w&oe=64E03CD0&_nc_sid=dbad39,https://www.facebook.com/NVIDIAAI/posts/pfbid02dWMK7d2PTw5AiJP5b4tKsRYuXcPqVR4hvZhYAaacEhFSZQRBoFGPdxT56mK3pSv2l?__cft__[0]=AZVf34EA-072mGKGwIzKlkuA84_2yvtaHS_hVUni7bRK-ZPhGr1KHLxa9tdfJeNGA1uPzru_tHizeh5g2qVVbYMJ7JULQfUOUaSlo5negr5TgjUc39DEt7j45bDPzdDwwyMU23Dnen7Hxc2FHNNm13-LpcndxKBxQ8Gb081sNLphHDhnHEX7f6Ggayn9qMcpWnZMltNo1RvtPCWzmDpMBKlM&__tn__=%2CO%2CP-R,21,0,positive,21
pfbid0LE8X9j5hQgBnRZJSoB7Q6qzAkYCdLhfrBNzm5QdmXo7FssmNtKEhyg1uDESJA9zgl,NVIDIA AI,2,26,3,0,0,0,0,0,29,3,"#NVIDIADeepStreamSDK provides state-of-the-art multi-object trackers to deliver excellent accuracy and performance, tackling challenging occlusion problems in pedestrian and vehicle tracking. Read this blog to learn more. https://bit.ly/40NVsjq",2023-04-10T00:00:00,['blob:https://www.facebook.com/8d02b215-54ad-448c-a53b-c53f67f16f69'],,https://www.facebook.com/NVIDIAAI/posts/pfbid0LE8X9j5hQgBnRZJSoB7Q6qzAkYCdLhfrBNzm5QdmXo7FssmNtKEhyg1uDESJA9zgl?__cft__[0]=AZXa6O2tjYGf1z9OWi0cbvxvzAI8XUh9w4Oiz9XwZEudMdT9-KwGXS7BxF1IQyUX4juCbHm4oBiSubPjGX_ZwPDgJS_GPU0USs_XUviln_LkSW2jOZ2LypR1cGhfYqGEfFFptM1x_TnmIC4zUg93N-CFDC-o9ErRwwm4mEtvXVvSCvjguoEtMgHisKKdO767zno7Kto9YpkgOzbEU3Yy-r4jfoEsqWIQPEC5g7vqxITs00gO6yi3ABUcgH5ElfMPtFg&__tn__=%2CO%2CP-R,31,0,positive,31
1160950311237903,NVIDIA AI,0,13,0,0,1,0,0,0,14,1,"#AI is helping #retailers improve business agility through innovation at every stage of the business cycle. Learn about the most important AI use cases in retail today across omnichannel management, intelligent stores, and supply chain optimization. https://bit.ly/3UbyoJ9",2023-04-07T00:00:00,[],https://scontent.fcai19-7.fna.fbcdn.net/v/t39.30808-6/340172097_3534926596791487_8749480112495360598_n.jpg?stp=dst-jpg_p526x296&_nc_cat=105&ccb=1-7&_nc_sid=9267fe&_nc_ohc=S7Q9ZLYZYS4AX8zoqV6&_nc_ht=scontent.fcai19-7.fna&oh=00_AfD2dEa885Xj73toMC2cAY7aXWJBv5AWiE7srplAF_5B4w&oe=64E3711B,https://www.facebook.com/NVIDIAAI/photos/a.119492422050369/1160950311237903/?__cft__[0]=AZVDaYFXxAZRHTlI5kEtNSGTc3A9CSLmvYCMbqf64NhQo3Ukd1zRT-Fa6JCNQQizGPKUQfHiqR468F3oiSoBdekCu_fqFV_sDwST7fCgK1k6oSFx77bcOG8alrc9unY6BLB_MQBNKcn4n7VXv_A_CNm58GzWJWuEJ1_yP7yYdA187T9JibMYdGP9O61vR7psN4nzrzkmyUZq2T-FBbvKzy6m&__tn__=%2CO%2CP-R,14,0,positive,14
1160587221274212,NVIDIA AI,0,10,0,0,1,0,0,0,11,4,"Are you ready to compete in an AI-intensive world? Join speakers from Harvard Business Review Analytic Services, IDC, and Microsoft on April 19 to discuss the complex needs of advanced AI and the strategy and tools your company needs. Register today! https://nvda.ws/3MdlyIl#MakeAIYourReality #AzureHPCAI #NVIDIAonAzure",2023-04-06T00:00:00,[],https://scontent.fcai19-7.fna.fbcdn.net/v/t39.30808-6/339916055_170909485834693_9175031376993593668_n.png?stp=dst-png_p180x540&_nc_cat=101&ccb=1-7&_nc_sid=9267fe&_nc_ohc=rKGeS4N2iJQAX9W9q8K&_nc_ht=scontent.fcai19-7.fna&oh=00_AfAsQV_rswuAG9iasABRbt7aFz5Q4US5z8_I1lDw9vgVFg&oe=64E2A41B,https://www.facebook.com/NVIDIAAI/photos/a.119492422050369/1160587221274212/?__cft__[0]=AZWAMnl7VRERQ6f8DXeEbgCydfaKDJqn8T8o5qtMogiwcFKfM4Wa2ywe7no_qLbmZv74qodlJBZ9cbZWs04IooJOizkyisQW0z2lcvkygsU_3xwpbHe66M8AREPvRlrgPyTZHOlMD3P2W3LenfimndxhNUJGYNxEMKe5z2txrfUFddzuEYyKF5Ct3L3dGtUwe3cmEL1RO6_mPFk2ZtPJv1L8&__tn__=%2CO%2CP-R,11,0,positive,11
1160542237945377,NVIDIA AI,0,14,1,0,1,0,0,0,16,1, cuGraph AMA - April 12 at 9 a.m. Pacific. Ask our experts about how to analyze large-scale graph datasets lightning-fast with a wide range of algorithms.Unlock the power of #GraphAnalytics with NVIDIA cuGraph. Register now to participate.  https://nvda.ws/40MgQps,2023-04-06T00:00:00,[],https://scontent.fcai19-7.fna.fbcdn.net/v/t39.30808-6/339573830_944337190239705_866719434469453662_n.jpg?stp=dst-jpg_p526x296&_nc_cat=106&ccb=1-7&_nc_sid=9267fe&_nc_ohc=RKqs8sXiDO4AX-5fX-d&_nc_ht=scontent.fcai19-7.fna&oh=00_AfD5qpq31RI_OT8B2m9bMArmdkEtOEPmv6mr_1yYHamQ0w&oe=64E32B9B,https://www.facebook.com/NVIDIAAI/photos/a.119492422050369/1160542237945377/?__cft__[0]=AZWGLjOiICAq-UpOOuBvW7Z-I2yS9PTP7TEg1K-H2Y0GymlMVc4RCFDsFuermpds0uX2WQsLYpff67yzuCKDTGIqN9rKXEvw5zq0QLHtGVxOCgK7rgRXU7vFmG8Usm0M7vu7xIyEWorbYoNwgkDWaJrw4tfuHKIel1IfcVjdGQSR3O4I8pz3sXqGpCa9ZpLXeb9DeI0LZum0MFeEVj4iVHjB&__tn__=%2CO%2CP-R,16,0,positive,16
pfbid0PMCdGz58V95vZMfucxjcYKVLLGK13vAYPD6ADK3fbB9C5Wnvhn8xN2VLK7qqvMkwl,NVIDIA AI,0,20,0,0,0,0,0,0,20,6,"All about the gains: from dataset preparation to creating a clustering dashboard, dive into a brief technical tutorial on how to create a Twitter topic model. https://nvda.ws/3mgfa8p",2023-04-05T00:00:00,[],https://external.fcai19-7.fna.fbcdn.net/emg1/v/t13/6007802940335715278?url=https%3A%2F%2Fdeveloper-blogs.nvidia.com%2Fwp-content%2Fuploads%2F2023%2F03%2Ftwitter-topic-model-dataiku-diagram.png&fb_obo=1&utld=nvidia.com&stp=c0.5000x0.5000f_dst-jpg_flffffff_p500x261_q75&ccb=13-1&oh=06_AbHnobuPVlyuXqDrbRElpJL3Hz1ZeIzMilOkef9Om9AeiQ&oe=64E04A3E&_nc_sid=dbad39,https://www.facebook.com/NVIDIAAI/posts/pfbid0PMCdGz58V95vZMfucxjcYKVLLGK13vAYPD6ADK3fbB9C5Wnvhn8xN2VLK7qqvMkwl?__cft__[0]=AZX0sQ5XNoQiGucaWPYXNn0souIIVxeCirX5YaQCmpfEt3OdPt4TKVrZzWtJ8F6ddg5cKcOwqx4ZFcqXem7H2KAYF6MthWdM0404xRJXzWRWb4aEvoL3hVaWyR1JcuGhUXcnJiMhC8LtQ2w8BH1mjbpJk2PAj_NsT5TbcZNspQEg5Kgx-N69C5e34EHYNzAxx8VOozgteTM2NDjMdAMGm5QB&__tn__=%2CO%2CP-R,20,0,positive,20
1160106477988953,NVIDIA AI,0,28,0,0,0,0,0,0,28,7,Learn to train the largest of #neuralnetworks and deploy them to production in this instructor-led workshop on May 3rd. #modelparallelismRegister now: https://nvda.ws/3nPVYPd,2023-04-05T00:00:00,[],https://scontent.fcai19-7.fna.fbcdn.net/v/t39.30808-6/339614573_1472841606585143_4385064965558438257_n.jpg?stp=dst-jpg_p526x296&_nc_cat=111&ccb=1-7&_nc_sid=9267fe&_nc_ohc=wrDOull4-f4AX8YE7XM&_nc_ht=scontent.fcai19-7.fna&oh=00_AfDzstNxt3Vkdu4zDIJBpThvDYcPTW695gxxfjYMZcgJDw&oe=64E381E7,https://www.facebook.com/NVIDIAAI/photos/a.119492422050369/1160106477988953/?__cft__[0]=AZWRt7R1Ol64QObkPTf8efHY15HEG9RTEomeCz45LF-5-W0dmrATUcmUBtinOi1Wyutuvm0UlgGMOsS81QdZPSvZAdJ1fyqAArqGvq28jtPZdsDAFQb03owmUgVAV_AcYJfj7fPOasYhy1XTPI6wqaqiEG6frvzTjVBNpFnWGlMjxzKYFNvnEOvB43Xp-hMsDhPvrkvFY4MMX4uPOK7nvRaS&__tn__=%2CO%2CP-R,28,0,positive,28
pfbid0be1qQZb27XPY4K4cZuRSZPEr3X1WDUMhKqxFFEqZgc5c4CJiJkZNf1Ghs4XMSnLVl,NVIDIA AI,3,16,0,0,1,0,0,0,17,2,"Transform your retail operations with data. Read the latest tutorial on how to use GPUs to speed up forecasting, markdown optimization & more: https://nvda.ws/3nEpkQu",2023-04-05T00:00:00,[],https://external.fcai19-7.fna.fbcdn.net/emg1/v/t13/15120726372646354500?url=https%3A%2F%2Fdeveloper-blogs.nvidia.com%2Fwp-content%2Fuploads%2F2023%2F03%2Frapids-spark-gcp-featured.jpg&fb_obo=1&utld=nvidia.com&stp=c0.5000x0.5000f_dst-jpg_flffffff_p500x261_q75&ccb=13-1&oh=06_AbGK3B6LDgWKKi1Ya44k1MfziP_AUFTsrBvD5ioSE4zbfg&oe=64E0A153&_nc_sid=dbad39,https://www.facebook.com/NVIDIAAI/posts/pfbid0be1qQZb27XPY4K4cZuRSZPEr3X1WDUMhKqxFFEqZgc5c4CJiJkZNf1Ghs4XMSnLVl?__cft__[0]=AZXlR_S2sVbpHYZoESCTH2ch2q_Zk9AjFwi4VCWBsve_wORV4Zx6KopxwCPEm0_gXyVOLz09JHwBQoxzB56s1UzoWydjNBvWVBJcZM4Bt089l-9By-IhD6bo0oQKdYjag8PDYmPBImsScsWtFdTVLMpuOF1O5F-Pm5MjivwSZu40UmG6gPto0vl6FEudpziwWKJ8CGFTr0_CcmqMgfw9qSyv&__tn__=%2CO%2CP-R,20,0,positive,20
1159692124697055,NVIDIA AI,0,11,0,0,1,0,0,0,12,1,"From forecasting to last-mile delivery, #AI is redefining the #retail industry. Tour our AI-enhanced landscape to see the possibilities in action. https://bit.ly/3GiKYR3",2023-04-04T00:00:00,[],https://scontent.fcai19-7.fna.fbcdn.net/v/t39.30808-6/339806760_3620326641528607_4458320424777671373_n.jpg?stp=dst-jpg_p526x296&_nc_cat=103&ccb=1-7&_nc_sid=9267fe&_nc_ohc=pH5xwC_x6mEAX-haXJ8&_nc_ht=scontent.fcai19-7.fna&oh=00_AfDlIhZRDCabcjC0ZGOU3UnDHJwZrIHeni4B3ysgxMXCiw&oe=64E2B801,https://www.facebook.com/NVIDIAAI/photos/a.119492422050369/1159692124697055/?__cft__[0]=AZUyd7CGpuTub5_1ompMfBFL90e0KzN8qz0_8mPSR1BbxIEYNUjmERdK_ogcUbyN62PAez0ocLXWhMDOxmQxHNMY2xBGoBbfdWdq5IwNcZl7RbBl5s1sZULGv8yhMLmOMU6QxJcBK2Hi_gf9u01V3NobNpaHOt670lgyVWjtBw3rulKAya5fwTkbBHSqx_veB2dI4q-_jVCp-I8MapVFGbIx&__tn__=%2CO%2CP-R,12,0,positive,12
1159658271367107,NVIDIA AI,0,18,1,0,1,0,0,0,20,3,"By adopting digital twin technology like Microsoft Azure AI infrastructure that leverages NVIDIA’s GPU-accelerated computing, #digitaltwins can offer new sustainable opportunities for organizations to begin their net zero journeys. Learn more > https://nvda.ws/3zvfnrl#NVIDIAonAzure #AzureHPCAI",2023-04-04T00:00:00,[],https://scontent.fcai19-7.fna.fbcdn.net/v/t39.30808-6/339791352_235548932297452_6894588625663436851_n.jpg?stp=dst-jpg_p180x540&_nc_cat=103&ccb=1-7&_nc_sid=9267fe&_nc_ohc=a8eVi9hZWAEAX8fKV6Q&_nc_ht=scontent.fcai19-7.fna&oh=00_AfAIW6tlUwA1ba3eYzxAzKiWKYvxfCy90ckfW4KZMfiUOQ&oe=64E3C336,https://www.facebook.com/NVIDIAAI/photos/a.119492422050369/1159658271367107/?__cft__[0]=AZUc4FR_ZyJeaN3D1NOF6DuuJ0_j_0Rl_8EKwTGCp2MOfktuaEVZ9p5XK66Kmb_smyJeQSzOBO_6REibBBpSqQ2EaVo4os1kmcJeoVMEOxMyNheM41VuC-biWJNo9Om9fxD4lpUqnXzswhCuLV_hx0J9v8F_TSPoTAEso_bFlnQAf2sFDXRT2Mp-VxOMQp1YYr3xTKvWcfR-e43R-MyvWhb_&__tn__=%2CO%2CP-R,20,0,positive,20
pfbid07z3e9yo59fDWHYgYU9ehgUHbkugRTpfWxuKpThbbHkeDcQHxYo1WUFLSSa39hhhEl,NVIDIA AI,0,9,0,0,1,0,0,0,10,1,"Can GPUs be used for more mundane ETL & feature engineering stages?Unveil how AT&T evaluated the utilization of GPUs to optimize their data pipeline for speed, cost, and design simplicity. Read up on their analysis results: https://nvda.ws/40LUq72",2023-04-04T00:00:00,[],https://external.fcai19-7.fna.fbcdn.net/emg1/v/t13/15968700019643256792?url=https%3A%2F%2Fdeveloper-blogs.nvidia.com%2Fwp-content%2Fuploads%2F2022%2F09%2Fatt-spark-featured.png&fb_obo=1&utld=nvidia.com&stp=c0.5000x0.5000f_dst-jpg_flffffff_p500x261_q75&ccb=13-1&oh=06_AbGEULWajhrbOPJTEoC5VNjV7Pax3qUu9NCeRTzJiy7R_g&oe=64E053A9&_nc_sid=dbad39,https://www.facebook.com/NVIDIAAI/posts/pfbid07z3e9yo59fDWHYgYU9ehgUHbkugRTpfWxuKpThbbHkeDcQHxYo1WUFLSSa39hhhEl?__cft__[0]=AZW-fGqiEwED2VdY9iJPPLA80tSY8CxCd1Jm-ADmHvawajjk2n5ZekVI0SJGvUwKUNxiOZ6z7mA_icLPCNbSSLT2oiqaxFNDwiWV_U2YvT60oyo3UzAz5TrbKt6pep-8YvcZakqfbwnTHBP3JGqYaJsz1N6JYInu4Lerbo6IPIfanyGK6SP5QB6Xr-7kla_g4u4OLc43yQYCzHgP1vZYLAjR&__tn__=%2CO%2CP-R,10,0,positive,10
pfbid02Hnp3mVCGWL3bFywPvVZGsuKxGNcQLbPzvU7XvHoM4o2hgMYxM95PyYVuk5LfBvVbl,NVIDIA AI,0,8,0,0,1,0,0,0,9,0,Interested in changing the functionality and user interface of NVIDIA Omniverse more to your liking? Customize the #NVIDIAOmniverse experience with extensions using #Python code. Learn how in this self-paced course: https://bit.ly/3K7vGQ3,2023-04-04T00:00:00,[],https://external.fcai19-7.fna.fbcdn.net/emg1/v/t13/15955961464287662856?url=https%3A%2F%2Fprod2-sprcdn-assets.sprinklr.com%2F50276%2Fcb42d5aa-b0f7-4022-91de-8111294b0899-207199185%2Fdli-social-training-course-omn.jpg&fb_obo=1&utld=sprinklr.com&stp=c0.5000x0.5000f_dst-jpg_flffffff_p500x261_q75&ccb=13-1&oh=06_AbH8M-JyE88G-L_BDCVsUr1bQwHAUseGoiIL4mwJZAJesw&oe=64E06A17&_nc_sid=dbad39,https://www.facebook.com/NVIDIAAI/posts/pfbid02Hnp3mVCGWL3bFywPvVZGsuKxGNcQLbPzvU7XvHoM4o2hgMYxM95PyYVuk5LfBvVbl?__cft__[0]=AZX7oFMTMr_YZ_9i1BUrtLnrTLwi8lQTTl5PhSVETKCte7t0Ah3f_XrR1YVDSu8yepvjTdX7uLKtiXjjFA33ADPHN7q8tg3IDO-KBNS3GgXRt7ZPi0w-i-i_ax8YycGSGnzuM2TBqS2xpdl23z_-Fsx1aTV2veONe6Jl_8nzlu-TCwKeqeWOlUhfGMptSNcK_zR2fHLktZgRNyM1o9POvFs9&__tn__=%2CO%2CP-R,9,0,positive,9
1159178508081750,NVIDIA AI,0,18,1,0,1,0,0,0,20,1,"Join NVIDIA and Lenovo Data Center to learn how to enable edge #AI for automation, efficiency, and improved consumer experiences. Register for our webinar on April 5. https://nvda.ws/3lSKr1a",2023-04-03T00:00:00,[],https://scontent.fcai19-7.fna.fbcdn.net/v/t39.30808-6/339915558_724473545946164_1247367726582411085_n.jpg?stp=dst-jpg_p526x296&_nc_cat=101&ccb=1-7&_nc_sid=9267fe&_nc_ohc=FzpAZJ84J0AAX9fkx9M&_nc_ht=scontent.fcai19-7.fna&oh=00_AfBn45uWHY2CWC4SrcixwjYHt8mFOHOsZkLMbz7Y4z-xng&oe=64E2AEEB,https://www.facebook.com/NVIDIAAI/photos/a.119492422050369/1159178508081750/?__cft__[0]=AZViQGdvdSw3EPJn1G7fHfJ2zTsBI-guy99QdtJ4Wx1WovRJN2FGRrpcRwJrEt9CnJuyxkdoYXGwT1WC38Ubk8RM6NEclO7MpF3lk_xAV8iI8gGfQ1i0cpFI4wf0LljfPqL6kZi-RfvuJAgpDXWQy8j2-MT2ClRjOSfaGmWPaWQZ0d7CslIn0RMwiqbZ9PL7bSdPksM8vfuw4IpsSazH8Iyg&__tn__=%2CO%2CP-R,20,0,positive,20
pfbid0Eyeotgt37VfhmgdgeXyRoECC3GHFwSMkeTUxbkEsLn2ZRP48aQ61Z2rAg9un8SJMl,NVIDIA AI,0,10,0,0,1,0,0,0,11,3,Don't let bottlenecks slow you down when designing your app—dive into RAPIDS RAFT's library of building blocks for ML & data analysis: https://nvda.ws/3lZuhDc,2023-04-03T00:00:00,[],https://external.fcai19-7.fna.fbcdn.net/emg1/v/t13/9755741541929009278?url=https%3A%2F%2Fdeveloper-blogs.nvidia.com%2Fwp-content%2Fuploads%2F2023%2F03%2FRAFT-featured-image-data-squares-connected-16x9-1-2048x1152.jpg&fb_obo=1&utld=nvidia.com&stp=c0.5000x0.5000f_dst-jpg_flffffff_p500x261_q75&ccb=13-1&oh=06_AbHqnXDky5BogCsiYOjaIhhIV_7KjKohBVpBeZqiZ4LrIg&oe=64E055CC&_nc_sid=dbad39,https://www.facebook.com/NVIDIAAI/posts/pfbid0Eyeotgt37VfhmgdgeXyRoECC3GHFwSMkeTUxbkEsLn2ZRP48aQ61Z2rAg9un8SJMl?__cft__[0]=AZVgDg3uLF2kUak1Uo1HUKD4pNCsf1D6Zag31yNTtoUIxhk5fWjPdAAza-KdD17paQ9-8aA-kwFb2aA0oM91P5RsnpQ3kFY7XyyOEi-gVnEZVzpOlC8mxEgRvTcXhsebtoz4RaZHLUN4nS6lASECr5SC1JOCG3khFQfZyUYMJdugRd6ispDGyUF1Pv9RIhTcXO1yUoqHVWL3Tm-nHfdWi39I&__tn__=%2CO%2CP-R,11,0,positive,11
1157792151553719,NVIDIA AI,0,9,0,0,0,0,0,0,9,1,"Did you know that infrastructure's make-or-break plays a crucial role in the success of your AI strategy?  Check out the VentureBeat Make AI Your Reality hub for insights, analysis, and expert advice that will help you further improve your AI journey. https://nvda.ws/3lZfPuK#MakeAIYourReality #AzureHPCAI #NVIDIAonAzure",2023-03-31T00:00:00,[],https://scontent.fcai19-7.fna.fbcdn.net/v/t39.30808-6/338344232_228339403048779_8829900049925705547_n.jpg?stp=dst-jpg_p180x540&_nc_cat=106&ccb=1-7&_nc_sid=9267fe&_nc_ohc=v5uGOoWX14wAX9ZlY-J&_nc_ht=scontent.fcai19-7.fna&oh=00_AfDRXKD3ieHcKg67mP86pq7xoqkFI48PL-rsRZ-2-TF7LQ&oe=64E40CD2,https://www.facebook.com/NVIDIAAI/photos/a.119492422050369/1157792151553719/?__cft__[0]=AZVSXzlu9--GPoS7Q9bHyYzetOcxbu-99qfYV2SpK4HHz9a_8oKkPvGgCs_m9V2LNVV6xTrD8dlEkpZXVkcRTUDVFf8ujkREDihkSQ_BnIRCZAQtR1al3ME-gf3J3ZrvD9UdeAPagT1Gxn5W8a8GusmIlRj7LhCxiJ9SIPMdSz8uTToizdG0DJClr4-0X3RQfxSlwkBjcrcrbKH4zvLpnyTk&__tn__=%2CO%2CP-R,9,0,positive,9
1157749401557994,NVIDIA AI,0,18,0,0,1,0,0,0,19,3,75% of edge #AI projects never make it to production. Register for our webinar with Lenovo Data Center to learn how you can establish a successful edge AI strategy. https://nvda.ws/3Zoi48F,2023-03-31T00:00:00,[],https://scontent.fcai19-7.fna.fbcdn.net/v/t39.30808-6/338191946_226635579905556_4221556807083191564_n.jpg?stp=dst-jpg_p526x296&_nc_cat=101&ccb=1-7&_nc_sid=9267fe&_nc_ohc=Pd2WJzvx4awAX_3NrT6&_nc_ht=scontent.fcai19-7.fna&oh=00_AfC5SWck9JB2tx1H3JZFW4sLwH99AjmOvF1qBx2XdjfPsw&oe=64E4842B,https://www.facebook.com/NVIDIAAI/photos/a.119492422050369/1157749401557994/?__cft__[0]=AZWBNMdmK1i9gPFLRgJLGxNAcLByXGXa8Q7BuLf2YWdX0HiNUdASr22MjgDkMlrhKDOyeYKir46p-hKkP7T4QcXfmJLw5zcj0o4uRIzSAtAQYuPVmtAWgJ3MuYPWDhMvk3nq9nmr8uwSeqjsQHM40-nh_eGDiKoB_Hx9nwZ5b8OTxy-vuKLpY5iPl0ibHqCKUEfd1W0DVgtsYK0d8oC_SylC&__tn__=%2CO%2CP-R,19,0,positive,19
1157437684922499,NVIDIA AI,21,50,3,0,0,0,0,0,53,3,"PepsiCo is deploying advanced machine vision technology from startup KoiReader Technologies, an #NVIDIAMetropolis partner, to improve efficiency and accuracy in its distribution process. https://bit.ly/40xCde2",2023-03-31T00:00:00,[],https://scontent.fcai19-7.fna.fbcdn.net/v/t39.30808-6/339112405_218361954204316_6993839717390762493_n.png?stp=dst-png_s960x960&_nc_cat=101&ccb=1-7&_nc_sid=9267fe&_nc_ohc=hGL77I9B5gkAX8RUl-Z&_nc_ht=scontent.fcai19-7.fna&oh=00_AfBSzlNcwoImTQvBaPwnN7HtgVSz4GsvuT0ulPN22WxUrw&oe=64E2DE3E,https://www.facebook.com/NVIDIAAI/photos/a.119492422050369/1157437684922499/?__cft__[0]=AZWPs-RyDBtGoytRfWUw6FxSFuXZQxQnaVhjDD4PbRnqq-B174LGQ2OFLTI3M1mozTOe_0foiNiYEDH2TKluQxWWT5SmtJ0WiufFysN2L3s-i-lcY1oAijSVXezMbvXRWQAXBTTMHYz9Yac9r8es67qxi4rQzK4bdchu1zOCgSEhgLYUGQ8O83kF9m8b3zttummmhrL-NB1SFrohbpeYyqcw&__tn__=%2CO%2CP-R,74,0,positive,74
pfbid0PtYWhv3M5z4bX3JF7EaEmU7WaWSRBpTV5S6S9XmRLZpjj6wVseTr9FtSJLdKPPV9l,NVIDIA AI,0,12,3,0,2,0,0,0,17,0,"Have you heard about #NVIDIA Picasso?  Generate images, video, and even 3D assets through a simple API call in no time. Learn more about our announced cloud service for #generativeAI.  https://nvda.ws/3zlBX5S",2023-03-31T00:00:00,[],https://external.fcai19-7.fna.fbcdn.net/emg1/v/t13/9258528511466980250?url=https%3A%2F%2Fwww.nvidia.com%2Fcontent%2Fdam%2Fen-zz%2FSolutions%2Fgpu-cloud%2Fpicasso%2Fnvidia-picasso-services-og.jpg&fb_obo=1&utld=nvidia.com&stp=c0.5000x0.5000f_dst-jpg_flffffff_p500x261_q75&ccb=13-1&oh=06_AbF5AHLUOMkNRmRFYc9tp-P99tU5h2OfrHfAGJXdhDdJqw&oe=64E068D0&_nc_sid=dbad39,https://www.facebook.com/NVIDIAAI/posts/pfbid0PtYWhv3M5z4bX3JF7EaEmU7WaWSRBpTV5S6S9XmRLZpjj6wVseTr9FtSJLdKPPV9l?__cft__[0]=AZU0jiEJGnRwzzCBHkKvz4AXy-quW_RF0DL5SV_OX4LREOxixAXKBv1wEi1YrK0Fn2OF_pcXDSGH5LJiyYr9OIkdXQuCXDAbQVLHYAuAbaw3pK_lTOXRpXbrTI4kh6wsUroGZVIfG-dmiziQAIbnrXL1gIAjEroFak_Q1wZ2btZffegt1XTBabSaQH6u3VLOIdaLCKibrgfZO1WB2MnVuP_E&__tn__=%2CO%2CP-R,17,0,positive,17
1157220744944193,NVIDIA AI,0,22,2,0,0,0,0,0,24,2,"NVIDIA Hardware Grant Program recipient, Open Climate Fix uses a cluster of NVIDIA RTX A6000 GPUs to power its work. See how NVIDIA technology has helped them develop and iterate on their models more easily! https://bit.ly/40oj6Ty",2023-03-30T00:00:00,[],https://scontent.fcai19-7.fna.fbcdn.net/v/t39.30808-6/339054065_143391098684012_9132233551696637189_n.png?stp=dst-png_s960x960&_nc_cat=108&ccb=1-7&_nc_sid=9267fe&_nc_ohc=NXzGEjQLBXYAX-kikQ9&_nc_ht=scontent.fcai19-7.fna&oh=00_AfCp4GyQ2PWAN-ZZegc6BGv6aQ1RUpA6faqFRX-XIi094Q&oe=64E3CD29,https://www.facebook.com/NVIDIAAI/photos/a.119492422050369/1157220744944193/?__cft__[0]=AZWqEKS1-ltTjP7p38LJ1-BHCQQtvTyXHcg0zxfzkQn_K4btxvk_QcH8kmfWDMof1RBRgHNDKq_aHLWoDrHmRTkRewbyM2P5t-iBrMXgU1W41RAWRVooyglmKjr4QRM8TsqgdTYM4QZC0PEBk1vIbAKrHWjTEJ1Jyx3VxFkAnnwJUKkenl0NBM_gJoihHjvsKlyd4zG1OOuKm425b8gVMmNC&__tn__=%2CO%2CP-R,24,0,positive,24
1156926738306927,NVIDIA AI,0,12,0,0,1,0,0,0,13,1,"What’s the best way to accelerate purpose-built #AI production smoothly and economically at scale to create value and business growth? Watch this VentureBeat webinar with experts from NVIDIA and Microsoft Azure to learn how to lower the barriers to AI, keep precious internal resources focused on data science and AI, and speed time-to-value. https://nvda.ws/3KfJOYK#MakeAIYourReality #AzureHPCAI #NVIDIAonAzure",2023-03-30T00:00:00,[],https://scontent.fcai19-7.fna.fbcdn.net/v/t39.30808-6/338971473_947657822923705_2983103752206289044_n.jpg?stp=dst-jpg_p180x540&_nc_cat=103&ccb=1-7&_nc_sid=9267fe&_nc_ohc=BdD7AavXOyEAX_eVM31&_nc_ht=scontent.fcai19-7.fna&oh=00_AfAIYZx-V8Hw6v3vQ6ii0uapTr4YLu6h2ShjkgABhBffQQ&oe=64E47307,https://www.facebook.com/NVIDIAAI/photos/a.119492422050369/1156926738306927/?__cft__[0]=AZWu5vkf_7s3P0VpM7fLoZ9NMQ_CfeZA4klRRo4a7THhNglaTA5xzxw8kXWNkqXRM26oneHAnu2FYrpuoLZA8kQYHyFDat4xXeNhC3ZqL0jONYo0lVQZZNZYoys-UIcdFz__s0VgiYENIpTG_tRh1dw_whOwHDl2aX7sNsgvB3VLPGV2tLWhVERlRS-4n96Kpb2zEwo8WviYOWub9g6ZxcZt&__tn__=%2CO%2CP-R,13,0,positive,13
1156894321643502,NVIDIA AI,0,6,0,0,1,0,0,0,7,2,Build your #AI strategy with Lenovo Data Center from the data center to the far edge. Join our webinar on April 5. https://nvda.ws/40u3DkQ,2023-03-29T00:00:00,[],https://scontent.fcai19-7.fna.fbcdn.net/v/t39.30808-6/338349808_1034383240870814_368451076542717135_n.jpg?stp=dst-jpg_p526x296&_nc_cat=101&ccb=1-7&_nc_sid=9267fe&_nc_ohc=1xZCL0vprn4AX8eBUv6&_nc_ht=scontent.fcai19-7.fna&oh=00_AfB2y1nwOQmq057ADw2729U5ywYHHzOIXjtMqs0jPYEhTQ&oe=64E4008D,https://www.facebook.com/NVIDIAAI/photos/a.119492422050369/1156894321643502/?__cft__[0]=AZW8ky4F3rfOl4ESy-uZfQ51IdFD222F8P1CQleJXlqRebGEN0weTwtju3xHUrttGV2hIOfdJRb6i66__LZi9NYxfp8l1AC7qBLvknkzk6UpaSupy3qlzNw9TpfoFujVGNV_xB45BDrOfDTbo6mxNQtX77zRRgbIGZbIB_9JuKxVz7ZuefolOut_G79tsCmbDV7L3_3LyLZVlwblqQg03J3B&__tn__=%2CO%2CP-R,7,0,positive,7
pfbid05npKBsXdbiXqWczosnCr3FAuSgxpYgg2pHVcUbZRBDPbP8yHavqsRY5asMpUKNEpl,NVIDIA AI,4,12,0,0,1,0,0,0,13,1,Data to insight up to 40x faster with accelerated data analytics.Read our new accelerated #DataAnalytics blog series to try RAPIDS cuDF for your next data analytics project: https://nvda.ws/422atPE,2023-03-29T00:00:00,[],https://external.fcai19-7.fna.fbcdn.net/emg1/v/t13/4477910795573631813?url=https%3A%2F%2Fprod2-sprcdn-assets.sprinklr.com%2F50276%2F429a3a6d-4b8a-48f7-a6f4-9512e227ca50-973383747%2Fdata-analysis-accelerated-feat.png&fb_obo=1&utld=sprinklr.com&stp=c0.5000x0.5000f_dst-jpg_flffffff_p500x261_q75&ccb=13-1&oh=06_AbFfN143h3oDK34rW__EV3czpqg3uMMtPmvdWQCXPPMc2w&oe=64DFFDCA&_nc_sid=dbad39,https://www.facebook.com/NVIDIAAI/posts/pfbid05npKBsXdbiXqWczosnCr3FAuSgxpYgg2pHVcUbZRBDPbP8yHavqsRY5asMpUKNEpl?__cft__[0]=AZV2Zm4uPkAddteZfStujh-55pjVqLF7qwC9OLyRtWK8MQkJXWZwSrsr-p8dNGydMc6puSMAFByK7Z8Sa_FR_CIt255q8RyHDFBMU3rqmaLOrAnXxmjcfEah6aa5BN9B5ty_OYR94lqb-eVa7DlhXKHnwIHuU_BftyzMehHC92PQNM1XjY9p7QdDCleQ-Y7W9RWznSS-_-WYC99bzK60SQsl&__tn__=%2CO%2CP-R,17,0,positive,17
1156754041657530,NVIDIA AI,0,31,4,0,0,0,0,0,35,2,"Learn about the 4 ways you can start using NVIDIA GPUs to accelerate your computing work, as well as the basics of how GPU computing works and the types of speed-ups you can see across a variety of workloads when you parallelize with a GPU. Register here: https://bit.ly/3FUQ2Li",2023-03-29T00:00:00,[],https://scontent.fcai19-7.fna.fbcdn.net/v/t39.30808-6/337886152_212739838022758_384813960551987794_n.jpg?stp=dst-jpg_p180x540&_nc_cat=101&ccb=1-7&_nc_sid=9267fe&_nc_ohc=MfznqI_a7F8AX8wLlW_&_nc_ht=scontent.fcai19-7.fna&oh=00_AfCP1NIHyHtzenp-nj5relvULK3DtrhtOwE9Z_llrqGWbQ&oe=64E3D32D,https://www.facebook.com/NVIDIAAI/photos/a.119492422050369/1156754041657530/?__cft__[0]=AZX4C4BNhOnyBVTyjnV59vTM-s70AjV776uePO_LyamWs0PuvlSYmpr2TS9HYWWQgojtc7qgcKaTHO541vB5Q_DUYbrEuwLK63q9eRG8PuJwD_3fiSs_V1dOIEaY0j1KuwKf2ExD07OqNb0Ye-1qotlr0ulyP3gO30E6VManbc6ufHjIv3h5MV7tjhgF0rknk1aqfgOKfYEmArur4URlQr-K&__tn__=%2CO%2CP-R,35,0,positive,35
pfbid025K5PvQZpCekaPZCbRQnHCTLZUoHozdjHBMhBwRj2zDfn6HgLqdM28D4C74DXdUH2l,NVIDIA AI,0,7,0,0,2,0,0,0,9,0,"Without a keyboard or mouse, VR game users often struggle with navigating their environment. How can XR developers design a more natural experience and improve accessibility?The answer is clear: add #speechrecognition and #texttospeech capabilities. Learn more in our blog: https://bit.ly/3Kf8PDt #NVIDIA #speechAI",2023-03-28T00:00:00,[],https://external.fcai19-7.fna.fbcdn.net/emg1/v/t13/3358021961415619257?url=https%3A%2F%2Fdeveloper-blogs.nvidia.com%2Fwp-content%2Fuploads%2F2022%2F09%2Fconvai-gtc22-fall-promo-pack-xr-applications-1600x900-1.jpg&fb_obo=1&utld=nvidia.com&stp=c0.5000x0.5000f_dst-jpg_flffffff_p500x261_q75&ccb=13-1&oh=06_AbElzm8FWmixAhsHLxgQ77dYHp2n5iaWPux-wrKhWuKN1Q&oe=64E02933&_nc_sid=dbad39,https://www.facebook.com/NVIDIAAI/posts/pfbid025K5PvQZpCekaPZCbRQnHCTLZUoHozdjHBMhBwRj2zDfn6HgLqdM28D4C74DXdUH2l?__cft__[0]=AZUhRavt81UTEbOZdLf6lF0yrWrPMkASNtzWZdRxL-HVx3YAGXq-WbxrZygs7DANnJcRbkJN_z0-vfw5Tb9PzDefW_p4wPWcQez8OkmPX-MFTw2mIjT1BzBN5xpHSqWbXfB76L8H39EQ8Hpu4z3lh6eVeKlnXG5ZhvJdiGolCVQI30V7r3lMIk27eHoys_-LLybx3CMM6w_Sgsvaqa_5oMpb&__tn__=%2CO%2CP-R,9,0,positive,9
pfbid02oNW6CASZMHJjdhyd5SfdSbjBW2GkBdU8BNjL5h6QBmXmMfA7yeigZGpTWznhBzyDl,NVIDIA AI,0,17,1,0,1,0,0,0,19,0," Realize the potential of #generativeAI. . .Increase access to gen #AI tools, SimReady #3D assets, and #SyntheticData generation services with updates for #NVIDIAOmniverse announced at #GTC23.https://nvda.ws/3lDZmfG",2023-03-28T00:00:00,[],https://external.fcai19-7.fna.fbcdn.net/emg1/v/t13/13245741848390712691?url=https%3A%2F%2Fblogs.nvidia.com%2Fwp-content%2Fuploads%2F2023%2F03%2Fove.jpeg&fb_obo=1&utld=nvidia.com&stp=c0.5000x0.5000f_dst-jpg_flffffff_p500x261_q75&ccb=13-1&oh=06_AbEosYNMdN4UTp9XkRE3zzjR_zL4hgQIpWNBK-EFgr8wog&oe=64E0997E&_nc_sid=dbad39,https://www.facebook.com/NVIDIAAI/posts/pfbid02oNW6CASZMHJjdhyd5SfdSbjBW2GkBdU8BNjL5h6QBmXmMfA7yeigZGpTWznhBzyDl?__cft__[0]=AZVXAvv9wRUTK94HG2UqNEAp4vAXW1fJnp4grnXEHVjanJCs5P0GteBcoQZKMdi7GngC4mqM9iK78SaS0Ede07oDmQ9kGlwAQ1QY6DLd36tnAmvm0kmQ8gFQgthLbNb_YQ6bfN52vJVgTc5yJMccl9taKka8dIJ491O_txBaYP0uFnUYgp_Ivzuijbwdehln6KjtosvA94om9VnpquzaOSRb&__tn__=%2CO%2CP-R,19,0,positive,19
pfbid02iXwbCkAeD4hrbbJjfAhBZCNPFMiQUHMVb6ybKYzYxrFsi4rggypfursEeHBfiVg6l,NVIDIA AI,0,15,3,0,1,0,0,0,19,3,How can #AI optimize chip design?Learn how AutoDMP optimizes macro placement for chip design with AI and GPUs.Read more:  https://nvda.ws/3zeFwe1,2023-03-28T00:00:00,['blob:https://www.facebook.com/316f654d-15e2-4a84-8140-218e8a058684'],,https://www.facebook.com/NVIDIAAI/posts/pfbid02iXwbCkAeD4hrbbJjfAhBZCNPFMiQUHMVb6ybKYzYxrFsi4rggypfursEeHBfiVg6l?__cft__[0]=AZURtZ0SDhVT-mBVjYE6vGlKutfr-_s1xdTx5iNtaEt9mBo5asrzc4e19G3jWCkC3gxv-P2jrGZjdMGOPG4yTRvYragJTX38tCIDrs0TsPSc08ssW9T6lSx12anpsh5uZ5bw7Rcu6Rw8vqkmsnfNbj61GK-yH8mlKQwwIZOCkXRypDB2BUKi1gIWYS5Z8rGvNt-Mfpb4HFrYazAWRPhY7O1lnZ_WfQ5U2YGfbqhewIFtJg&__tn__=%2CO%2CP-R,19,0,positive,19
pfbid02FK6FzmxrmcQt1byNrR42aTYmE2bXrTqdxBu7vrUetPtkgzzxCE4H2x7mtHpnE7Vrl,NVIDIA AI,0,4,0,0,1,0,0,0,5,0,"Simultaneously and securely processing classified data at sea, discover the cutting-edge solution the U.S. Navy needed for its common display system (CDS): http://ow.ly/ao1i50MZEqY",2023-03-27T00:00:00,[],https://scontent.fcai19-7.fna.fbcdn.net/v/t39.30808-6/338129936_739356050910886_5875018313842001889_n.jpg?stp=dst-jpg_s960x960&_nc_cat=102&ccb=1-7&_nc_sid=2c4854&_nc_ohc=wYP1pi9iX9sAX_Tvo3f&_nc_ht=scontent.fcai19-7.fna&oh=00_AfA5MV7X-ySMtQH9iSUqO81Ht4ZjV6xjUIuzlFd-nngvsg&oe=64E46663,https://www.facebook.com/NVIDIAAI/posts/pfbid02FK6FzmxrmcQt1byNrR42aTYmE2bXrTqdxBu7vrUetPtkgzzxCE4H2x7mtHpnE7Vrl?__cft__[0]=AZWkY6uNcruvwCgPGAP17exIrIz33oTCo8RkYK2f-uN3GHVurn6ZWOnfP5J-fV1-KVSvCLxeO2QrbwU9ZUbvRSW8JWQwGzketSIX3RQvLEFSc7IgoT9JnbBpukVZxN_ZZ7pyG1jz6GQN8SabCdjy2-QFQ0dBYL6AnxinjjFWxVdMMkVg7Xr2v69K6KouA_SVAxo0-v8gJ94_DPxRPI-mT2rynvHHoQPGUpFhGXQt6kLOUyeMgeJYkeedLr9uZEmTj1WniSL6dQ0-4Na51vvBIv6f&__tn__=%2CO%2CP-R,5,0,positive,5
1155850795081188,NVIDIA AI,5,31,2,0,0,0,0,0,33,4,"The University of Florida is embedding #AI throughout its entire teaching curriculum. See how NVIDIA is helping to quickly find patterns in data, as well as provide insight for others, including governments, on how to best use this emerging technology. https://bit.ly/3ySMG7s [photo credit: UF]",2023-03-27T00:00:00,[],https://scontent.fcai19-7.fna.fbcdn.net/v/t39.30808-6/338010928_1899354117108113_2374579819951030739_n.jpg?stp=dst-jpg_p180x540&_nc_cat=108&ccb=1-7&_nc_sid=9267fe&_nc_ohc=LMzRN3rDsGEAX8xgNiX&_nc_ht=scontent.fcai19-7.fna&oh=00_AfCJlDbLBnxBPMP-Js80ld-RWcLZsYEXfcCQ8rkXWerzvw&oe=64E3F4D3,https://www.facebook.com/NVIDIAAI/photos/a.119492422050369/1155850795081188/?__cft__[0]=AZWatgjIDtk4BuGdt5sW91CvDZiRvfqQRJeGNp5hizswtfty7UrpruBf_1dj4yfzRUwRh-q1p8DIeUM1B6H2tNgitMAIe2g0mQvsI8wF86aJsG6bL1pFGnepphGVe0WQ8ThfbmHc3rxdkGr3sro7G2efWSvO4Ly3kE_rnUW8KFiBAcHM29QNMa-lthKc8v7sp4awfHrGvnbKfqrbeIzrUPXC&__tn__=%2CO%2CP-R,38,0,positive,38
1154948961838038,NVIDIA AI,0,28,7,0,3,0,0,0,38,9,"Learn more about what PureWeb Reality, a real-time 3D streaming platform, has to offer with CoreWeave’s specialized cloud infrastructure and the wide range of NVIDIA RTX GPUs, providing on-demand access to creators to deploy immersive experiences. https://nvda.ws/40e6K0h",2023-03-25T00:00:00,[],https://scontent.fcai19-7.fna.fbcdn.net/v/t39.30808-6/338025573_918373609475933_7305850528657682054_n.png?stp=dst-png_p180x540&_nc_cat=111&ccb=1-7&_nc_sid=9267fe&_nc_ohc=uqreQstQlegAX_2be7y&_nc_ht=scontent.fcai19-7.fna&oh=00_AfBDDk4m1fBeZiU7WulaHj0-1VMVPGNbFd4gohMxjKnnbA&oe=64E2DBC7,https://www.facebook.com/NVIDIAAI/photos/a.119492422050369/1154948961838038/?__cft__[0]=AZX8OnMS8rQ856xziomn7JonZQfRM-r-NNWoASQT332xjLPndYr-WdK9mwUXYtgEJ8DmQwmdH_AOd0qLaYMCZyIvb9wrl0eR76VYZ4GtDr0MsuIY5kfWckFiqbKHOhnCp3Dg6v8WxEGTOajdQ7g_zKZWJ0Znt9eUbhaxS6SxZfb-OI0EKllnBdYhhJ5JP-309_ICHLQOMdleCxHQccD3sovF&__tn__=%2CO%2CP-R,38,0,positive,38
pfbid0rqLk5KwMtsyPaJjUfaL4nRcQBnm7aw781LtWK7Kaw8i74gRanDvvrQUZoWVsvpffl,NVIDIA AI,0,6,0,0,1,0,0,0,7,1,Discover how DOCA and data processing units can optimize your data center and help you solve critical network and infrastructure challenges. Join us on April 11: https://bit.ly/3lsTkyp #NVIDIAInception #networking #finance #cybersecurity #startups,2023-03-24T00:00:00,[],https://external.fcai19-7.fna.fbcdn.net/emg1/v/t13/9802255767361134361?url=https%3A%2F%2Fprod2-sprcdn-assets.sprinklr.com%2F50276%2F5cd4ca1e-a710-49d1-9f2e-900294a6b884-543651610%2Finception-q4-webinar-doca-tw-l.jpg&fb_obo=1&utld=sprinklr.com&stp=c0.5000x0.5000f_dst-jpg_flffffff_p500x261_q75&ccb=13-1&oh=06_AbFR5-5uYIc4P52dh0bPzmY3roZ4mTN4Jj_Cpv89noYteQ&oe=64E01A12&_nc_sid=dbad39,https://www.facebook.com/NVIDIAAI/posts/pfbid0rqLk5KwMtsyPaJjUfaL4nRcQBnm7aw781LtWK7Kaw8i74gRanDvvrQUZoWVsvpffl?__cft__[0]=AZVTMocuqbJrxbWAzu33Ca4ekXV_xR7kBBzv9v9wKLLLlEhZzhCmu_HnS8zv1o4k3jIYCfmWJ_eQnMgOTi58hJknTkN8WfB8d2fouRXmL9oEzdAdzRd2xzz5sAKzjidXWwdmokeO-GulEWboURgeQmrpfhWHNpDwW1o7veKXCk00Carp4_3D-fG0H0YZ9XmqXAwgvepOkh65T30MmN8yCE4T&__tn__=%2CO%2CP-R,7,0,positive,7
1154519105214357,NVIDIA AI,0,15,1,0,1,0,0,0,17,2,"Morningstar, Inc. is using the NVIDIA NeMo™ service in its Data Collection research and development on how #LLMs can scan and summarize information from sources such as financial documents to quickly extract market intelligence. Check it out: https://nvda.ws/3n6oQ5u",2023-03-24T00:00:00,[],https://scontent.fcai19-7.fna.fbcdn.net/v/t39.30808-6/338013370_172199055655430_8004212034649122155_n.png?stp=dst-png_p180x540&_nc_cat=107&ccb=1-7&_nc_sid=9267fe&_nc_ohc=bD4uIYk2WjIAX_A4DZR&_nc_ht=scontent.fcai19-7.fna&oh=00_AfC7Z9VawKPM3ZUYxrWOExxGH_oOoiqizjZEOTRemOqCww&oe=64E2D0B8,https://www.facebook.com/NVIDIAAI/photos/a.119492422050369/1154519105214357/?__cft__[0]=AZW0qGz2odeis-Dlc1KN23gK7yNLaOYzPxTwaZgy6ZyvAm-1kia71zSxsAts9rozGuVAmNAAsKRgmG0QeA86NyXtuM424l1huDpEwY-XmtZI9hgW2PX8j411p339IcSwqw88IWiODyaEtcoOvPcrq8esxRZQ4b0k8GV1AzCKMJsbYbPUF4v9m0dbaG5UvzRfMSzPNO6mxjo5tHtnLDfVxOGu&__tn__=%2CO%2CP-R,17,0,positive,17
pfbid0EWndA4raaDBqDW5MQ52GuxqDD3P48GMAi1Nauw2PVs2mFV5i7kjDG3Yuo4SGvCoyl,NVIDIA AI,0,7,0,0,1,0,0,0,8,1,"Just getting started with #speechAI and #LLM? This glossary page breaks down what a large language model is, how it works, the challenges the technology faces, and how to get started. #AI Read more now: https://nvda.ws/3ZaJHC0",2023-03-23T00:00:00,[],https://external.fcai19-7.fna.fbcdn.net/emg1/v/t13/8069587227161450987?url=https%3A%2F%2Fwww.nvidia.com%2Fcontent%2Fdam%2Fen-zz%2FSolutions%2Fglossary%2Fdata-science%2Flarge-language-models%2Flarge-language-models-og.jpg&fb_obo=1&utld=nvidia.com&stp=c0.5000x0.5000f_dst-jpg_flffffff_p500x261_q75&ccb=13-1&oh=06_AbGm9ylefhtIy-NMEMWiaM8Zx160V60xDm9WqO1WK1KZWg&oe=64E04BC8&_nc_sid=dbad39,https://www.facebook.com/NVIDIAAI/posts/pfbid0EWndA4raaDBqDW5MQ52GuxqDD3P48GMAi1Nauw2PVs2mFV5i7kjDG3Yuo4SGvCoyl?__cft__[0]=AZUJPsnPJCC6kJcg2lsJ0HQdKeVZS6jDaeV6UYaqlbb0FJOhv0rBrN2Oc1tyI_Slxz8fjR07qI43VV3eFTdFvBZrQr3pFEFSSP8ZRdNGp-vK9YNbUTXEiXTATM0Xj86MdoYkLkLQj7crkDhgq6lfpI6NoZOSkkQIw00pxqzriT1J12EZBkqXvRXRj-rN-vdN7HNzau3qWfuflj9vow8XTyWC&__tn__=%2CO%2CP-R,8,0,positive,8
pfbid032vNtrZWmu9bfFqn6MwByBA4FRhYVYvYgdGeqcBRxe1aomWjazCiSroNzPcLNsMe5l,NVIDIA AI,0,8,0,0,1,0,0,0,9,2,AI is changing how enterprises manage #edge applications.Read this blog to learn the four fundamental differences between the way traditional enterprise software and #AI applications at the edge are designed and managed. https://developer.nvidia.com/.../ai-is-changing-how.../...,2023-03-23T00:00:00,[],https://external.fcai19-7.fna.fbcdn.net/emg1/v/t13/10489812689198668738?url=https%3A%2F%2Fdeveloper-blogs.nvidia.com%2Fwp-content%2Fuploads%2F2022%2F06%2FAI-infrastructure-edge-ai-v005.png&fb_obo=1&utld=nvidia.com&stp=c0.5000x0.5000f_dst-jpg_flffffff_p500x261_q75&ccb=13-1&oh=06_AbGOGQxU5SrST6CpCUQjg_MdVUu7StfDs5TgCzoofdcLPw&oe=64E01579&_nc_sid=dbad39,https://www.facebook.com/NVIDIAAI/posts/pfbid032vNtrZWmu9bfFqn6MwByBA4FRhYVYvYgdGeqcBRxe1aomWjazCiSroNzPcLNsMe5l?__cft__[0]=AZV0AiwrUbzxZtFRz8e5rgm4wARF3h9a9YI3CJWDWXr1sIdj0ECE2C2r2w_A5IumUYpVg-Ea5VAfsl6MydSg02Z4jJyNXj3wwi-Rkl9yDuirl5yf7gW5Cik989zTplLvxxJfDbPOVkvh1IMRN3oPtCBkuRmva-yhU7sRvqbmOUQoZypcPqTpeoyD5w4lEi3ZTXMKz53yv7lxP1lc6bvjmXwm&__tn__=%2CO%2CP-R,9,0,positive,9
1154047668594834,NVIDIA AI,0,17,3,0,0,0,0,0,20,3,"NVIDIA Triton now offers native support in #Python with PyTriton, model analyzer support for model ensembles and multi-model analysis, and much more. Check out the newest features from #GTC23 below. https://nvda.ws/3JCbDJf#nvidiatriton #aiinference",2023-03-23T00:00:00,[],https://scontent.fcai19-7.fna.fbcdn.net/v/t39.30808-6/337280022_955589618964305_8689344316828312489_n.jpg?stp=dst-jpg_p180x540&_nc_cat=101&ccb=1-7&_nc_sid=9267fe&_nc_ohc=YrQda9qJpLcAX-KtRah&_nc_oc=AQnegM676Mk08CHDFEDFzU_IGtkAxapDltWXE_Y2tCqhF9ekymrM49Uv7dR3I0rGJro&_nc_ht=scontent.fcai19-7.fna&oh=00_AfAdl47qulqV93pbj1zdT_fCNsYUoMNFoFz-hMuwUUr8vA&oe=64E2B991,https://www.facebook.com/NVIDIAAI/photos/a.119492422050369/1154047668594834/?__cft__[0]=AZU4J7-FsmfL_W4fmTskKWS64M7iH3qC7Plsm_bqTjb98TXFb8c4KpQKuAn8cq-hSjyU3VV14RnCetv3BXWbNoawZeWpqYQ4LaM5dzswmWufjKF6HmwQEubzWIVx2HUSGT7MzeRr9w9CVeyeduGHod6PnAD_UCF5m6TxYUUUp3jo40FeXO_IOjd-zF_VEoCd1cUGWQNwpJMyvPICWfP0S828&__tn__=%2CO%2CP-R,20,0,positive,20
pfbid0BZ7FxEmmLTytjQMBGfRS3qjxGfWKNUzrcoDyjSzJdewAUEDuP4cBPYK9mxmSZMGGl,NVIDIA AI,10,51,3,0,0,0,0,0,54,3,Still not sure what #generativeAI is or how it works? Check out this glossary page that tells you everything you should know about generative AI. https://nvda.ws/3yV6mYx,2023-03-23T00:00:00,[],https://external.fcai19-7.fna.fbcdn.net/emg1/v/t13/5108146408514406923?url=https%3A%2F%2Fwww.nvidia.com%2Fcontent%2Fdam%2Fen-zz%2FSolutions%2Fglossary%2Fdata-science%2Fgenerative-ai%2Fgen-ai-og.jpg&fb_obo=1&utld=nvidia.com&stp=c0.5000x0.5000f_dst-jpg_flffffff_p500x261_q75&ccb=13-1&oh=06_AbEb8-s__TSElliD3lGGgTU0JS554imuYzMsrhnsv04X7Q&oe=64E0472B&_nc_sid=dbad39,https://www.facebook.com/NVIDIAAI/posts/pfbid0BZ7FxEmmLTytjQMBGfRS3qjxGfWKNUzrcoDyjSzJdewAUEDuP4cBPYK9mxmSZMGGl?__cft__[0]=AZVdzAPw9ZdAsNOmTaCmkyEqnGKqlP7UTLsIfiRhx7tzquKqBSZgHCTRuqGAy6zXhvc676BqC2gRp3a6XvIter7fF4SQZ-6Za5wyeG73q6KRlJRuc8cz8MVOkc4G8f8T_rVDNBzBluvypzRsHTr8Yej5cO_Y3JNOEiMkc_9VgCKvUM_dUb6pvMCTAQsXi9FadY-CMZV-pCfM0mgBqWHQ-1Kn&__tn__=%2CO%2CP-R,64,0,positive,64
1153680555298212,NVIDIA AI,0,13,2,0,1,0,0,0,16,0,"Join leading avatar developers from InWorld AI,  Ready Player Me, HourOne, and KLleon tomorrow at #GTC23 as they discuss the technologies and challenges of building lifelike digital humans. https://nvda.ws/3Jz7wPV",2023-03-23T00:00:00,[],https://scontent.fcai19-7.fna.fbcdn.net/v/t39.30808-6/337113541_999720731012813_5792127335209156223_n.png?stp=dst-png_p180x540&_nc_cat=100&ccb=1-7&_nc_sid=9267fe&_nc_ohc=esiy70Kr-mwAX_f_VIP&_nc_ht=scontent.fcai19-7.fna&oh=00_AfD9gJyNRuMa2KZgGAK2Xf4vc-316dCi9tYkVnPFVNMSeg&oe=64E4278C,https://www.facebook.com/NVIDIAAI/photos/a.119492422050369/1153680555298212/?__cft__[0]=AZUENZuv81BWkvRmoMWnX7ETkUssmRCgNeFkhmhjMvHBrerW3B4yLdUgX1nybZ4iLfJMf3INyDo6uaLrYqFCBAgCZRzZzdJP6XG6kK0whCMiSQE3gdgxeiaF7qLEoDLvWMLQDsFmyefag0jmc9Aut_7WTYx4joB7P6zQfU-CuMVQ10pmHaVJ21F5WHMQXxU9vgrl5WjckwZ5aEjT5Yn9z6K_&__tn__=%2CO%2CP-R,16,0,positive,16
pfbid0216zVMSjXHynD1xnmCjHgbu5BaF1cV1XQ5Pgt8pD6yVVMLk7jSA792XnYRq2BH3xGl,NVIDIA AI,0,11,0,0,2,0,0,0,13,6,Spend more time designing your app & less time worrying about bottlenecks. Read a quick primer on RAPIDS RAFT's library of building blocks for #ML & #DataAnalysis: https://nvda.ws/3n1PBrJ,2023-03-22T00:00:00,[],https://external.fcai19-7.fna.fbcdn.net/emg1/v/t13/9755741541929009278?url=https%3A%2F%2Fdeveloper-blogs.nvidia.com%2Fwp-content%2Fuploads%2F2023%2F03%2FRAFT-featured-image-data-squares-connected-16x9-1-2048x1152.jpg&fb_obo=1&utld=nvidia.com&stp=c0.5000x0.5000f_dst-jpg_flffffff_p500x261_q75&ccb=13-1&oh=06_AbHqnXDky5BogCsiYOjaIhhIV_7KjKohBVpBeZqiZ4LrIg&oe=64E055CC&_nc_sid=dbad39,https://www.facebook.com/NVIDIAAI/posts/pfbid0216zVMSjXHynD1xnmCjHgbu5BaF1cV1XQ5Pgt8pD6yVVMLk7jSA792XnYRq2BH3xGl?__cft__[0]=AZVzc-TCQfIwAvbBZ_1zHCBnzK6Y6_MZJ4ZKag89GV3xoMzorIfU-DwfqoMEEhYYWNGNH_ECNVZ3hrvB0RVpYQfvbWdZaLEITUJArs4jnfJbRjlKW4GpnC2Q0ES--uHQIuCCxB5-QXUK-ki8Kpgukmp0jj6lraeWXDAxYjQL891-Lcw8CBU-GCO58NFdYbVxjx46ZrWvjyFF5dRyJTuM4MPl&__tn__=%2CO%2CP-R,13,0,positive,13
1153629495303318,NVIDIA AI,0,20,0,0,0,0,0,0,20,5,"Keep up with the latest #generativeai announcements from NVIDIA at #GTC23 and learn how to easily build, customize, and run your own #generativeai models with NVIDIA AI Foundations and the Nemo framework: https://nvda.ws/42w0NNG",2023-03-22T00:00:00,[],https://scontent.fcai19-7.fna.fbcdn.net/v/t39.30808-6/337143526_894013801854397_7351261539654325263_n.png?stp=dst-png_p180x540&_nc_cat=100&ccb=1-7&_nc_sid=9267fe&_nc_ohc=6EBcrxma4eUAX-4hMct&_nc_ht=scontent.fcai19-7.fna&oh=00_AfAXesEBs0aC4vMn9y0j4IxDbcbJXPXyozdgAb9koF7mZg&oe=64E37763,https://www.facebook.com/NVIDIAAI/photos/a.119492422050369/1153629495303318/?__cft__[0]=AZV8jb8c5Orfd1ZGM0yamIC17ejPO2cqOJL59V1swdEWkpdoLVfSu-NLNNj7rBTDYnpugzAN77dF2__7R1mdBY3079wyXWZ2_c9CuFH775yUBqdBrcmNZ9-yRDWq5opOQZcv5GqfQUOZthJfb2_IGXgl5tIgzbXIA7T9JccUbHhfvGaX02VMO6F5j4dic74OD9DMZwJF_oxtoPEwL_bIKR1n&__tn__=%2CO%2CP-R,20,0,positive,20
1153610865305181,NVIDIA AI,0,10,0,0,1,0,0,0,11,1,"From product recommendations and #routeoptimization to intelligent virtual assistants, and digital fingerprinting to detect #cybersecurity threats, explore the latest for NVIDIA’s #AI workflows, and find new ways to accelerate the development of AI solutions. https://nvda.ws/407Izjs #GTC2023",2023-03-22T00:00:00,[],https://scontent.fcai19-7.fna.fbcdn.net/v/t39.30808-6/337140600_981687046190195_3003912619460390723_n.jpg?stp=dst-jpg_p526x296&_nc_cat=100&ccb=1-7&_nc_sid=9267fe&_nc_ohc=0UH1vU-OmbUAX_-pUlD&_nc_ht=scontent.fcai19-7.fna&oh=00_AfDtarPS0NjaBPXonddj9GndBhms_Me2c8B00tQKBui-Ew&oe=64E2FBDE,https://www.facebook.com/NVIDIAAI/photos/a.119492422050369/1153610865305181/?__cft__[0]=AZX5nOQfg85C2ozVM6JyGhZ7rpdI5zeRNRjjta6LZlsdLVi86Wv0k0TYOS2GIBjZRPaflpSm2R83alqc0CxvDiBQ-9wIZmi9pdr971MOHGlYZ8JRffYg8EbYQbU6WurLxbIcKXh0833toidfDy5i_kT9eh8HOXipJl1_-qH7edoioyBB9i3psBKTNW0EEQSCbo3Ge3C4oB_48f6VAJrJa2cl&__tn__=%2CO%2CP-R,11,0,positive,11
pfbid0ALtNovUgPwzmfszyFh2n7JnqjTMYC13qz3BFdgnePTAynL6AgJNu5DgH932uPs2pl,NVIDIA AI,2,11,0,0,1,0,0,0,12,1,Get enterprise AI up and running with help from over 100+ NVIDIA #MLOps and #AI platform partners announced at #GTC23. Read more. https://nvda.ws/3nbJKAl,2023-03-22T00:00:00,[],https://external.fcai19-7.fna.fbcdn.net/emg1/v/t13/12913874129089552058?url=https%3A%2F%2Fblogs.nvidia.com%2Fwp-content%2Fuploads%2F2023%2F03%2Fmlops-partners-gtc-1280x680-1.jpg&fb_obo=1&utld=nvidia.com&stp=c0.5000x0.5000f_dst-jpg_flffffff_p500x261_q75&ccb=13-1&oh=06_AbEucTWhvezKK9bA5gVebPvnjyMJCjtyVPp0gOKcFzM5gQ&oe=64E05A44&_nc_sid=dbad39 https://static.xx.fbcdn.net/rsrc.php/v3/y9/r/Z-dbClQDXLv.png,https://www.facebook.com/NVIDIAAI/posts/pfbid0ALtNovUgPwzmfszyFh2n7JnqjTMYC13qz3BFdgnePTAynL6AgJNu5DgH932uPs2pl?__cft__[0]=AZVTUJv3sXZOVmz8YcIx3wTGFWaUPeK-S-3ywX2_IhMjmtkZXP8dqFaEfEddSVyqFr-FG7--j_sLyeGoHVoYXKrSBXgWzCcuVI5lrl9KaOiM4jplY60rFgSmdO76bBCY-tNrvGdFQ6OmgCXkV5Z3XwlFAm4kAecN_IIWC9C2oyB892uneYXE8qYj16Eb7Cnl-AxwRactoLDMarDrHcOVgSQf&__tn__=%2CO%2CP-R,14,0,positive,14
pfbid02edSVGQr4merbxvyUSmwWuKu87HSew7u7MwChdHquNHiEBjwfhaZpUFGWEwdyE2fSl,NVIDIA AI,0,15,1,0,1,0,0,0,17,5,"The next version of #NVIDIATAO brings the power of the world’s best #visiontransformers in the hands of every developer and service provider to create state-of-the-art #computervision models and deploy them on any device - GPUs, CPUs, MCUs - at the edge or in the cloud. Read blog > https://nvda.ws/3n7Offa#GTC23",2023-03-22T00:00:00,[],https://scontent.fcai19-7.fna.fbcdn.net/v/t39.30808-6/337136827_770909894385932_3443407921068136598_n.jpg?stp=dst-jpg_p526x296&_nc_cat=105&ccb=1-7&_nc_sid=9267fe&_nc_ohc=qNCn-DWm7bAAX8Mlf25&_nc_ht=scontent.fcai19-7.fna&oh=00_AfCr0HL8fZxszBnY72TA1tlHf8hYlz3EkcCzakQwah3_Gg&oe=64E349E6,https://www.facebook.com/NVIDIAAI/posts/pfbid02edSVGQr4merbxvyUSmwWuKu87HSew7u7MwChdHquNHiEBjwfhaZpUFGWEwdyE2fSl?__cft__[0]=AZUprFbJfYb-WIrH81YNPqD2wD5BdxxHL1aKFPm2UlGaFYnCAlGmHPfcPoFDrkQYb0Sm0p8Ni8oQ5Yz_TARBUNOIko_GBnhcEu_m-cgImu-m56y_vGN5_tK6WZoG47p4Uha8IWbzpTzdqrI6hRq2dHSvmgmDFCsedvfZPaFZnOCs6v6fZQWgOBdjRkR-3NoPt0utW9NZOqI2d1A91kaEd32OwwSW79KS-2EnmW1GhMGyG7tHsXh5wsVdlwIi902BS-W_87Hl58QuWG56w_epBid7&__tn__=%2CO%2CP-R,17,0,positive,17
pfbid032ZdQ847bWR8C27QtFrUW593wsTVCLdacGzb49n54fTjcaSxHzrEvNvTd1zDesQNEl,NVIDIA AI,0,12,2,0,1,0,0,0,15,2,"Stay in the know on the newest SDK and library updates from NVIDIA, and learn efficient ways to accelerate your computing while reducing cost: https://nvda.ws/42z5tlK",2023-03-22T00:00:00,[],https://external.fcai19-7.fna.fbcdn.net/emg1/v/t13/13389983428976690314?url=https%3A%2F%2Fdeveloper-blogs.nvidia.com%2Fwp-content%2Fuploads%2F2023%2F03%2FSDKs-Data-Pipelines-Computational-Science-GTC.jpg&fb_obo=1&utld=nvidia.com&stp=c0.5000x0.5000f_dst-jpg_flffffff_p500x261_q75&ccb=13-1&oh=06_AbFvXwQG4KiRSnIcNcrBMWR0fzkwVPxsxENhhGE2aHbc1A&oe=64E08142&_nc_sid=dbad39,https://www.facebook.com/NVIDIAAI/posts/pfbid032ZdQ847bWR8C27QtFrUW593wsTVCLdacGzb49n54fTjcaSxHzrEvNvTd1zDesQNEl?__cft__[0]=AZXSZv7hv83qDEcfvLKW_QSNzF4_GSNy2GlUTmj2Jfjmg26qISxdKJ7SX5-wF7bhkrRWqWj8ETj61J3_EJHqHGu_a23jcJqXh_WEYfHo7j5lvcXLBOdpRKPxDFWojSta2w-zJEAbLgvVv_c3E_W9l9pyVhs9oW7C46V5plmTuuFym3q7ehz45ZkFLYk6bq_gdHQNTDlq4fpMrNrtk1Po9_-S&__tn__=%2CO%2CP-R,15,0,positive,15
pfbid02DX1nBdhe36gLSAdoVfuWvkPneaBFmcDrZQdez2dwVfyTUh3GZf65iN1cGN49p43Jl,NVIDIA AI,0,11,1,0,2,0,0,0,14,3,"Hey there, students! Ready to build the future? Join the all-new NVIDIA Student Network and get exclusive access to training, tools, and skills that will jumpstart your career in #AI. https://bit.ly/3LXj4xJ",2023-03-22T00:00:00,['blob:https://www.facebook.com/faaacb06-edca-4474-863f-db6c28949602'],https://scontent.fcai19-7.fna.fbcdn.net/v/t15.5256-10/326426442_177263668433287_4938910287143128888_n.jpg?stp=dst-jpg_p180x540&_nc_cat=111&ccb=1-7&_nc_sid=ad6a45&_nc_ohc=LoK_wkkfmosAX-gMz-s&_nc_ht=scontent.fcai19-7.fna&oh=00_AfBphhrS1gNjNY8Hs0f31TrIIADzs3PM7lsJFd0LKUWBGA&oe=64E31C29,https://www.facebook.com/NVIDIAAI/posts/pfbid02DX1nBdhe36gLSAdoVfuWvkPneaBFmcDrZQdez2dwVfyTUh3GZf65iN1cGN49p43Jl?__cft__[0]=AZVfeW0Nr58IhjjkX-XIV8z_KV7rTzxTFIdgNTsD36rK7AmTiwpJq-9q7CjxKKYbU2f3aMWeJAJ7GPzECzytC7HLf3q1ebeEw2EIGNEhWzkzDoUiPdfGRc7R3WT1OqxKUoEevLyv7xN0p5cFRJON_aSblf1xXrIJpuSnUHwfo7XqcnsCtd_9Z8zIbj_uOdFRpZfsZKGg7icReKUhFrWJ75CNnYehgtiQKoAoCTjF4F5b5Q&__tn__=%2CO%2CP-R,14,0,positive,14
1153516445314623,NVIDIA AI,0,10,5,0,1,0,0,0,16,1,Learn from NVIDIA experts on how to easily develop and hyper-personalize large scale #generativeai models with hundreds of billions of parameters: https://nvda.ws/3n0MOPy,2023-03-22T00:00:00,[],https://scontent.fcai19-7.fna.fbcdn.net/v/t39.30808-6/337143382_1280318892919213_731628335778396827_n.png?stp=dst-png_p526x296&_nc_cat=110&ccb=1-7&_nc_sid=9267fe&_nc_ohc=CG5-pA_iJg0AX--DgZ1&_nc_ht=scontent.fcai19-7.fna&oh=00_AfCenRfueWSVQm-WrNbk0xpgY0nwvf_Yh9fQmJ1J7MNbIw&oe=64E31CC5,https://www.facebook.com/NVIDIAAI/photos/a.119492422050369/1153516445314623/?__cft__[0]=AZVXqZ3fiKool4jARMh0Cq99KBD9_GXBTNKwgpaJpwN3S95QDq9VS39beD_Eimt2GToxagOvKy5g37JtfZ8D3FehlyozlvDYY7XE9cu5bdSEdEL4gEXp-KClnF4IVtTs3ovNl9lR1-YJlsbJW7lsqn5cDRHD-AXVYgGoJjvZV1cAHk0w-pWd8MgCRJzOqtq-Z3KjPlC_AIm6rWExpKfFro_a&__tn__=%2CO%2CP-R,16,0,positive,16
pfbid0J9ZbyDVcL1ydBw3DFZ4FroJ4K2NmewzzknyBnUFS6BX8e1gwShR1Tm289g2LfW5Xl,NVIDIA AI,0,10,0,0,1,0,0,0,11,0,Drivers can get auto repair estimates in seconds instead of days with #AI-driven insurance applications from CCC Intelligent Solutions with an assist from #NVIDIADGX Cloud and Base Command Platform. Learn more: https://nvda.ws/40r867C #GTC23,2023-03-22T00:00:00,[],https://external.fcai19-7.fna.fbcdn.net/emg1/v/t13/5127141868983039072?url=https%3A%2F%2Fblogs.nvidia.com%2Fwp-content%2Fuploads%2F2023%2F03%2FCCC-Estimate-STP.png&fb_obo=1&utld=nvidia.com&stp=c0.5000x0.5000f_dst-jpg_flffffff_p500x261_q75&ccb=13-1&oh=06_AbHGrC6QqLDW5iHqWEidHNO4q7TkVwb56IxN9VC0O4giFQ&oe=64E05C31&_nc_sid=dbad39,https://www.facebook.com/NVIDIAAI/posts/pfbid0J9ZbyDVcL1ydBw3DFZ4FroJ4K2NmewzzknyBnUFS6BX8e1gwShR1Tm289g2LfW5Xl?__cft__[0]=AZVOaZ3LffWM-SpVIE-mq1138szBMk5gkVexTW2AN8vMHMDmUqYkBbJlnCECu6CsBEq9SRqTuyTCFjuJcYdridF_i6NMgWp6RGpcPaDbZs0S4lmaC54F7zwuD8nYMsTfiCtyTuH7LeIANiDymUsTQ4Ea7PeTdXVE9yKGZKv4rta4JUAZOC96E4uKg0HaQMnmoOZJ2hdpkm6EE0KQyU_0n3Nn&__tn__=%2CO%2CP-R,11,0,positive,11
pfbid02RbhtpiSYcXHgDzEDpChuexWDT8coY6SMYU16j36i3TCANrhYst83GCCJJt3avkyhl,NVIDIA AI,0,14,0,0,1,0,0,0,15,2,"Build, verify, and validate #AI for industrial and medical settings with NVIDIA IGX Orin developer kits, available now. https://nvda.ws/3LGVYLA #GTC23",2023-03-21T00:00:00,[],https://external.fcai19-7.fna.fbcdn.net/emg1/v/t13/9028823277134100510?url=https%3A%2F%2Fdeveloper-blogs.nvidia.com%2Fwp-content%2Fuploads%2F2023%2F03%2FIGX-Orin-Developer-Kit.jpg&fb_obo=1&utld=nvidia.com&stp=c0.5000x0.5000f_dst-jpg_flffffff_p500x261_q75&ccb=13-1&oh=06_AbGTHuz5bAywRiY2s-ta_GLf0bNoXYI9kFD80IymcFnE2A&oe=64E0168D&_nc_sid=dbad39,https://www.facebook.com/NVIDIAAI/posts/pfbid02RbhtpiSYcXHgDzEDpChuexWDT8coY6SMYU16j36i3TCANrhYst83GCCJJt3avkyhl?__cft__[0]=AZWA2C6DAsHksXfaCwd6H99PyaDhjcwlxXtpVwBhyy-abxgBSqky64QunlGiRIH-U9VzH8YDmdzQyAdEJW6ZAv5vkgBOc7uc3_ImCgFvant8aN-f25VQJgkau-ilgRG0_4riKfuvTF4dlfRsPt1waOE2SWKbfr4iN9dOE2C451YtT-gYAkeZSPaU-YGDyvL-lP2w8knkxW1O8iUVbSgJ2zFP&__tn__=%2CO%2CP-R,15,0,positive,15
1153124218687179,NVIDIA AI,0,10,1,0,1,0,0,0,12,0,NVIDIA cuOpt has multiple new world records solving vehicle routing problems.  Read our blog to learn more about the new world records and how NVIDIA cuOpt optimizes delivery routes with unprecedented speed.  #AI https://nvda.ws/3lp8ODw,2023-03-21T00:00:00,[],https://scontent.fcai19-7.fna.fbcdn.net/v/t39.30808-6/337151521_723052752938805_4499223336985145134_n.jpg?stp=dst-jpg_p526x296&_nc_cat=105&ccb=1-7&_nc_sid=9267fe&_nc_ohc=KxSZZXlLTJMAX_xgPWc&_nc_ht=scontent.fcai19-7.fna&oh=00_AfAGUmwfK2DkYhpcC_LfwRHj-Z-s-MQr0CHZzcb0L0Lo4w&oe=64E3B4F5,https://www.facebook.com/NVIDIAAI/photos/a.119492422050369/1153124218687179/?__cft__[0]=AZUxW4FDeCzoN_Vx6PwvT0GO7ZTdu07C8f0U_ezu3DNPF6UrnUKlD258MEnwsulfaEZuHAP7BkGN8yaeskFbcu7qXBq9KlX49PvYR0Bck_sNDvSZneBW2OFcOwRQnRgUq9_5p-UejbMQtQeN-K7_xhHHf7sCx0R9Cskb4Ar7FLnNqCaLXjsk96yk5Ba37QHNSkiLnjioGGzycbjvv4dczkdB&__tn__=%2CO%2CP-R,12,0,positive,12
1153113665354901,NVIDIA AI,9,85,12,0,0,0,0,0,97,5,"Today we announced our partnership to add the NVIDIA Picasso #generativeAI capabilities to the Adobe Creative Cloud. This will accelerate the #3D, video, and graphics production for artists with the assurance of their credentials managed through the Content Authenticity Initiative.  https://nvda.ws/3yTVZEe",2023-03-21T00:00:00,[],https://scontent.fcai19-7.fna.fbcdn.net/v/t39.30808-6/337138699_152702754053397_9133883666641788503_n.jpg?stp=dst-jpg_p526x296&_nc_cat=110&ccb=1-7&_nc_sid=9267fe&_nc_ohc=z9piScJODXgAX_AGriJ&_nc_ht=scontent.fcai19-7.fna&oh=00_AfB8ooQGvlLAAUmIjYN_KJzEkRoUi5kuzu_liUM7W5GX4A&oe=64E2BA86,https://www.facebook.com/NVIDIAAI/photos/a.119492422050369/1153113665354901/?__cft__[0]=AZVyFZHQm1cb317Xxiu_Zdyf9TsIhgCkxvY70GUVPFmgO-yKU3HKQvmD4aUKZeJF-9IA3onERDKLm99GY3YIe60CaleYZUhrnnXnI9Y1CrV-yZCXEGeC0QhgHIhk-WU5aSr_3obcn4nIRSJak5snkMDK8XmQ9zxaW6ccTBXnwt9M9IMCNHf8a03WuJE7mQjQhbNSL6ZbgR8u-pjkcbSIK5tl&__tn__=%2CO%2CP-R,106,0,positive,106
1153113672021567,NVIDIA AI,0,21,3,0,0,0,0,0,24,1,"Shutterstock is partnering with NVIDIA to develop text to #3D models trained on licensed content from Shutterstock. These models can be used to generate high-fidelity 3D assets from simple text prompts to be used in simulation, animation, and 3D workflows. #GTC23 #generativeAI   https://nvda.ws/42wiyw8",2023-03-21T00:00:00,[],https://scontent.fcai19-7.fna.fbcdn.net/v/t39.30808-6/336805555_1013300059642153_6531400630286235756_n.jpg?stp=dst-jpg_p526x296&_nc_cat=102&ccb=1-7&_nc_sid=9267fe&_nc_ohc=jSHStJ5llGYAX-hmzPr&_nc_ht=scontent.fcai19-7.fna&oh=00_AfD35_lbY6ACgDEkdL4WyfK4urbehyxQGCOeLvVUvOwXPg&oe=64E34FFB,https://www.facebook.com/NVIDIAAI/photos/a.119492422050369/1153113672021567/?__cft__[0]=AZUYz9SQQKT9MkpqIM_MYc3FOO2CB9mDOzy5Un63ktlvDtjNQB_81MN2JikXRVlWEPS-llLpzjL9e_TVRDwOVt5bcMr-478UKw2sbdIbS4hzKh5iiv-rtca8RFizfo0r74MAklsuw4PsIpOikqpKmTM6H3JzbIqN6kqvNqagy_9k5cltUd-AqYFNix_mXO4ftFQEmRSRfLQd30Hc9GiKhPvL&__tn__=%2CO%2CP-R,24,0,positive,24
1153113668688234,NVIDIA AI,0,54,4,0,0,0,0,0,58,20,Just announced: NVIDIA and Getty Images are partnering to train responsible generative text-to-image and text-to-video foundation models. These models will use text prompts to generate images and video and will be trained on Getty Images’ fully licensed assets. #GTC23 #generativeAI   https://nvda.ws/3Z4aeRB,2023-03-21T00:00:00,[],https://scontent.fcai19-7.fna.fbcdn.net/v/t39.30808-6/337018105_1334387267127591_1030229529438963598_n.jpg?stp=dst-jpg_p526x296&_nc_cat=109&ccb=1-7&_nc_sid=9267fe&_nc_ohc=o4Ot10RpqdwAX-G7udn&_nc_oc=AQnk6Picaeern3TGuT0SISS9TtbyiQ2a_P8tDQi4zD9PniZptf8-aUBvn3e2c5sSGi0&_nc_ht=scontent.fcai19-7.fna&oh=00_AfD7c1uaAHuf8kINBe8MS5dQ3g7hhNE7-h7Y2sAij7YmvQ&oe=64E41B22,https://www.facebook.com/NVIDIAAI/photos/a.119492422050369/1153113668688234/?__cft__[0]=AZXN9EOXNbbBjBJ8swOewid16GiSq_H2-HxW9KuMMkWWjTKEEDrsW2Q9up6AgDF8gSFCFl3quGoonIUAIRP6DKauetkeIJA3Ru0k4mcv6pwVL2u992uVMNvcE7_-TFjnWBknD8y1f1OSXWOtQlcwYiIhIkpc5VFVl13v7t2GKzE4BnUjhbeP3c-o_c1cnaWTxkzqTR6ZqtHlIT0-6no91h4E&__tn__=%2CO%2CP-R,58,0,positive,58
1153093672023567,NVIDIA AI,0,11,1,0,1,0,0,0,13,10,"NVIDIA NeMo service, part of the newly announced NVIDIA #AI Foundations, helps enterprises encode their proprietary data with #LLMs to power intelligent chatbots, customer service, and more. Check out this blog to learn more. https://nvda.ws/42tEgBe",2023-03-21T00:00:00,[],https://scontent.fcai19-7.fna.fbcdn.net/v/t39.30808-6/336328882_985638839376833_1486944996590172850_n.png?stp=dst-png_p526x296&_nc_cat=105&ccb=1-7&_nc_sid=9267fe&_nc_ohc=64aSFAj8d4YAX99pT0j&_nc_ht=scontent.fcai19-7.fna&oh=00_AfA-X3dIuTdJ-kOsRpdf40x5HnsItIjOd8BsiC9AseT_GQ&oe=64E3F309,https://www.facebook.com/NVIDIAAI/photos/a.119492422050369/1153093672023567/?__cft__[0]=AZVBfZPGdGJ4Dt9oTMciBNjp7bZA18L0Nhw4x_PTpqHRqraXL-NSj4MOQ8h5WTns7HviuH60iyWPdYVJmgyL2KvUwz6YKsFTtrw2tA_KUmDOSsYkcT6fpUVhuHHM5CuH8fa-esH6AuJLg2KTCZRRsWjj0NS7Lnd49ttMkpk5cELTjbJWyGFqlzVCCofsoM5CHgH75g6aIDelRd9WlOTVVTm5&__tn__=%2CO%2CP-R,13,0,positive,13
pfbid0BLDrDZMTdPcSZQvTV4Fr51NnTbHPY1mShtWvMzfapWJQXofVdLL4EPMjwuN1P9c4l,NVIDIA AI,0,17,0,0,1,0,0,0,18,3,Defend against spear phishing with NVIDIA Morpheus and #generativeAI https://nvda.ws/3nbhf5N,2023-03-21T00:00:00,[],https://external.fcai19-7.fna.fbcdn.net/emg1/v/t13/16805743096457301854?url=https%3A%2F%2Fdeveloper-blogs.nvidia.com%2Fwp-content%2Fuploads%2F2023%2F03%2Fspear-phishing-generative-ai-morpheus-1.gif&fb_obo=1&utld=nvidia.com&stp=c0.5000x0.5000f_dst-jpg_flffffff_p500x261_q75&ccb=13-1&oh=06_AbFkFoqYtmzNYHg-3ISH9EDghve6fuNfJ840XpUvy47t4w&oe=64E02310&_nc_sid=dbad39,https://www.facebook.com/NVIDIAAI/posts/pfbid0BLDrDZMTdPcSZQvTV4Fr51NnTbHPY1mShtWvMzfapWJQXofVdLL4EPMjwuN1P9c4l?__cft__[0]=AZW8zIrGu057CGbQ8MbNdAwWmTNkndOozQRODJOXLqVFLqyzSdMc0Q2yfYC1l13KN5dEPsOl8jTYjSnQ3yNgdihtN1XJ7KWmzppEYb8Dz1CT-7BJXYWNyvCtyUTNNS1SlgZVA_a6QdaOai6ilZvYNGsF3TvXdNqom_TVTfGtgSWpwj3lnqpeTM-F3SEO7SAjttWQoVTgylRdB6DL_IcNhTS6&__tn__=%2CO%2CP-R,18,0,positive,18
1153071645359103,NVIDIA AI,0,26,2,0,0,0,0,0,28,6,"Just launched at #GTC23, NVIDIA AI Foundations, a set of cloud services that provides businesses with a simplified approach to build, customize, and run #generativeAI models with their proprietary data for text language, visual content, and biology. https://nvda.ws/3ltAbMx",2023-03-21T00:00:00,[],https://scontent.fcai19-7.fna.fbcdn.net/v/t39.30808-6/336923131_3501311073424033_1774114586548652656_n.png?stp=dst-png_s960x960&_nc_cat=100&ccb=1-7&_nc_sid=9267fe&_nc_ohc=4NmpsCIg_sIAX9cC4Yz&_nc_ht=scontent.fcai19-7.fna&oh=00_AfBCHxb2FHIF5VYgKPbx2EVVnMZqdH9-sjkyW5xyBWbAyA&oe=64E44470,https://www.facebook.com/NVIDIAAI/photos/a.119492422050369/1153071645359103/?__cft__[0]=AZVUsaCvvteOrI27NOd3cpw_fiMrCWoP1fUYA-2rPkl-xuaGc2vD72txHl4vbCMo1mo0SHro_f8ueCN-FvRptzeCO9FC2UsUJwU76SEXTjW9vPjcU8iSAUuU_ucoIVUdulifWA2_8zhHW4YLwqT3t7ZWGAl8WwCPh_TbA18v_KTaZDZVqTXKJPZRfwwCf-bCZQxnaALDy6RgVEHzToOf7zkh&__tn__=%2CO%2CP-R,28,0,positive,28
pfbid02z1KaGqBenKvqn6fmVRB9wevkhrsm6KsCiNZvouB6Tc1KLqmjfqyc9YphCtt3UWmvl,NVIDIA AI,0,12,0,1,1,0,0,0,14,2,"#AI World Record for Route Optimization!NVIDIA, thanks for sharing.Read more: https://bit.ly/3Z4CSBV#NvidiaPartner #ArtificialIntelligence #AugmentedReality #Innovation #Digital #Technology",2023-03-21T00:00:00,['blob:https://www.facebook.com/97a28611-2a15-4976-886b-66b465135ff3'],https://scontent.fcai19-7.fna.fbcdn.net/v/t15.5256-10/334977942_637224054805868_2741195943489388298_n.jpg?stp=dst-jpg_p960x960&_nc_cat=111&ccb=1-7&_nc_sid=ad6a45&_nc_ohc=y95jTG4DFO8AX-jxAxz&_nc_ht=scontent.fcai19-7.fna&oh=00_AfA7R-t4g_HJ5Mr3InvyDToVtEjVOfYhSmnQszru-JC_eA&oe=64E2EC60,https://www.facebook.com/NVIDIAAI/posts/pfbid02z1KaGqBenKvqn6fmVRB9wevkhrsm6KsCiNZvouB6Tc1KLqmjfqyc9YphCtt3UWmvl?__cft__[0]=AZWc3RQRWH_zF5hYdQzF6YpttvCTN-mxrLWL2T3Zi1QNsIduP0OBGZPb8vud_QHKmbSNKoFK_0iCAG2S0yh9ZMbaUOPg589-ef4iy_JyZE6sC0RE0yuBpYL_jRkhXs9kYd0oc6ezfgzH5byjqxPrXguVspuaRDtSpnWfvoyTE1mOWq3Up5gn6N8XIcsOx56SJGWz4OjEf5NbWTV2cN_Ib7_HszVvtfrbS96wMzrrFmpNcbAlOdMdWqHFEuuzU0-tBs4&__tn__=%2CO%2CP-R,14,0,positive,14
1153009205365347,NVIDIA AI,0,11,1,0,1,0,0,0,13,1,"Join Rama Akkiraju, NVIDIA VP of Enterprise AI and Automation, at #GTC23 to hear first-hand experiences from guest execs at IBM, VMware, Blue Shield of California and Scale AI about leveraging #AI to transform enterprises. Learn about opportunities, challenges and best practices for building products and in-house technologies. Learn more: https://bit.ly/403vTuv",2023-03-21T00:00:00,[],https://scontent.fcai19-7.fna.fbcdn.net/v/t39.30808-6/337063031_148481084520878_5787637825460106634_n.png?stp=dst-png_p180x540&_nc_cat=108&ccb=1-7&_nc_sid=9267fe&_nc_ohc=GdHjfICiwJEAX9DD-zl&_nc_ht=scontent.fcai19-7.fna&oh=00_AfB6rg-MgMRhw4NDtArZy3FB6LV0ST19pji12laQHYDLiA&oe=64E48114,https://www.facebook.com/NVIDIAAI/photos/a.119492422050369/1153009205365347/?__cft__[0]=AZVRdXfURjQPUqX4IJV56sM82jNOyzBekdtgZosfkXo_pys1YlpAmaZ0ws8GjX3evUx_o_QEv3x-dWRmFIZ0HjUY59XzauWg2cVW4OIhyudlXRD0XzLSDTwKyXssiDvstaCf89LoJz0znAvTtyE-ilQ_6RoOFYQW7s9Iooe8ZJW5A-cDA_XJsDIZ6kA6iMbjicwqQ8pMtUNvYx3ucfcixoff&__tn__=%2CO%2CP-R,13,0,positive,13
1152719628727638,NVIDIA AI,0,10,0,0,1,0,0,0,11,2,"We are excited to have Geoffrey Moore, author of ""Crossing the Chasm,"" as our special guest for the interactive AI Business Essentials for Executives session at #GTC23. Join us to explore crucial questions like ""What's possible with AI today?"" and ""How can AI help my business?"", providing insights you need to leverage #AI for maximum impact.  Wednesday 3/22 at 8 a.m. PDT  https://nvda.ws/3FClKwu",2023-03-21T00:00:00,[],https://scontent.fcai19-7.fna.fbcdn.net/v/t39.30808-6/334063883_562402662534030_7264294657526667533_n.png?stp=dst-png_p526x296&_nc_cat=101&ccb=1-7&_nc_sid=9267fe&_nc_ohc=ijUhVkj18isAX9OKeBQ&_nc_ht=scontent.fcai19-7.fna&oh=00_AfA4jmYbqPrRjS4CiVReCkMW7p2ghTdppG9AcTDlJzzrrw&oe=64E3E784,https://www.facebook.com/NVIDIAAI/photos/a.119492422050369/1152719628727638/?__cft__[0]=AZWP5sExyE1ylmTChE0kAYlCZzikjSXpykSPpbV_2yyk3ShIFLRxBjs4iZWZDthmv5-g9BTUj3EFanCyB-JsJJojlTjySQdDT_-L41W7-rOrxvPwiwI2C5XpwORrcOHpVfjdQJuHBSX3nSFVDAe883XZU2PCNNOlyfbFiSTF1NgMrD1yNWrYvZYUWqvze72X-6wJqvqbSlUl4oGBBTHJw_yD&__tn__=%2CO%2CP-R,11,0,positive,11
1152654045400863,NVIDIA AI,0,6,1,0,1,0,0,0,8,0,"Hear from industry leaders LinkedIn, Roblox, and more on how they've harnessed the power of #recommendationsystem to pioneer products that shape the online consumer experience. #AI #GTC23 #GenerativeAI Register Today: https://nvda.ws/3Iv7ckp",2023-03-20T00:00:00,[],https://scontent.fcai19-7.fna.fbcdn.net/v/t39.30808-6/336802341_119309861064034_1977950859871856931_n.png?stp=dst-png_p180x540&_nc_cat=110&ccb=1-7&_nc_sid=9267fe&_nc_ohc=F7R0yNXG-0wAX80ms31&_nc_ht=scontent.fcai19-7.fna&oh=00_AfBPX79sO8-WfjlIlM7-6EGOfiocLSdFsFIf5b9kNEGr2g&oe=64E3C0C6,https://www.facebook.com/NVIDIAAI/photos/a.119492422050369/1152654045400863/?__cft__[0]=AZVQxH_tZxS7xuM6lC7mHj4UuXHlsvLuHvWX6elYKT0lsUjEyWuCJ1Qwkcf-Np_mKtnTpzXCWCNBe4atacQBq-Zj35My4l8KcB8S_vBIp_ReKYzTeBV0khQwMBYWxNv9P3dsOEja1IvvoiKBwwsVju2xgriU55NZP6SbBP7jkVnW_3X5CLmfymly59fJ1PJ1HrWdWrtIRK3Bx3zX53iexZNr&__tn__=%2CO%2CP-R,8,0,positive,8
pfbid02uMToN3EYnNpsyMKuaH3sFDs4AAqFFSBFTXPPGKs7oniFNGhyKVeq1XYDGMEqorAal,NVIDIA AI,0,17,2,0,1,0,0,0,20,0,"AI workflows are cloud-native, packaged reference examples that illustrate how NVIDIA #AI frameworks can be leveraged to build AI solutions such as intelligent virtual assistants, digital fingerprinting for #cybersecurity, product recommendations, and more. https://nvda.ws/3Jrrvyd #recsys #speechAI",2023-03-20T00:00:00,[],https://external.fcai19-7.fna.fbcdn.net/emg1/v/t13/14007241195119621817?url=https%3A%2F%2Fi.ytimg.com%2Fvi%2F74fDoIvxfB4%2Fmaxresdefault.jpg&fb_obo=1&utld=ytimg.com&stp=c0.5000x0.5000f_dst-jpg_flffffff_p500x261_q75&ccb=13-1&oh=06_AbEMsxqDURGdqlEttSXSrcilh6iD5bHmzU8uTrsKQqG_aw&oe=64DFFFB9&_nc_sid=dbad39,https://www.facebook.com/NVIDIAAI/posts/pfbid02uMToN3EYnNpsyMKuaH3sFDs4AAqFFSBFTXPPGKs7oniFNGhyKVeq1XYDGMEqorAal?__cft__[0]=AZXSw9DQB6nmJo2fETDANw1_RJaj9phamF57Qxtqb7NqHgGnAKBkCGK4PR_ASmf3z5RshNm7qAjk5t7XSO3Jsy7MibymT56mFvgMlK8bnpLeA_y68p27OpxbJ4_50k-4iRvkf7Q2qWH3am33QHuqMz2wmLMfzToA9nzrGrFVpnUfDC5SlZoKn_PnRnSmiXYTb55vg4ERldfc-xlZupoDArYs&__tn__=%2CO%2CP-R,20,0,positive,20
pfbid02Hn3i64ur1JYwzqffX3c6udsGqVFjuxS1mz9uME6DPMbXseJYrtfPZ6TXCUzi1pT1l,NVIDIA AI,0,12,0,0,1,0,0,0,13,1,Have you ever wondered what it takes to bring a virtual character to life? Learn more about the foundational #AI building blocks to create interactive avatars at #GTC23. https://nvda.ws/3DwG81c,2023-03-20T00:00:00,['blob:https://www.facebook.com/a9ffb2b7-6bf1-4d17-9c69-9651d49af9e8'],https://scontent.fcai19-7.fna.fbcdn.net/v/t15.5256-10/335967994_119375024398141_5419190566185497340_n.jpg?stp=dst-jpg_p960x960&_nc_cat=104&ccb=1-7&_nc_sid=ad6a45&_nc_ohc=L238ThMHNRcAX-u2a2X&_nc_ht=scontent.fcai19-7.fna&oh=00_AfBbgeiyU3xJ_l0MpbPnCZCMViavkD31q9ELCJvFO9qMhg&oe=64E45507,https://www.facebook.com/NVIDIAAI/posts/pfbid02Hn3i64ur1JYwzqffX3c6udsGqVFjuxS1mz9uME6DPMbXseJYrtfPZ6TXCUzi1pT1l?__cft__[0]=AZUW0hZ6ohWD0dtKylAdFhDDtEQwezc-sCxaYFv52B1ncFnizZv18lebRf8vdK5nQ4RBg14tTxMMWUVZOV7kOKVsWm1lg46gtkVel4kS3GMvnCZ3oU2lxAz0e4ujxjxSYB-UMYyHAKfPzQVj7OcWnByGtI0ctKR3B4u1Oi5DVR7dffEhqrnBFh2xgjb3TuYZGJsaT3b9Bc8ya50X3VFrMXUeopkfU8uSqG1P_enl0mzftw&__tn__=%2CO%2CP-R,13,0,positive,13
1152207222112212,NVIDIA AI,0,8,0,0,1,0,0,0,9,1,How can financial firms accelerate derivative pricing using #AI and #machinelearning? Find out how JP Morgan Chase is using a novel solution to calibrate financial models using autoencoders. Join their #GTC23 session on March 23 at 9 AM ET: https://nvda.ws/3KHwbSX,2023-03-20T00:00:00,[],https://scontent.fcai19-7.fna.fbcdn.net/v/t39.30808-6/337031253_2015220538809611_6256265627863095162_n.png?stp=dst-png_p526x296&_nc_cat=108&ccb=1-7&_nc_sid=9267fe&_nc_ohc=8LMnRlxNbCEAX9o42_r&_nc_ht=scontent.fcai19-7.fna&oh=00_AfDIJ5JnBrRSxbiksVacqOa7nWyFFnx0Egb-2LBXs6OPxQ&oe=64E46F97,https://www.facebook.com/NVIDIAAI/photos/a.119492422050369/1152207222112212/?__cft__[0]=AZUtBsDjZ1bB8NkuJfSpyeCe39l2TF7H8wFgZywQrWFc3ydqoqUnJgQ2eQ441v1n-8xwBI7qNX7kiAIbzkwUbWC-oXIY6WMQ8KURTk01Qj1KPjcgwFv9J0pHqEI04kZ7JSYSfMPcIbCJQN-B6iuuJQItIoSJvHFqLgE73N4cBLi-6ouG2-10HuwMTtLqsOIJxpczfO9b8nA9Q2weYa2iS2Ey&__tn__=%2CO%2CP-R,9,0,positive,9
1152173748782226,NVIDIA AI,0,5,0,0,1,0,0,0,6,0,Learn how large international banks have been using NVIDIA #GPUs for risk calculations and discover how NVIDIA AI Enterprise can improve performance. Gain insights into the challenges of multi-tenancy requirements and best practices for application deployment: https://nvda.ws/3Z7iLUw #financialservices #GTC23,2023-03-19T00:00:00,[],https://scontent.fcai19-7.fna.fbcdn.net/v/t39.30808-6/336898527_225772789945298_5286003823693086828_n.png?stp=dst-png_p526x296&_nc_cat=103&ccb=1-7&_nc_sid=9267fe&_nc_ohc=GV7U-gix5x8AX8bfRs2&_nc_ht=scontent.fcai19-7.fna&oh=00_AfBpqJ14abvzVpa_cHQhNGH1hNEg0qyI6eryZu_cGF2LuQ&oe=64E415BE,https://www.facebook.com/NVIDIAAI/photos/a.119492422050369/1152173748782226/?__cft__[0]=AZVLnApAlgZU8LFK5QELkxB6_feH8iRGUCyvA_rsQWMB334NytWe-XBAu-SgHaarin45JRX9ejBaUG4xjw60-sWVUEnTgrTfEToaJrn7JonYL9XQ7MaBMzqppulsG4vWtoF_dCTrSf5Uw2AW0m6x2upWQX4gNf-bgM_R-VT9qBn5KI8CId3gCZAjPACz0L2_dEp2peAHg4xRzPqc6K6VBiBG&__tn__=%2CO%2CP-R,6,0,positive,6
1152137575452510,NVIDIA AI,0,12,1,0,1,0,0,0,14,1,"Financial supply chains are using edge #AI and intelligent video analytics to enhance control services and improve application performance. On March 22 at 5 PM PT, hear how Ping An built a supply-chain finance solution powered by the NVIDIA Jetson edge AI platform. Register for the #GTC23 session: https://nvda.ws/3J1itc6",2023-03-19T00:00:00,[],https://scontent.fcai19-7.fna.fbcdn.net/v/t39.30808-6/337003539_6078434502271491_8516320300443075928_n.png?stp=dst-png_p526x296&_nc_cat=105&ccb=1-7&_nc_sid=9267fe&_nc_ohc=Je-T197VXQAAX8b8aZN&_nc_ht=scontent.fcai19-7.fna&oh=00_AfCNCAO3FGOXQDkgFDFrbN1EYJ5ZxNQaEhssvUidARN7KA&oe=64E473DA,https://www.facebook.com/NVIDIAAI/photos/a.119492422050369/1152137575452510/?__cft__[0]=AZXBQlARtdNGDR53wsEpdxGcgwwFJgYd-a5Tn2X0948ef1ZyjGyO5ez92ZF4IZrgYPm6f7YDHDOin_S2N5iLyF8psMNcdRmSWt5TWt8kL8BhqfDxPqGwcac_ZHwfFuVvQXg5Rtv3zWvXLSa5DlOWsqZW4n-z85fvaj5ELz80jYHEou0e7crOCHbF3mVnyfW6czesyC1xk1dsD1NX3fmT4Rtv&__tn__=%2CO%2CP-R,14,0,positive,14
1152091065457161,NVIDIA AI,0,7,0,0,1,0,0,0,8,1,"Learn how Portland General Electric, an innovative electric #utility, is seeking to solve the industry's most complex challenges with distributed #AI at the grid edge--powered by Utilidata and NVIDIA. Join the #GTC23 session on March 23 at 7 AM PT: https://nvda.ws/3SHQLEx",2023-03-19T00:00:00,[],https://scontent.fcai19-7.fna.fbcdn.net/v/t39.30808-6/336752376_3470166126571659_5986525330238828126_n.png?stp=dst-png_p526x296&_nc_cat=109&ccb=1-7&_nc_sid=9267fe&_nc_ohc=7NE5REN9VT0AX_LU1pS&_nc_ht=scontent.fcai19-7.fna&oh=00_AfDAIl57NSDcGsDVsSA_9eNinso44StOBjgN-zEAQsiLRQ&oe=64E3A780,https://www.facebook.com/NVIDIAAI/photos/a.119492422050369/1152091065457161/?__cft__[0]=AZVQm5eaVzuTX2UkhS6Azb3WwKApTEhrX5-5XwW0P6MCjlrOEIRTrWnoTyZGY6g0B4N9z-0cwsIIAe5b_DZ_D8K6Su64EPnOEsI1B-bbZrRG03l3sHrcYFLznXnKJbh49sj7zy8UOBcGClvIKeUNSolwlc3puvUahUNfRIFAyfFgS2P74-znngtlAQiQ4rmBKGTNNowe4hxJPPf_Fs1cG7kR&__tn__=%2CO%2CP-R,8,0,positive,8
1151662748833326,NVIDIA AI,0,7,0,0,1,0,0,0,8,1,How can financial services firms effectively detect fradulent transactions across millions of endpoints? Mastercard is using transaction graph networks and machine learning to detect fraud. Register free for their #GTC23 session on March 22 at 7 AM PT: https://nvda.ws/3Zatj5q,2023-03-18T00:00:00,[],https://scontent.fcai19-7.fna.fbcdn.net/v/t39.30808-6/336804887_758334515619901_6769077023297816766_n.png?stp=dst-png_p526x296&_nc_cat=109&ccb=1-7&_nc_sid=9267fe&_nc_ohc=9Mq9MRDYTGgAX8z9pnU&_nc_ht=scontent.fcai19-7.fna&oh=00_AfCNn4bUgd53b_G35z8M8kf0EI_HyXXZVq70hS4tY2psDw&oe=64E2CFA4,https://www.facebook.com/NVIDIAAI/photos/a.119492422050369/1151662748833326/?__cft__[0]=AZVIGxFtIgNQQrb1p7OFAm_WeZxzz7ZDFbI6XWjxmhDV2MzejFC8TK30HPiz66ooYwW4hyWb_v0p6PMRdgPuh1xZe8gDSVW6e4DXSHjJkS08cJSn-eKxnVQESmrvoysKp_KSDsXIQkfYlIDOSorBOOCQ1DsMnFUo4oERLAM7ub7VaqITZDsgT4DJ1m3lHtAHX8APKJdVyiKzfDE7ZfHQY9J1&__tn__=%2CO%2CP-R,8,0,positive,8
1151581475508120,NVIDIA AI,0,15,0,0,1,0,0,0,16,0,"BP achieved runtime speedups by porting their production Reverse Time Migration (RTM) code, a critical seismic imaging workflow, onto NVIDIA HGX A100 and leveraging the cuFFT library.Learn more at #GTC23 on March 21 at 2:00 p.m. PT: https://nvda.ws/41CbDRN",2023-03-18T00:00:00,[],https://scontent.fcai19-7.fna.fbcdn.net/v/t39.30808-6/336511022_520814906885613_956775321984289354_n.png?stp=dst-png_p526x296&_nc_cat=101&ccb=1-7&_nc_sid=9267fe&_nc_ohc=9PXz9xbvyQoAX8TbEnM&_nc_ht=scontent.fcai19-7.fna&oh=00_AfAKogOOn6nxV9Yvt5h4guPpCmEeiLR4RvLl6vUeMBDOxg&oe=64E3C67A,https://www.facebook.com/NVIDIAAI/photos/a.119492422050369/1151581475508120/?__cft__[0]=AZUIgA5P_JTpFS-mlcHVyHPJv-ZHfWP_PsqLzW7mq08CMbMztCUiXolZ2P5_vHoH9iLSuCCqnFJls5eLbkDp09cZ-gLjNuCc79ax1ERK2roVLgw9FyK6LssHQoStYCmNyD5pcwTz4a_EbHNG3iWFORQwPe7ERfF0W9Ws8B2L3zZJj05g1tqcjQnDA3ULArI2umkLeeaw70QH-JTGLkUJT-qJ&__tn__=%2CO%2CP-R,16,0,positive,16
pfbid0FqtXyv4NAVYQgM9xssSF1eVF68zydxkDrxAfZiEETxEiGN86PHtKQvMnPquywpnyl,NVIDIA AI,0,18,0,0,2,0,0,0,20,5,"Kaggle Grandmaster and NVIDIA Senior Deep Learning Data Scientist Théo Viel joined Ken Jee to discuss Theo’s origins in Kaggle, how he keeps a regular competition schedule, what it is like to be on the Kaggle Grandmaster team, and much more. Check it out: https://nvda.ws/3lis7y3Don't miss Théo and the rest of the KGMON team next week at #GTC23.",2023-03-18T00:00:00,[],https://external.fcai19-7.fna.fbcdn.net/emg1/v/t13/7804176426901233502?url=https%3A%2F%2Fi.ytimg.com%2Fvi%2F7Z2IY4TE3jk%2Fmaxresdefault.jpg&fb_obo=1&utld=ytimg.com&stp=c0.5000x0.5000f_dst-jpg_flffffff_p500x261_q75&ccb=13-1&oh=06_AbHCyavPlCzz4WZYwTvvjHGylpA9fZtv9m5Br0YW8oK9Pw&oe=64E064F6&_nc_sid=dbad39,https://www.facebook.com/NVIDIAAI/posts/pfbid0FqtXyv4NAVYQgM9xssSF1eVF68zydxkDrxAfZiEETxEiGN86PHtKQvMnPquywpnyl?__cft__[0]=AZVe0GWuCDSP6CPxiSM9aHcKlh_vq6Xv1laQUn7lG3HXhjj4aD2RAj2Y2UuQkc2VVT6ipq0TfZe7hqpC-KaKlIfnb5RqPNIlUvyB1kmd8cpAkIuXAXuzledw2srT8Iq3obHeaaZOepixOkxHM4w7U9fgrf9MCqHlQAXwyHQmFS280zsTW9sgsUbvOm1uVVUWq43H1G9BJ5y9STZK_z7HKkfp&__tn__=%2CO%2CP-R,20,0,positive,20
pfbid0qDe1dSNjMWWPB5UqtdKkAj44HVnQgdddN3zc4xaL8tbY3CXFYoSz6kRDbip2jk4Tl,NVIDIA AI,0,4,0,0,0,0,0,0,4,0,Join an #AMA with our #generativeAI experts from every industry at this #GTC23 watch party. Sign up here: https://nvda.ws/42pHVA3,2023-03-17T00:00:00,[],https://external.fcai19-7.fna.fbcdn.net/emg1/v/t13/13362099270706253269?url=https%3A%2F%2Fwww.nvidia.com%2Fcontent%2Fdam%2Fen-zz%2FSolutions%2Fgtc%2Fsocial-image%2Fgtc23-spring-web-sponsor-page-general-og-r2.jpg&fb_obo=1&utld=nvidia.com&stp=c0.5000x0.5000f_dst-jpg_flffffff_p500x261_q75&ccb=13-1&oh=06_AbHNbbGluapcxXXVoJo9SGym4kzpx8gbeXh842o7Z9nL4A&oe=64E009FD&_nc_sid=dbad39,https://www.facebook.com/NVIDIAAI/posts/pfbid0qDe1dSNjMWWPB5UqtdKkAj44HVnQgdddN3zc4xaL8tbY3CXFYoSz6kRDbip2jk4Tl?__cft__[0]=AZUijsMn23OyzfComX0xcIppNK23geuGeBur-4-RDfhsLgnltiCKQ8sEuT3krzFCQk5sxOQPi6VpsuPjlUNJW9S4cbCe7FfHZTMsVezzqMZpACANmUqrAjxVXMv28FSMKOml7sQ-XGtRRTVXj8rftkR36miBBZnAm6tALfSiXIoQihKa2JDFoJLtV91DLMJHng6VmMqR1QUyidrUqRf0BYna&__tn__=%2CO%2CP-R,4,0,positive,4
pfbid0gAtFFcseY9QpvDY1gfKNNh2VjarGX9yM1ahU2YGE5FZDfeScUhPGTb5dWycEbTPkl,NVIDIA AI,0,11,0,0,1,0,0,0,12,0,Technical walkthrough: Optimizing end-to-end AI. Learn how to optimize #AI inference performance and accelerate model deployment on with #TensorRT.Read part 5 of our series: https://nvda.ws/3Fyxdxc,2023-03-17T00:00:00,[],https://external.fcai19-7.fna.fbcdn.net/emg1/v/t13/2880644534911601325?url=https%3A%2F%2Fdeveloper-blogs.nvidia.com%2Fwp-content%2Fuploads%2F2023%2F04%2Fproviz-dev-aaai-featured-image-part5-1920x1080-1.jpg&fb_obo=1&utld=nvidia.com&stp=c0.5000x0.5000f_dst-jpg_flffffff_p500x261_q75&ccb=13-1&oh=06_AbEOi9rzOQLEgt3iz3QIFE5UjN-dKwLMGdfKHWRSuk9WmQ&oe=64E06DCF&_nc_sid=dbad39,https://www.facebook.com/NVIDIAAI/posts/pfbid0gAtFFcseY9QpvDY1gfKNNh2VjarGX9yM1ahU2YGE5FZDfeScUhPGTb5dWycEbTPkl?__cft__[0]=AZVU-sUkydGNPjQrolm3SFJGd_RTemaiFMrMyBo1OZH0iOpWruH3yAH0KUW0Fmd6kBcEQzvmb4q6WkE3nFcCKIIKzSrsGu-_KKtj_MTNY_l5X2oerjDe_RkwZbMoAqqGCkNR0eak3SxgqfS3drkpdAonvtj-V-zRs0vbcC1IOVSHn4PEqOF6oBbOZy70c8qV7YvgOyMHEn42jZQOhc07Jz7d&__tn__=%2CO%2CP-R,12,0,positive,12
pfbid02d8DJz4i5iDkyUWutmAynGMJX26FJGxSnCdkKgYwkCfakb3APMbNYPVz6xyW7Uvhl,NVIDIA AI,0,6,0,0,1,0,0,0,7,0,Attend NVIDIA Deep Learning Institute (DLI) training labs and workshops at #GTC23 and improve your data science skills. Check out the list of data science opportunities: https://nvda.ws/3yozXsR,2023-03-17T00:00:00,[],https://external.fcai19-7.fna.fbcdn.net/emg1/v/t13/9134677940708886837?url=https%3A%2F%2Fprod2-sprcdn-assets.sprinklr.com%2F50276%2F0753f687-3390-4071-bd5a-799c1a997d74-644219421%2Fgtc23-spring-dlil-x4-drive-reg.png&fb_obo=1&utld=sprinklr.com&stp=c0.5000x0.5000f_dst-jpg_flffffff_p500x261_q75&ccb=13-1&oh=06_AbHF-3vUBnK4WuUzO0WYID6rkLR_fOMao-L3KwA2SASfKg&oe=64DFF9E5&_nc_sid=dbad39,https://www.facebook.com/NVIDIAAI/posts/pfbid02d8DJz4i5iDkyUWutmAynGMJX26FJGxSnCdkKgYwkCfakb3APMbNYPVz6xyW7Uvhl?__cft__[0]=AZXTubTSBmNk7jSCTtL_kJGsvD4jkP88f_YI9CvVKp_xkcdZADXmGOyJ344l5tF8ebVJbm6nuVXisnr805PX-RcnQztF8WL4kWEKmvZ-HNR7xmGUYdSzr_amFLDEXFERIFIFHSL74swW1_Ky_pQj5ZcMtsxCtg1IB6ZZpE9MT3oUgx3zgbspwWVw0a-Y6ZFse5AdgCOpzlKKKN3EKVOOiuOU&__tn__=%2CO%2CP-R,7,0,positive,7
pfbid02zUJ7ptbz6Fv5Dx9jKi52DLSSatNQB1gpjzNF9E2CukaYww8KZ7NdGKKoJYsMRjjDl,NVIDIA AI,0,14,0,0,1,0,0,0,15,3,"What does it take to become a Kaggle triple Grandmaster?Jean-Francois Puget, PhD Distinguished Engineer at NVIDIA, joins Data Evangelist Richard Cotton of DataCamp to dissect his scientific approach to #machinelearning and how he uses this to consistently achieve high results in Kaggle competitions. Listen here: https://nvda.ws/3JrJdSaLearn more from Jean-Francois and his peers at #GTC23 next week.",2023-03-17T00:00:00,[],https://external.fcai19-7.fna.fbcdn.net/emg1/v/t13/11403074097057633571?url=https%3A%2F%2Fres.cloudinary.com%2Fdyd911kmh%2Fimage%2Fupload%2Fv1678723572%2FQuote_4_2c2a3a0f5e.png&fb_obo=1&utld=cloudinary.com&stp=c0.5000x0.5000f_dst-jpg_flffffff_p500x261_q75&ccb=13-1&oh=06_AbFpseSiR-S2JWJtUKL92BkZopuuqL1zzo-TdOsruJ27rA&oe=64E02E78&_nc_sid=dbad39,https://www.facebook.com/NVIDIAAI/posts/pfbid02zUJ7ptbz6Fv5Dx9jKi52DLSSatNQB1gpjzNF9E2CukaYww8KZ7NdGKKoJYsMRjjDl?__cft__[0]=AZXEp-9QbLOkZME97zw1I3bkPBLlBqkmbHEffagq31YhNY9hCR9K07kSjDS2bLkbToiw1UeFcLTQtGGxPecwfFxDbwLzneBysWTVocb5XgBEKtle6ZY9Pl1f6yJP2rUTM4lW9R5BJlINLnmrOjnhVlacPFrWiMNxf2LQyTHCCGiI5_ddZuC29kIgIphUYFFMFfUKwIx_EiGEba1YAK__zmdL&__tn__=%2CO%2CP-R,15,0,positive,15
1150706202262314,NVIDIA AI,0,18,2,0,0,0,0,0,20,2,"​Just announced: Utilidata is working with NVIDIA to develop and deploy a lower-cost, lower-power module to deliver real-time #AI at the grid edge. The purpose-built module will leverage the NVIDIA Jetson platform and power Utilidata’s #smartgrid chip beginning in 2024. Learn more: https://nvda.ws/3ZUj5Gw",2023-03-17T00:00:00,[],https://scontent.fcai19-7.fna.fbcdn.net/v/t39.30808-6/336530228_620085846609483_5950354290505524099_n.jpg?stp=dst-jpg_p180x540&_nc_cat=109&ccb=1-7&_nc_sid=9267fe&_nc_ohc=YJG7eSPVUWoAX836Iwl&_nc_ht=scontent.fcai19-7.fna&oh=00_AfBTepVfATlvd_c5khn5TvpfEYrNkPYJ48pUHLIXYR_vuw&oe=64E4A86F,https://www.facebook.com/NVIDIAAI/photos/a.119492422050369/1150706202262314/?__cft__[0]=AZWCDS_AYTpuBS3vN2wtY8Kdc6uRPqMIqGTzR6qDajLFR9-Ww74oafZVGhf70nV9cpxFhtaA3Gis3OIRmk1vT4d76sg-lEn8fYEE3FrbVW_klUwwsvbq4jVX-lT8BQtTMkPanIM1_uBOSvuadg-mZ2A562HPAjmjmv0uFX0UmPOFX_2lo6SJUspAu1yjUjnAkmA_7u5lNlel2_CffWItTljl&__tn__=%2CO%2CP-R,20,0,positive,20
1150690415597226,NVIDIA AI,0,5,0,0,1,0,0,0,6,0,Hear from enterprises that have successfully leveraged #NVIDIADGX Cloud and implemented a hybrid #AI infrastructure that unifies AI development across on-premises and cloud. Register for this #GTC23 session now. https://nvda.ws/3y06NAg,2023-03-17T00:00:00,[],https://scontent.fcai19-7.fna.fbcdn.net/v/t39.30808-6/335450634_209350241730016_4102388236470092166_n.png?stp=dst-png_p526x296&_nc_cat=103&ccb=1-7&_nc_sid=9267fe&_nc_ohc=cWauyT2TBQ8AX_Nx6Ti&_nc_ht=scontent.fcai19-7.fna&oh=00_AfAXEo_J5OaZJbsqFB888WAZ164MFxhJgXE1YBiJYFDgog&oe=64E2EC85,https://www.facebook.com/NVIDIAAI/photos/a.119492422050369/1150690415597226/?__cft__[0]=AZX7qiZwQTvrCq9fUtRGiup-BhuN1fhn8NlvnV8XI4FKXh2SdmmC75dv0GCtMcyZRuqUzl51VywXRJzqDkeuqKu55-vSJvQhN1NwPrtQeQBt_FxLm40Jc4cRUViMcOGv12xeashnAPYaONKRVwvOqULZmKooOWwkwXyV9y73FenCPESvDCExb25UW4NL-ZaGjITBAV7z7WVUAGCmA2jemHx5&__tn__=%2CO%2CP-R,6,0,positive,6
1150674128932188,NVIDIA AI,0,11,1,0,1,0,0,0,13,3,"While Monte Carlo methods are widely used to value complex financial securities, they are also computationally expensive. On March 21 at 11 AM PT, learn how JPMorgan Chase is using machine learning, TensorFlow, and NVIDIA #GPUs for fast, cost-effective Monte Carlo simulations: https://nvda.ws/3m5osng #GTC23",2023-03-16T00:00:00,[],https://scontent.fcai19-7.fna.fbcdn.net/v/t39.30808-6/336359623_236645162136419_5343178438988481146_n.png?stp=dst-png_p526x296&_nc_cat=108&ccb=1-7&_nc_sid=9267fe&_nc_ohc=CrokGJmEZt0AX-5ll9J&_nc_ht=scontent.fcai19-7.fna&oh=00_AfCUNr1QX_Bg2vIwbUywBIHzJBwd7WTouf07KVktZv25ug&oe=64E49343,https://www.facebook.com/NVIDIAAI/photos/a.119492422050369/1150674128932188/?__cft__[0]=AZVGabt451bHr7bSqegFs_QiwJMPRgsdxEnmpbiWnlwiQHi-VO-W9fz2QlrRIcwvEzYezuk6wqw_ga-Nl4k6y-C6zbHaOs0ZJwZ2mTInN475KVAa9KbsPPZ1nrSrT09cVdq26RiJ_FiSAVSaYTk_zf0FSNyXnhMbcKG6Lac51J56VlbwOI627cNk_1yqHyPYT6aMNE3C1vrwlB_GxFtg97Gr&__tn__=%2CO%2CP-R,13,0,positive,13
1150657368933864,NVIDIA AI,0,9,0,0,1,0,0,0,10,0,"At #GTC23, gain valuable guidance on the #IT strategy needed to enable your business to reap the benefits of the next wave of #AI transformation. #DataCenterRegister now and add this session to your schedule: https://nvda.ws/3y2Fkhp",2023-03-16T00:00:00,[],https://scontent.fcai19-7.fna.fbcdn.net/v/t39.30808-6/335292235_3357626207844477_9167516246505060196_n.png?stp=dst-png_p526x296&_nc_cat=102&ccb=1-7&_nc_sid=9267fe&_nc_ohc=H-gZnDaECM8AX875Ysa&_nc_ht=scontent.fcai19-7.fna&oh=00_AfC0HsSGY2TU5pwRVrbTEjoHuEMP6OBhWtmYus3vzK4Vdg&oe=64E48955,https://www.facebook.com/NVIDIAAI/photos/a.119492422050369/1150657368933864/?__cft__[0]=AZXn689De-pKf2SY4aOpjXHchFwXn4ZcvYX-MDyqhE-vHcwWg06qwQk1JJ3DSgJBQ_Ln8x6rPq92pe8-uU4cp6TF9d0kHcmRMJcbI_pPkBhlCGa454dbup3b-8F_1z8NB0p2y9-YIafJPXL0PYjtG6ORymoObGf0hlWz79iSIwDgL1leSrucaR3e9nG7Qg4PPb3LEIufQ7rmoy26r2GrGwtE&__tn__=%2CO%2CP-R,10,0,positive,10
pfbid02rqn28v4JBDafE3sNghRVrwS1QXnQdd71RsUTjHaSdSGqhKEHJe2UHBAiH1CGfpwUl,NVIDIA AI,0,7,0,0,1,0,0,0,8,1,"Learn how to build and deploy sophisticated #cloudnative vision AI applications using #syntheticdata generation with NVIDIA Isaac Sim, transfer learning with #NVIDIATAO, and pre-built microservices from #NVIDIAMetropolis. Register now > https://nvda.ws/3YZkieT#GTC23",2023-03-16T00:00:00,['blob:https://www.facebook.com/bd18f761-0fe5-4821-a5e8-478c50d9d066'],https://scontent.fcai19-7.fna.fbcdn.net/v/t15.5256-10/336528995_162042126693799_1834664268918051906_n.jpg?stp=dst-jpg_p960x960&_nc_cat=107&ccb=1-7&_nc_sid=ad6a45&_nc_ohc=OTIcS8Btz18AX9Ea_Aq&_nc_ht=scontent.fcai19-7.fna&oh=00_AfAfqflQyvx5JRvEQcMzWkpkkPK8J-DiCWjKvZAvA3lgDg&oe=64E30DBD,https://www.facebook.com/NVIDIAAI/posts/pfbid02rqn28v4JBDafE3sNghRVrwS1QXnQdd71RsUTjHaSdSGqhKEHJe2UHBAiH1CGfpwUl?__cft__[0]=AZW6tUZQAf3n8BKsWb8VRURsJQshfxJgwSwnt5OVg4eL6NAjwuwGiv7EgdgckPpJDaoLH8h-hNQ1eilJbbVM4d2veyKca0XAmauQq5DpXJWHQjnCwnqD053QlB-Q6ayU940ERHuiAE-YifAVZeFJauhkuG8va2jmRBRwVTSDJAFg5X25cl1q9JHUw2kJs2dtszq0EWdY5ZlUFMWoCsug3M0lXJ1Fd5zTWYUIjkEbTAFMrZDORCWOP2cXhDu34j7GLuw&__tn__=%2CO%2CP-R,8,0,positive,8
pfbid0yMkg4LTLrdrQZNjMrMScN6jByoFBNXoGTjYNfUxzsTzVh9WbCrjhxnMpcZCxQXY4l,NVIDIA AI,0,16,0,0,1,0,0,0,17,2,Technical walkthrough: Learn how to easily create your own custom language models using prompt tuning techniques and the NVIDIA NeMo framework. #LLM #GenAI https://nvda.ws/3JBU8cj,2023-03-16T00:00:00,[],https://external.fcai19-7.fna.fbcdn.net/emg1/v/t13/289551546878161292?url=https%3A%2F%2Fdeveloper-blogs.nvidia.com%2Fwp-content%2Fuploads%2F2023%2F03%2Fcustom-language-model-abstract.png&fb_obo=1&utld=nvidia.com&stp=c0.5000x0.5000f_dst-jpg_flffffff_p500x261_q75&ccb=13-1&oh=06_AbFaYNOQAZ9lfoR4QEtEYqYJABqqV5EXS5Lo_Kev_ADKFA&oe=64E0965D&_nc_sid=dbad39,https://www.facebook.com/NVIDIAAI/posts/pfbid0yMkg4LTLrdrQZNjMrMScN6jByoFBNXoGTjYNfUxzsTzVh9WbCrjhxnMpcZCxQXY4l?__cft__[0]=AZUmiC7IFusYjFVq135r0Qwh3-Gn0xmoY_P-pbMfC05zWnkPU9KuseSwJkgCA2wsU2KX7G5NTrkA8wgR26hua5Ge-1S_DFKnbtFZpBaq8SgL7Vu0LZRJrUdnyAHosHCRo499keW9UwbnQ2SLwtF0elofuveEV8Ht5J0UjErreIir8kM32qo60zSBO_fWXmDexUAavPDWJiDxB_6YixE_buf_&__tn__=%2CO%2CP-R,17,0,positive,17
pfbid0ygyVS1HgFV4t21abhS2wT9eTwMMbWtUfGMT6jyi2BYbGzskoB6koauUDW5seQ2GJl,NVIDIA AI,0,11,0,0,1,0,0,0,12,3,"With new advancements and capabilities built on NVIDIA AI, our platform offers significant cost savings through accelerated data pipelines and reduced processing times at scale. Learn more by attending data science sessions at #GTC23: https://nvda.ws/3ZQWCdb",2023-03-16T00:00:00,[],https://external.fcai19-7.fna.fbcdn.net/emg1/v/t13/70229140017733031?url=https%3A%2F%2Fprod2-sprcdn-assets.sprinklr.com%2F50276%2F0dda76d3-61db-4e6a-a98f-219f6c92b2e4-1160939167%2Fgtc23-spring-social-ai-for-dev.png&fb_obo=1&utld=sprinklr.com&stp=c0.5000x0.5000f_dst-jpg_flffffff_p500x261_q75&ccb=13-1&oh=06_AbGiiW2YL7CWuQ-lZBz9lLo-j_8KNeIaS0Tov8hGuGPNdA&oe=64E06263&_nc_sid=dbad39,https://www.facebook.com/NVIDIAAI/posts/pfbid0ygyVS1HgFV4t21abhS2wT9eTwMMbWtUfGMT6jyi2BYbGzskoB6koauUDW5seQ2GJl?__cft__[0]=AZU1KHV03twpZpIWLlnZlqd8XKg0w1WU2-2jl3mWca0Xf_zwwy4FonmyDexL2GBETU6pe9DpU1A5cpvEd1dSLW_lTPtAs9IoaUk5gbpMwAtnWcLKXRf3O7TP5IsuljwM0OyNu-XExlSzUJ0EC-1fl9IX6CttxTKWX00IJmsrMGFRehFJou-GRNnI9yLOEiQECjtcsTuRzcfCiJlcnuYS_yyo&__tn__=%2CO%2CP-R,12,0,positive,12
1150596538939947,NVIDIA AI,0,14,0,0,1,0,0,0,15,1,"From content generation for marketing to virtual assistants, chatbots, and more, #generativeAI is impacting every industry. Join us at #GTC23 to learn how the latest advancements in NVIDIA NeMo can help you build generative AI models quickly for intelligent enterprise applications. Register Today https://nvda.ws/3YPqgOY",2023-03-16T00:00:00,[],https://scontent.fcai19-7.fna.fbcdn.net/v/t39.30808-6/335429975_165615102966166_3728385839694348263_n.png?stp=dst-png_p526x296&_nc_cat=111&ccb=1-7&_nc_sid=9267fe&_nc_ohc=qHijZcRK9jUAX8WTWAP&_nc_ht=scontent.fcai19-7.fna&oh=00_AfCP8oA3YOuE5iFMgRk-MZrLtjYvYAlSF6KC8BW8EppCZQ&oe=64E43F61,https://www.facebook.com/NVIDIAAI/photos/a.119492422050369/1150596538939947/?__cft__[0]=AZXKQXCe9MM2HsvjcKw4peJ71BrMMfYbRq1dc0_bDvuGfPn5_Qd-8a6zSwFcDybBN-bqNA738rhI6NRWlTNd_a3w6-TmCNjBZRS-zFPplF6be4NBJf9x-JlYThHO0vasvPXmAn59_uR_7uC82MK7jg0abBcA-3L0xg_q0wYDNAkBm8bjsBusZVKHuJpyB1QbfzrlMwbpHd5S1lci6k7KZdc3&__tn__=%2CO%2CP-R,15,0,positive,15
pfbid0bLeiyaDxLp7qAVESz13JXmuBitcjavthq4zj15SDQVG4jpPRMiUZsKrwLeN5vF1Tl,NVIDIA AI,0,8,1,0,1,0,0,0,10,1,"Advance your technical skills with hands-on DLI workshops led by subject matter experts in AI, accelerated computing, data science, graphics, simulation, and more for a special #GTC23 pricing of $149. Register now: https://nvda.ws/3YICUzW",2023-03-16T00:00:00,[],https://external.fcai19-7.fna.fbcdn.net/emg1/v/t13/14503503214717836154?url=https%3A%2F%2Fprod2-sprcdn-assets.sprinklr.com%2F50276%2Fe08d31a8-e867-4b95-aa7b-43457b920876-644219421%2Fgtc23-spring-dlil-x4-drive-reg.png&fb_obo=1&utld=sprinklr.com&stp=c0.5000x0.5000f_dst-jpg_flffffff_p500x261_q75&ccb=13-1&oh=06_AbEKI7MrQP89AG54LdQ_LhxUo5R5va3llzpF9Pfa-nWBSQ&oe=64E07C87&_nc_sid=dbad39,https://www.facebook.com/NVIDIAAI/posts/pfbid0bLeiyaDxLp7qAVESz13JXmuBitcjavthq4zj15SDQVG4jpPRMiUZsKrwLeN5vF1Tl?__cft__[0]=AZVqqI5XsKQLPHdI57FhlBuulXVyHL1HfmXUaxL269kDqUaeAB6LVvaGow0d9_hc69ZSdAkDMIyW9F9zvE08yyYBcctFH98GxniDClvsm6DKwBmUYPEStORr2WJWBP1tbPUXJhTRWtO_iSPhjYLCyZrL5wEcjIldN8lyuRFMtK-iIcZf4bG0Z-OskmjdhZiRq5ah7y7PgUjJ5FVARePMDiwn&__tn__=%2CO%2CP-R,10,0,positive,10
pfbid0Au6zAwmJ71vqB9qWhvQ6E4KhaWnRfiYAQPWrdneUWhfbfH5wxZsP7T27UM13EN4dl,NVIDIA AI,0,12,4,0,1,0,0,0,17,1,"NVIDIA CEO Jensen Huang's keynote is a must-see for anyone who wants to stay up-to-date on the latest discoveries in AI. Tune in to #GTC23 to discover the #AI breakthroughs that are shaping our future--online on March 21, 8 a.m. PDT. You won't want to miss this. https://nvda.ws/3l6q7ZV",2023-03-16T00:00:00,['blob:https://www.facebook.com/1df4f1f2-1be8-49a1-8401-deae30419756'],https://scontent.fcai19-7.fna.fbcdn.net/v/t15.5256-10/334370171_3404805169784212_839710189971880623_n.jpg?stp=dst-jpg_p960x960&_nc_cat=107&ccb=1-7&_nc_sid=ad6a45&_nc_ohc=DNnX4feySCIAX-hhj4Q&_nc_ht=scontent.fcai19-7.fna&oh=00_AfB7--8t14rDNGhEmgzKpS-RbjvW_ivE8NS081qltKCgYg&oe=64E312FE,https://www.facebook.com/NVIDIAAI/posts/pfbid0Au6zAwmJ71vqB9qWhvQ6E4KhaWnRfiYAQPWrdneUWhfbfH5wxZsP7T27UM13EN4dl?__cft__[0]=AZXVdl357yFuokf5ON3ftgT9quAvDCuSf4vNh31uLhOMnB0-VmFa26CR3UFfWzYAy2EDocZJLA20sh3Oq84xiZmjJ0gU_SZNokDNqv0hzRHFKOffAySUhOT212lu_d_s3Ei96Q15JdnW8GNIH4RuPNvI5pKM3sOzqEOqdJuTwGew8OiJelZcF8riTIUhUXoa5oyTFnfIYR89GN9WyC8t7wx2kCF3f3PmaLyetv-6znjReKUtVWBhcCkr2EYjE6KNElY&__tn__=%2CO%2CP-R,17,0,positive,17
pfbid0gVzhorK7ANN3qe56j1ZL18e33J2Bu3FRBi3zUEqWuStVmKq7zbRax7Dr8j8jLDMtl,NVIDIA AI,0,12,2,0,1,0,0,0,15,2,How're you using data to improve retail operations?Read a step-by-step tutorial on how to speed up retail data processing pipelines with GPUs — from demand forecasting to markdown optimization: https://nvda.ws/3Tykv7z,2023-03-16T00:00:00,[],https://external.fcai19-7.fna.fbcdn.net/emg1/v/t13/15120726372646354500?url=https%3A%2F%2Fdeveloper-blogs.nvidia.com%2Fwp-content%2Fuploads%2F2023%2F03%2Frapids-spark-gcp-featured.jpg&fb_obo=1&utld=nvidia.com&stp=c0.5000x0.5000f_dst-jpg_flffffff_p500x261_q75&ccb=13-1&oh=06_AbGK3B6LDgWKKi1Ya44k1MfziP_AUFTsrBvD5ioSE4zbfg&oe=64E0A153&_nc_sid=dbad39,https://www.facebook.com/NVIDIAAI/posts/pfbid0gVzhorK7ANN3qe56j1ZL18e33J2Bu3FRBi3zUEqWuStVmKq7zbRax7Dr8j8jLDMtl?__cft__[0]=AZU1qELjBMSKhIcX-oRJv2uYGgyNqdI3FhJYuKM7iFqoWcLEb0bii6VG7SK7cdW_l7ff1jgqrcjm8NW9LivY-vogIhixxcyica_XSpaPGOxjcfRUdfodxPJpHe3ujCam_1CAdL9_6wIGDLPEGTriuTwE3LJC5fvuNcFVcRy0M6Ec0SRQ6BwmFShRmcG98UeCSsJi9wmah92FuvkZ8i-47vNP&__tn__=%2CO%2CP-R,15,0,positive,15
pfbid08z9TF2xGt6JsRCgdYBYSbiouAzUoTFtq5y2W51ztn72A7j82JjvvD3dNtPYk8VPFl,NVIDIA AI,0,11,0,0,1,0,0,0,12,3,Hear Senior Data Scientist and Kaggle Grandmaster Chris Deotte share what the most important step is in every data science project: https://nvda.ws/3TkPDHaLearn more from Chris and his KGMON colleagues by attending their panel at #GTC23.  https://nvda.ws/40737IW,2023-03-16T00:00:00,[],https://external.fcai19-7.fna.fbcdn.net/emg1/v/t13/5566949324289736806?url=https%3A%2F%2Fi.ytimg.com%2Fvi%2Fb1ghiZcSqUY%2Fmaxresdefault.jpg%3Fsqp%3D-oaymwEmCIAKENAF8quKqQMa8AEB-AH-CYAC0AWKAgwIABABGEkgZSg4MA8%3D%26rs%3DAOn4CLBK889kdPc0z2P5NUCVoGKKzK_a0A&fb_obo=1&utld=ytimg.com&stp=c0.5000x0.5000f_dst-jpg_flffffff_p500x261_q75&ccb=13-1&oh=06_AbE4YuUJzr2DLwWRmbEg4-6tIAFC9UfTcLuyjQf_KRHnpA&oe=64E03A9C&_nc_sid=dbad39,https://www.facebook.com/NVIDIAAI/posts/pfbid08z9TF2xGt6JsRCgdYBYSbiouAzUoTFtq5y2W51ztn72A7j82JjvvD3dNtPYk8VPFl?__cft__[0]=AZUSywrPPinK9XW_DYRHGaAzvQaYPsxmyfzMl34OPPssO8Xr6Qg8PkL47hD2quasiQITlXNoxAlxT41ioNj6nBNm-CyTLslQLHOwA6QIcufgFJoviNkNzgfiUtruIgJdoyjgFjI7jiOMjMn296I_hIRb7pU7ricaEe8O1xpXVniPykcprdak7HA0asy2R8gl4QdjyZkoUnkj5Fhg_1wfL-ZM&__tn__=%2CO%2CP-R,12,0,positive,12
1150158012317133,NVIDIA AI,0,7,0,0,1,0,0,0,8,0,"Join our panel of experts for an unforgettable #generativeAI watch party at #GTC23 where we will dive deeper into generative application development, inference, enterprise possibilities, and more.  https://nvda.ws/42pHVA3",2023-03-15T00:00:00,[],https://scontent.fcai19-7.fna.fbcdn.net/v/t39.30808-6/336539318_5941144455934390_3768797916047126053_n.png?stp=dst-png_p526x296&_nc_cat=106&ccb=1-7&_nc_sid=9267fe&_nc_ohc=J-qiNjBa8xsAX_OuxGq&_nc_ht=scontent.fcai19-7.fna&oh=00_AfDSnLlAHwhla6DpLx11xBk5zrmODEVQcF93Jec7nGS6Lw&oe=64E3FCE1,https://www.facebook.com/NVIDIAAI/photos/a.119492422050369/1150158012317133/?__cft__[0]=AZXg7_9QUyfKtXprW8aSdMciFRcn-3O6MyXi1PX5GwVkySJU5ODoaCHO89_dEClPa9KZg-LwQAK_74vuDqXIUqmNLdFpYpIjNPcaez68vtZJFYmY_YaQCj0xZCpFK84w_nveeJIHCVSJZF9vUiSvbywfw60WgNdSR174UVuAJSW553HWQX2QeY7Chbwc8kD70hTi0XAArIZ-kkD6YenGzhBi&__tn__=%2CO%2CP-R,8,0,positive,8
pfbid02GFazafwJBoeDUj1pov7wwG9qxV2UN4wTeQX43c3dB1KQsG87o7TyPXVU3eUfVL12l,NVIDIA AI,0,14,0,0,1,0,0,0,15,5,Technical walkthrough: The hardest data problems need time series processing. RAPIDS cuDF can make that easier. Read our easy-to-follow tutorial on how to use RAPIDS cuDF for time series analysis: https://nvda.ws/3le9N9t,2023-03-15T00:00:00,[],https://external.fcai19-7.fna.fbcdn.net/emg1/v/t13/7006305037771681914?url=https%3A%2F%2Fdeveloper-blogs.nvidia.com%2Fwp-content%2Fuploads%2F2023%2F03%2Fabstract-bar-graph.jpg&fb_obo=1&utld=nvidia.com&stp=c0.5000x0.5000f_dst-jpg_flffffff_p500x261_q75&ccb=13-1&oh=06_AbHQtSrGdajkf6kgrlrCJN2L3qrcG6QwL0nq0VME3QizZw&oe=64E06C94&_nc_sid=dbad39,https://www.facebook.com/NVIDIAAI/posts/pfbid02GFazafwJBoeDUj1pov7wwG9qxV2UN4wTeQX43c3dB1KQsG87o7TyPXVU3eUfVL12l?__cft__[0]=AZXxfMQv4ROYivJlwbaqLtVG11mU6FsULNy4iC94_cVtjZ85Xk1fQ8eMlqX11TQG2Q-S2cECw2cQbZe1O97F2vgXIMuHzc8SCLHws1TThQKIMv4EcBZfcuhoatHYxx4ySjtBdykYnTPBW1Lj9-pJN4LmE15GEkTPyk24aWPqPCF_je1dzwUBYKISYb5F0EmqBs9SN54vH3dqSidLlOl_o53M&__tn__=%2CO%2CP-R,15,0,positive,15
pfbid02MSF2srMwpzthWopLae5EXAmTggRZMc4PzFVzSCgD6ioFj4J8qXN5u3o9okwqDXDBl,NVIDIA AI,0,15,0,0,1,0,0,0,16,2,Discover why enterprises such as NIO and Yahoo! JAPAN（ヤフー）are using NVIDIA Triton to run their ensembles of ML models: https://nvda.ws/3LpNfNI,2023-03-15T00:00:00,[],https://external.fcai19-7.fna.fbcdn.net/emg1/v/t13/3720797625909783633?url=https%3A%2F%2Fcdn.pathfactory.com%2Fassets%2F10412%2Fcontents%2F488660%2Fthumbnails%2F600x%2Finference-solution-showcase-triton-model-ensembles-2654550-final.png&fb_obo=1&utld=pathfactory.com&stp=c0.5000x0.5000f_dst-jpg_flffffff_p500x261_q75&ccb=13-1&oh=06_AbEXeYoAe7KSpXRLOiAXIOUIA3AY0WZVsEtEbHcmqE7Zrg&oe=64E0119E&_nc_sid=dbad39,https://www.facebook.com/NVIDIAAI/posts/pfbid02MSF2srMwpzthWopLae5EXAmTggRZMc4PzFVzSCgD6ioFj4J8qXN5u3o9okwqDXDBl?__cft__[0]=AZW7adWHYDs8hdiWVWL4KN0gQ_s-w4NNqYjFYmBWOzHUqqV1ONQKD-RJp2ubS-80JgzOVajrT8j4L80IcuTcf5OOKvpSepWSqRkb0uPCSEVz3QjUv1GNJYSai1bUKpknSNu5wf9g5UMsiuuQC3Elq1Ti6BIr8VKo5J6tVYyat7KtmKB38aEpt5sDOWBjdpzhOl7uTMm6oUAVYFTydY_gUmCl&__tn__=%2CO%2CP-R,16,0,positive,16
1150081878991413,NVIDIA AI,0,9,0,0,1,0,0,0,10,1,"Hear from NVIDIA Academic Grant Program recipient and professor at the University of Washington, Dale Durran speak on improved accuracy and efficiency of #deeplearning weather predictions. Register for #GTC23 to join the session. https://nvda.ws/3KtUvaQ",2023-03-15T00:00:00,[],https://scontent.fcai19-7.fna.fbcdn.net/v/t39.30808-6/335166528_548543894048363_2849873423282618691_n.png?stp=dst-png_p180x540&_nc_cat=101&ccb=1-7&_nc_sid=9267fe&_nc_ohc=NQKBfkEwwIMAX-ENZly&_nc_ht=scontent.fcai19-7.fna&oh=00_AfCrZDQdDvl7RNoqg-D7LWpAp2fPnBC9Kf_fAecnx6h_wQ&oe=64E35D51,https://www.facebook.com/NVIDIAAI/photos/a.119492422050369/1150081878991413/?__cft__[0]=AZXYBuRi1MKUbtk8CcQLaGoT3KNLtxWp-BYFIqg2ilXmfsljSaeY7x0EXID-2wgaCepACFkgG2-j0dhQBP-eo2jq_PfBj_R9_c_7qHvL74WsHL3lRKTauJuhMqR3iSkK2mAq1OONrywLxyP8dFxM35aS-CVsuEbALSOGDm3esi5Cz3qnNZWzYw4YGVnuTCUbk3cVQodgo-3Fzk9qoHcB5ppP&__tn__=%2CO%2CP-R,10,0,positive,10
1149983269001274,NVIDIA AI,0,18,1,0,1,0,0,0,20,1,Want to learn how to simplify the deployment of #AI models in production? Save your spot at our #MLOps #GTC23 expert panel. https://nvda.ws/3YCefMA,2023-03-15T00:00:00,[],https://scontent.fcai19-7.fna.fbcdn.net/v/t39.30808-6/335436976_1380964002740519_8770239160733329712_n.png?stp=dst-png_p526x296&_nc_cat=110&ccb=1-7&_nc_sid=9267fe&_nc_ohc=rMzQIxyJgegAX8i3Fi5&_nc_ht=scontent.fcai19-7.fna&oh=00_AfAmpoKnIzTdg62fJgxnLM79B5uPgPrMQ5eUwOu27WoPvA&oe=64E2D03B,https://www.facebook.com/NVIDIAAI/photos/a.119492422050369/1149983269001274/?__cft__[0]=AZUQrPwM6aoKc4_uTg9ARDp3v0Lsu_JOxvHosqK61wCZi3CD7Bo5TsKtq2ZS-XpyHFf9-bxftvGh8WwlroXNnmKGHNHCvPksz2BT3K5Ltp-qhfbieRoIyCTYKigV-Rq1TyVIfpJcbDC8xs_hk32wXgjLxPz0OHf58ZfDrjYOhiP1ZxPfQgE7rEDKT_VkPY0uJvc_ODvdqOGvLegOBdYdLCjh&__tn__=%2CO%2CP-R,20,0,positive,20
1149714642361470,NVIDIA AI,0,11,0,0,1,0,0,0,12,3,"Deutsche Bank details their #LLM journey and model training approach for modern #banking using Bert, FinFormer, GPT and T5, and strategy for model adaptation via fine-tuning and prompt learning using NeMo Megatron.Learn more in their #GTC23 session on March 23 at 9 AM PT: https://nvda.ws/3mRfNFs",2023-03-15T00:00:00,[],https://scontent.fcai19-7.fna.fbcdn.net/v/t39.30808-6/335495030_1893010567721195_9111108974224411249_n.png?stp=dst-png_p526x296&_nc_cat=102&ccb=1-7&_nc_sid=9267fe&_nc_ohc=_0WEIWkSXIoAX_0zlpM&_nc_ht=scontent.fcai19-7.fna&oh=00_AfBIyFMgBoYWHCo4uhI6HuTxbmnYma_hGCLzJXouf_6Tpw&oe=64E49ABF,https://www.facebook.com/NVIDIAAI/photos/a.119492422050369/1149714642361470/?__cft__[0]=AZWLTCc3phA_awR-WKzEOwTAQagN9zM4_zo6Msrpi7sprVfVkkmY-KkuNS5ejdReaBvcZjG2lxpcdT0OnGFaKMLhpBy1NtnAUGlhnnMJ-SBrChJ2_QDnRv-nbPiMYn5_FOjKFcBW1iP7scu9zptZXeTLikao13DzYU-0DKe2G3AOvZzdoXdjgmlR4_AefRtAnvQ4PgHUKc41h68L4bvz7Wn8&__tn__=%2CO%2CP-R,12,0,positive,12
pfbid0vSUgiCcftA3vybhmvHVe3caUpYx7iJ3Z2QPj3BctSUKnPK95gXEg78F5mJfjCxehl,NVIDIA AI,0,10,0,0,1,0,0,0,11,1,"Hear what our Senior Deep Learning Data Scientist and Kaggle Grandmaster Bo Liu likes most about Kaggle: https://nvda.ws/3Lkeidf  To learn more, join Bo and other members of the KGMON team at their #GTC23 panel next week.  https://nvda.ws/3Lqx172",2023-03-15T00:00:00,[],https://external.fcai19-7.fna.fbcdn.net/emg1/v/t13/4997621223476764659?url=https%3A%2F%2Fi.ytimg.com%2Fvi%2F6LpFd4PzKbI%2Fmaxresdefault.jpg%3Fsqp%3D-oaymwEmCIAKENAF8quKqQMa8AEB-AH-CYAC0AWKAgwIABABGEQgZSgqMA8%3D%26rs%3DAOn4CLDyZXOLr7nudf91YLovYZEbz0jhRg&fb_obo=1&utld=ytimg.com&stp=c0.5000x0.5000f_dst-jpg_flffffff_p500x261_q75&ccb=13-1&oh=06_AbEwHSkzGYUVtn3JmYPPm_bscUH2EV9MVZH4tHV76i8MWg&oe=64E034F8&_nc_sid=dbad39,https://www.facebook.com/NVIDIAAI/posts/pfbid0vSUgiCcftA3vybhmvHVe3caUpYx7iJ3Z2QPj3BctSUKnPK95gXEg78F5mJfjCxehl?__cft__[0]=AZX2UHXkUVjOBvhU4152WPN3sbORzugdIPHTPmAEB7ickprwGIasOnR6ERqyl04hRrVpVdDJB4P7EcpohxOQS_ChQ-ysuAQMn_-7ApwQGegkAjtBQpK6C-UY-hTakkuvmEKwDK_SLNUUkutvZeQaPJAEUq7KgLHFmGyTpeWf27mZcUViW746-vA5zcxReBpWIYzbjq7Hiz2RfUvbv-ocJSvj&__tn__=%2CO%2CP-R,11,0,positive,11
1149681965698071,NVIDIA AI,0,14,0,0,1,0,0,0,15,0,"TempoQuest and Microsoft are using NVIDIA #GPUs for fast, high-resolution #renewableenergy production forecasting and natural disaster planning.Learn more at #GTC23 on March 23 at 8:00 a.m. PT: https://nvda.ws/3IJcAPE",2023-03-14T00:00:00,[],https://scontent.fcai19-7.fna.fbcdn.net/v/t39.30808-6/333231609_195240106533006_3730226948610222265_n.png?stp=dst-png_p526x296&_nc_cat=110&ccb=1-7&_nc_sid=9267fe&_nc_ohc=1PQ0Ki8bCMwAX9O0L24&_nc_ht=scontent.fcai19-7.fna&oh=00_AfAyE6tYLWjdHhsxgpHPZkGgmE8ERBgKpmbo0YOHd6NvUA&oe=64E2C69C,https://www.facebook.com/NVIDIAAI/photos/a.119492422050369/1149681965698071/?__cft__[0]=AZULPAeUEK_c9JG5LaS4JTNjtX8MRJ6oK0pKz7kKOXu8JiRr1ilrmvMZGpS_v6MNklMRWvWGzNn3ycmtCN2U2pY_o1svbae1utN9Z6RB91Jvrsm3iH1vyFnIA4WP08TivLt5WEBpk6bTYbKwu9Wq2qjNRViuMEt3_NoemznuHuz1A1OEEmr7uQHZQqrVlHimu26P0zq8GpkfAvHrDskGPqjP&__tn__=%2CO%2CP-R,15,0,positive,15
1149663819033219,NVIDIA AI,0,10,0,0,1,0,0,0,11,0,"Explore the latest tools, optimizations, and best practices for deep learning training and inference: https://nvda.ws/3LnWH3T",2023-03-14T00:00:00,[],https://scontent.fcai19-7.fna.fbcdn.net/v/t39.30808-6/335510607_1623286298098868_8166715466223992923_n.png?stp=dst-png_p526x296&_nc_cat=107&ccb=1-7&_nc_sid=9267fe&_nc_ohc=mKRGaBQ04iMAX_s7KS4&_nc_ht=scontent.fcai19-7.fna&oh=00_AfBQ9Vqh5HmEWxefRhspOhMk1m097dNEa30B7DnXLML7qA&oe=64E3FD27,https://www.facebook.com/NVIDIAAI/photos/a.119492422050369/1149663819033219/?__cft__[0]=AZUdenJAQg9sMiM_BQbyHghmCXTpXlFbAbKtm-4cvvNCuBTHRnaQQt2NRKunPbmTjVdpYNdoqlFfpuDWv5IoAKhd2HUgmtcCaQRTZcThzKws9ct2cdMrRI7CVIhDHIAbYPaQt0GzM4_4qAOv77ayJMI3MhW7wRZ-QfHdwonBgxjHDdPulqiqFaXaNT9a9wGeZykLuHzM-yrZzOqB1kZKFeFg&__tn__=%2CO%2CP-R,11,0,positive,11
pfbid0woeyF8oGxFKfyG9bdvnowh9sNtReFPsok529S6vi19RC4jZNtKZhSf1WsdPfPQ9zl,NVIDIA AI,0,15,0,0,1,0,0,0,16,4,"Production-level AI workloads require an ensemble of ML models. Use NVIDIA’s Triton to optimize an end-to-end inference pipeline with multiple models, different framework backends, and CPU/GPUs. Check out how here: https://nvda.ws/3Tc9vwl",2023-03-14T00:00:00,[],https://external.fcai19-7.fna.fbcdn.net/emg1/v/t13/3670975296148700772?url=https%3A%2F%2Fdeveloper-blogs.nvidia.com%2Fwp-content%2Fuploads%2F2023%2F02%2Finference-visual-triton-model-ensembles.jpg&fb_obo=1&utld=nvidia.com&stp=c0.5000x0.5000f_dst-jpg_flffffff_p500x261_q75&ccb=13-1&oh=06_AbGPXZ3NELfaJSeqDHxP-wKe0eV5qSN6u0OOCmYp8R8H_g&oe=64E0A1EB&_nc_sid=dbad39,https://www.facebook.com/NVIDIAAI/posts/pfbid0woeyF8oGxFKfyG9bdvnowh9sNtReFPsok529S6vi19RC4jZNtKZhSf1WsdPfPQ9zl?__cft__[0]=AZWeWRZp1GK2_34rSqNgoJRJTGmWSGhBIR4nFl8QQ7pnBx4xjIo6remkLp6chEXAfwupf3eFy7iERb0ik8H4t968Z1PYMP3fwsfMzryt347Tq9PYGsrqkdnrupVtASyCWggfD3iQF7pMTzzdgBy8TaQ6eaMfJlc96VIdBVjFcDDv6rhNOgMhlRUEoxYgAUT4lThdo7I6lyoDZYpd3azi0vEV&__tn__=%2CO%2CP-R,16,0,positive,16
pfbid0umP56t4TNKgHmGXqgbYMVczBbupANdSAktexi6xMvzmtCejNhCeBrCXGyvmHKs7Jl,NVIDIA AI,0,6,0,0,0,0,0,0,6,0,Do you ever wish pandas could run faster on your workloads? Start your data analytics workload strong using RAPIDS cuDF for #EDA tasks. Get started with a simple tutorial: https://nvda.ws/3LminO4,2023-03-14T00:00:00,[],https://external.fcai19-7.fna.fbcdn.net/emg1/v/t13/5736967800424077043?url=https%3A%2F%2Fdeveloper-blogs.nvidia.com%2Fwp-content%2Fuploads%2F2023%2F03%2Fdata-analysis-accelerated-featured.png&fb_obo=1&utld=nvidia.com&stp=c0.5000x0.5000f_dst-jpg_flffffff_p500x261_q75&ccb=13-1&oh=06_AbFxUUsNKo2oUexsM08EOmIcAeHUEhr5D45GODfumxfmNA&oe=64E053D1&_nc_sid=dbad39,https://www.facebook.com/NVIDIAAI/posts/pfbid0umP56t4TNKgHmGXqgbYMVczBbupANdSAktexi6xMvzmtCejNhCeBrCXGyvmHKs7Jl?__cft__[0]=AZU12i2i_L7GGj0dqnA6ngvRVInjjtcUbU96DLRmzwtISA6QypELnTO5moO1zpwh1UAFuSc8STYVYjmWtgJ6C7w10V2WOKP5I1I2jUQBHV7EzV6_NtKhC7cuADqF6eGPJFNHX72qFUi4qETYvICMiOtARU2pW_lOm-RN7VaHY1E8Acp3soqgVCPf_ikRdJ0d0jYGZ15ZwKC-kiMwXhHY0rg9&__tn__=%2CO%2CP-R,6,0,positive,6
1149230149076586,NVIDIA AI,0,17,0,0,1,0,0,0,18,2,Curious about what NVIDIA is up to in research and #AI?Tune in to Yannic Kilcher's interview with Bryan Catanzaro for a preview of NVIDIA's latest groundbreaking work. https://nvda.ws/3TbWoem Learn more at Bryan's upcoming #GTC23 session on generative AI:  https://nvda.ws/3mQQUKd,2023-03-14T00:00:00,[],https://scontent.fcai19-7.fna.fbcdn.net/v/t39.30808-6/335307534_747414173666765_2376735773297280716_n.png?stp=dst-png_p526x296&_nc_cat=101&ccb=1-7&_nc_sid=9267fe&_nc_ohc=7xq4Cxwfuv0AX9Mb-Zo&_nc_ht=scontent.fcai19-7.fna&oh=00_AfB_-xJK9u2NuCLXhVTUh0QVoVwrK72HNk6KZWf31xb1jg&oe=64E32F95,https://www.facebook.com/NVIDIAAI/photos/a.119492422050369/1149230149076586/?__cft__[0]=AZUC7jxj8Dvs5ITEP1VWSXiVSM743t9OUpkwjZfAgTv7tvav60GS4b8nqVsWe9IRn3ftqfNntQRqnw3IZ0NkojxI_-HpvD8FP5hvM7aQVzOhjJczf9JWO_ZlC3AT3vxNK0cESeG39XI0Ne7rU5fB4qQp8sZK0vdW2luFXVV9pT0q8_XFvUQyPIrzz7qBlXlm4JWBEzqV63DxAV2NTZhNf3lu&__tn__=%2CO%2CP-R,18,0,positive,18
pfbid02SC7AQZBZ3ryQfEeAcAubFwXq3N5CZ1gMK2gUi3ayc2D8uAGNwZMcHyMGQ64gZUS4l,NVIDIA AI,0,7,0,0,1,0,0,0,8,1,Hear NVIDIA Senior Deep Learning Data Scientist and Kaggle Grandmaster Théo Viel's advice on performing well in Kaggle competitions: https://nvda.ws/420GaJ1 Want to learn more? Be sure to join the KGMON team's panel next week at #GTC23.,2023-03-13T00:00:00,[],https://external.fcai19-7.fna.fbcdn.net/emg1/v/t13/15632690342927096486?url=https%3A%2F%2Fi.ytimg.com%2Fvi%2FL323NxwWW1M%2Fmaxresdefault.jpg%3Fsqp%3D-oaymwEmCIAKENAF8quKqQMa8AEB-AH-CYAC0AWKAgwIABABGEMgZSgoMA8%3D%26rs%3DAOn4CLA-xdT-7tqHPou3gQ7SR8gpNjcqOg&fb_obo=1&utld=ytimg.com&stp=c0.5000x0.5000f_dst-jpg_flffffff_p500x261_q75&ccb=13-1&oh=06_AbFNJ5R_R2f_66IGbQIBqud7zvoSJ5-QBRCi8y8fVRIepw&oe=64E06F44&_nc_sid=dbad39,https://www.facebook.com/NVIDIAAI/posts/pfbid02SC7AQZBZ3ryQfEeAcAubFwXq3N5CZ1gMK2gUi3ayc2D8uAGNwZMcHyMGQ64gZUS4l?__cft__[0]=AZUYL3-h5mNlKvpR0pyq-u2n1K-BOoIRA_fBiQg64GrvSUXBMF4Y6pQYSpdPKIqWrrBGBS7fWbOJblOcnWbmc0KPMNgG7qAwA4sxddou5ihEGm9eS9DD_m3mC3xIvc_lrlts4bH1_Fa3Vu3crIhMU-OHWGCvM2aQg7tx-mVm2UtWJqHcjYremIX0DevOAxPmduwV9ixblDJe8eBidtgbWIGT&__tn__=%2CO%2CP-R,8,0,positive,8
pfbid026Cd8c4oSPZUoMAoZ3wbSPKQbhTfWgPFtKKwkdK72dRzsktXkhXwArgikKqD3iARFl,NVIDIA AI,1,9,2,0,1,0,0,0,12,1,"Discover how to develop your next #genAI solution, and navigate a rapidly changing ecosystem. Hear from these innovative #startups Wombo.ai, Irreverent Labs , and @WriterAI that are making waves in the space. Free session at #GTC23: https://nvda.ws/3HQHjem#NVIDIAInception #GenerativeAI #AI #developer",2023-03-13T00:00:00,[],https://external.fcai19-7.fna.fbcdn.net/emg1/v/t13/6796093510497592294?url=https%3A%2F%2Fprod2-sprcdn-assets.sprinklr.com%2F50276%2F3a500544-96db-470f-8aa1-ba8933a36659-1059820079%2F2623389-gtc23-spring-social-in.png&fb_obo=1&utld=sprinklr.com&stp=c0.5000x0.5000f_dst-jpg_flffffff_p500x261_q75&ccb=13-1&oh=06_AbFy8f1spvB9c-Yi55TyWLTvXsVK7b2p9OfavTCfNt9e3w&oe=64E071EB&_nc_sid=dbad39,https://www.facebook.com/NVIDIAAI/posts/pfbid026Cd8c4oSPZUoMAoZ3wbSPKQbhTfWgPFtKKwkdK72dRzsktXkhXwArgikKqD3iARFl?__cft__[0]=AZWGv6lCgxuvVDYPnHrqNOqvsUHuNXj4nVP6k5MDPfchkXg0Sfp18KH-xLTUAH2MalkyWqXdAVvERyv0MnjAJu92-xzDw7rywR2fyIXRs_T7mF4yRt0qyKdRH6cuD0nm81REIYMHQketp_FHcDhiL1AZZVCahgfg6KaBUnI3IaznEAoDK7eJb9N6xiwtyIjO32rCjZEbALvigQ0JUJPVNumr&__tn__=%2CO%2CP-R,13,0,positive,13
pfbid0LNkwpyLzb5RqbdzqccT1iEns1SaGDug5fYhnXB8N3UEMeUitJwsnKDKV8j6kNbxGl,NVIDIA AI,0,76,0,0,0,0,0,0,76,3,Today Microsoft announced the preview of NVIDIA H100 in the cloud. The ND H100 v5 instance series will help power a new era of generative AI. Our long-term product collaboration with Microsoft Azure brings leading #AI innovations to enterprises around the world. Learn more: https://nvda.ws/3yvWB2N,2023-03-13T00:00:00,[],https://scontent.fcai19-7.fna.fbcdn.net/v/t39.30808-6/332279586_916927932957892_2000467381437982263_n.jpg?stp=dst-jpg_p526x296&_nc_cat=100&ccb=1-7&_nc_sid=9267fe&_nc_ohc=qrtb64qbTRsAX9M_mp9&_nc_ht=scontent.fcai19-7.fna&oh=00_AfDsfJuMeuYY7ng2BfUjhOjQmO7mCnGAx38fXlSvJiH9dQ&oe=64E36EC0,https://www.facebook.com/NVIDIAAI/posts/pfbid0LNkwpyLzb5RqbdzqccT1iEns1SaGDug5fYhnXB8N3UEMeUitJwsnKDKV8j6kNbxGl?__cft__[0]=AZVJiAuTn8HPL5P98hW_iEpcpLeuF6Yz3RYxynluWO_KLqhTaFA9T2nB1q5xR0S7e_x17ycp5zrlyP5UmnV0RZjZc7BMrAF0kom_NxmRYl3B6asdDvqulrBvyHKsxZQ7E6hLbubtt4AyieMpr1RtrJ7tK1UYDj9LnhsntMy2jha3dGEgfd-C5OccxXaGlhSwnzpsPxdTJ_XNYzkhMJcKstphH9wkAsBB64gy-Xqt4Q_WhiiS24sGSdzuaTaLtOrt4pJSuwC0G88OQVRlI1S6iyey&__tn__=%2CO%2CP-R,76,0,positive,76
1149007299098871,NVIDIA AI,0,12,0,0,1,0,0,0,13,3,"At #GTC23, hear how ASOS, an online fashion and cosmetic retailer, is using NVIDIA Triton Inference Server to develop recommendations and personalized search systems at scale. #ecommerce #retail https://nvda.ws/3L8q5er",2023-03-13T00:00:00,[],https://scontent.fcai19-7.fna.fbcdn.net/v/t39.30808-6/336130214_6010604682309001_6837561781520452082_n.png?stp=dst-png_p526x296&_nc_cat=101&ccb=1-7&_nc_sid=9267fe&_nc_ohc=Im4zqRcA9k0AX-IxOeQ&_nc_ht=scontent.fcai19-7.fna&oh=00_AfDlf6vfCtq1oZN6-kD5I4_LUCtc4yxIhyOPxWlSOaST0Q&oe=64E3B8FF,https://www.facebook.com/NVIDIAAI/photos/a.119492422050369/1149007299098871/?__cft__[0]=AZVa-owE6lQsCW-3UItS1XKj8Xjy5iP2HVXTLbLMPKw825CTKAEVQq4ir7_9iDIHRpEh9a8g0o4YhIE_FFTLpDjH2pC5ceKaOw-U3bVCmBr0N580oaEpZBIqLlFoYgdTRnEovdyvJM_pV1FamWrVrhyKZpAryBZKG8cLY9CHbjISfvpv6L7eq8fbtgzCHzzDVmBg4rlbWEUYZ2VbLgpu_SfC&__tn__=%2CO%2CP-R,13,0,positive,13
1148837035782564,NVIDIA AI,0,19,0,0,0,0,0,0,19,1,"Join this #GTC23 session to see how PepsiCo is using #digitaltwins and intelligent video analytics to gain insights that help improve order processing time, order fulfillment rate, and operator efficiencies. https://nvda.ws/41VKJ7u",2023-03-13T00:00:00,[],https://scontent.fcai19-7.fna.fbcdn.net/v/t39.30808-6/335600324_3410334989204735_1465073670235346046_n.png?stp=dst-png_p526x296&_nc_cat=105&ccb=1-7&_nc_sid=9267fe&_nc_ohc=B44RyCUCQgIAX96AGIu&_nc_ht=scontent.fcai19-7.fna&oh=00_AfALODqNE8HzMsxwhX6Ujk-DWtPonwNUiwROn57KVtW9nw&oe=64E3C56F,https://www.facebook.com/NVIDIAAI/photos/a.119492422050369/1148837035782564/?__cft__[0]=AZVtLmiFD1Xkb_7Tm5swmDcoYe8UWwPCFTrcqTxGcBXsuFCkAa4JSNpcoMFrrR8P0sm3Kx5sqqGaZdN4nVEGD2HlXoQmiY0q9q2gvC3Zv1o5BMzlHpVuN-lxA1KvBGi8ygaeHJrUoOJ5yt1PcJKCd4DAiaHbGT1agfCjrScnjPE89luAWxj3JhCJVo17HBhq6Xt1UydI53WerOjv_T0gt4k9&__tn__=%2CO%2CP-R,19,0,positive,19
pfbid0p4Fo1A4giAKS5tx4QTVkgPCT9yqqyXg2KFijgqCWdttNYyqQVmDHtHZJUFfR3J11l,NVIDIA AI,0,11,1,0,1,0,0,0,13,0,"Motion capture. Face scanning. Synthetic data generation. Tune in to hear from #startups Elevate 3D, Lumirithmic, Move.ai, & Infinity AI who are using #NVIDIAOmniverse to accelerate their AI solution and create whole new opportunities. Register now for #GTC23: https://nvda.ws/3JyPIV7 #NVIDIAInception #metaverse",2023-03-13T00:00:00,[],https://external.fcai19-7.fna.fbcdn.net/emg1/v/t13/6818747454047967714?url=https%3A%2F%2Fprod2-sprcdn-assets.sprinklr.com%2F50276%2F74dd2ee7-1573-4b32-81d3-b60918c612ed-679653124%2Fgtc23-spring-social-inception-.png&fb_obo=1&utld=sprinklr.com&stp=c0.5000x0.5000f_dst-jpg_flffffff_p500x261_q75&ccb=13-1&oh=06_AbE6wVjj-BxpM2A2JA6vXBnbLwxNG-O9M54lIr_fJMDjtg&oe=64E02B92&_nc_sid=dbad39,https://www.facebook.com/NVIDIAAI/posts/pfbid0p4Fo1A4giAKS5tx4QTVkgPCT9yqqyXg2KFijgqCWdttNYyqQVmDHtHZJUFfR3J11l?__cft__[0]=AZVJ3Iz2Xr92mBKMJ-PoC9s0g1eAiUevH4AvQw7BNpHNGKGSOWxBG0_s56KDNTW351tE8R2E9yMg6ntAKO_slJg1aQV7Hr3CCr1w41mPHJWZhzBbwrxOwjUiKaTs2c92GjBbgpxwXvuJQX3SvLkZn0zIV4hLqOKFc_Z0818yxhB1I5qs4CZJq-HbCP_WHlFSdTVvF8l9YIwEYtUGKJG6oYAo&__tn__=%2CO%2CP-R,13,0,positive,13
pfbid0o8638diUEpw8z9XWtVxwwGocf4BH9FC3Bq5PMTt24tnDHhiqKpKF4JgMER5wUM43l,NVIDIA AI,0,8,0,0,0,0,0,0,8,0,"How are AI startups accelerating their solution to market and reducing costs? Learn how from these #NVIDIAInception members Nota, AgtechOS, and NVIDIA at #GTC23. Add it to your schedule now: https://nvda.ws/3YltY33",2023-03-12T00:00:00,[],https://external.fcai19-7.fna.fbcdn.net/emg1/v/t13/15732445634047904357?url=https%3A%2F%2Fprod2-sprcdn-assets.sprinklr.com%2F50276%2F076af7ea-bb3e-43d6-9a87-5ace606f26c1-1683774998%2F2623389-gtc23-spring-social-in.png&fb_obo=1&utld=sprinklr.com&stp=c0.5000x0.5000f_dst-jpg_flffffff_p500x261_q75&ccb=13-1&oh=06_AbHDXGrb1rjDCKPf3bo0xnRo8rk_PWQM1C82jCQF-pV2TA&oe=64E04A60&_nc_sid=dbad39,https://www.facebook.com/NVIDIAAI/posts/pfbid0o8638diUEpw8z9XWtVxwwGocf4BH9FC3Bq5PMTt24tnDHhiqKpKF4JgMER5wUM43l?__cft__[0]=AZXQbi1dMePZ4u-BMxTIng9vfuvV9YerKRj2UW6BIUJP2Cb-B8w9lnuXdoGHWqFG7AefFplEblYl0Tuit0KMCG9fxJ8xebPnmc4l_KbVa0vv5EqSuwS2I4pWmEzKY-J5hO1D4N4M9mE1UDygz82aYVGTNdYCcSNIQkrCALoD9g_77JnIlNK3rGvKldXYgbV9NrXMBkf3pEcqtkc83RxK9YpJ&__tn__=%2CO%2CP-R,8,0,positive,8
pfbid0iBC9wTfdFcrfQFCCPymKpMGYDvRtcg6sFV7mMUwA3aKMr4eZhFUquJt61U6KDHWMl,NVIDIA AI,0,27,0,0,0,0,0,0,27,2,"Learn how to use Redis as high-performance data storage for Triton and Merlin inference pipelines. Each use case provides low latency solutions even as data scales, especially for computationally complex applications. https://nvda.ws/3kUCGXX #NVIDIAInception #AI #Inference #startup",2023-03-12T00:00:00,[],https://external.fcai19-7.fna.fbcdn.net/emg1/v/t13/1463721001923908289?url=https%3A%2F%2Fdeveloper-blogs.nvidia.com%2Fwp-content%2Fuploads%2F2023%2F03%2Fmerlin-redis-hps-featured.png&fb_obo=1&utld=nvidia.com&stp=c0.5000x0.5000f_dst-jpg_flffffff_p500x261_q75&ccb=13-1&oh=06_AbEnYetg0FMqp-4N75bIypzs6spkKC1VUgP6qUJopUgNPg&oe=64E06F53&_nc_sid=dbad39,https://www.facebook.com/NVIDIAAI/posts/pfbid0iBC9wTfdFcrfQFCCPymKpMGYDvRtcg6sFV7mMUwA3aKMr4eZhFUquJt61U6KDHWMl?__cft__[0]=AZX77w4c8YyF6zL_U9LbTru6Y5LJ-xLNcSG-GraRBkjXuuqCSsOwU-wvlLIJ6wrieQqHCmNqMX_A2At_x5ZDfh8UHx--1E9Q_7-H5mZiGh-MoX6sUXwI2ty67hW7xjr6z4Fty_-uCCpVUA0eRldoGDnZ_iROAWePmw3AE7MUPuD06I0dPD-6dDJRNFkrfxTeaAaWaNFPiGmmCdfS4FfrlvPR&__tn__=%2CO%2CP-R,27,0,positive,27
1147770909222510,NVIDIA AI,0,16,0,0,1,0,0,0,17,1,Discover how Roblox integrates Triton inference service with Kubeflow and Kserve to simplify deployment on both CPU and GPUs. Don't miss out on learning about the latest computer vision models and game recommendation cases. #MachineLearning #AI #GTC23  https://nvda.ws/3J24Nh8,2023-03-11T00:00:00,[],https://scontent.fcai19-7.fna.fbcdn.net/v/t39.30808-6/333623229_173087392170345_3856806064142023574_n.png?stp=dst-png_p180x540&_nc_cat=108&ccb=1-7&_nc_sid=9267fe&_nc_ohc=AmsulRKmWxQAX-0dp52&_nc_ht=scontent.fcai19-7.fna&oh=00_AfCOxWVkF78Y26eH_WNH0d-wh2gq9qpokrYwr247eggLlg&oe=64E40236,https://www.facebook.com/NVIDIAAI/photos/a.119492422050369/1147770909222510/?__cft__[0]=AZX6d8iwmBPA6NE8ewUk0r7w47O9scDlYy5XuciiyY-Qv83csL_93lcV4HOxhN0u1AxO2fltFxZVeKf8CiV4GVXElKwrnGM5NR7zVjuRs4CumPF4XClyQIn5csu49Ly6UlXMhxyB60MG-scXtQe3UYG5I2gUzhIT9al-LPAJpwkf5YDtKzMGx9qXsJUATzCMOD2eWCXq18Aj3Mal5cdNULyu&__tn__=%2CO%2CP-R,17,0,positive,17
pfbid02DhPW7em8PiGUHTiULNmvQ8LBUCNRV27x9RBA4ypxdPJv5gPg4ny9xAYzwxY99E5ql,NVIDIA AI,0,15,0,0,1,0,0,0,16,0,"Improve your #datascience skills with the NVIDIA Deep Learning Institute (DLI) training labs and workshops at #GTC23, hosted by our data science experts: https://nvda.ws/3yozXsR",2023-03-10T00:00:00,[],https://external.fcai19-7.fna.fbcdn.net/emg1/v/t13/4498139092360313925?url=https%3A%2F%2Fprod2-sprcdn-assets.sprinklr.com%2F50276%2F48fc0e52-5426-49bf-8a4f-b05a9c34a822-744390594%2Fgtc23-spring-drive-reg-email-t.jpg&fb_obo=1&utld=sprinklr.com&stp=c0.5000x0.5000f_dst-jpg_flffffff_p500x261_q75&ccb=13-1&oh=06_AbGJjL3_bCapxFgPluVDd7KQLZ0UTeeccP0KtpZbtteh5A&oe=64E0A942&_nc_sid=dbad39,https://www.facebook.com/NVIDIAAI/posts/pfbid02DhPW7em8PiGUHTiULNmvQ8LBUCNRV27x9RBA4ypxdPJv5gPg4ny9xAYzwxY99E5ql?__cft__[0]=AZWg_br1ThfpNEN0DScZaM59Ix6kZdxUjS-ZO-e6BwVKL_p3MgoIhexoWk2DycI2F159MpkoqjVLrpHDsLAMMH4Uac2_-0MLcC8Ynde80nLuFtDG8LC1RosTHsgQV9oDwOuJ_-Y_duAPMqYJ1mG33ttm6dKV80UNZBwcdU_jMFrsycxZRV9YLSbAX3V4TUbM9SolyrzNdc8IRgxfpFi9Jmrg&__tn__=%2CO%2CP-R,16,0,positive,16
pfbid0vT2MdDPYXKhvcbu73G4Aw1eLDgeyNxd8uG2MPPr62GyC8APnKG8eU897gKXtcnZxl,NVIDIA AI,0,9,0,0,1,0,0,0,10,1,"Take advantage of a Deep Learning Institute workshop at a special #GTC23 price of $149. Choose from a variety of workshops covering #AI, accelerated computing and data science taught by NVIDIA experts. Register now: https://nvda.ws/3kQ8rB2",2023-03-10T00:00:00,[],https://external.fcai19-7.fna.fbcdn.net/emg1/v/t13/6057008356596371427?url=https%3A%2F%2Fprod2-sprcdn-assets.sprinklr.com%2F50276%2Fb0c3f12a-8d35-4123-8fd5-7e910ba4015e-644219421%2Fgtc23-spring-dlil-x4-drive-reg.png&fb_obo=1&utld=sprinklr.com&stp=c0.5000x0.5000f_dst-jpg_flffffff_p500x261_q75&ccb=13-1&oh=06_AbEWufLKfGffjqGDIEdl_Td-AMiVhqngm6-cmcoKhsujQA&oe=64E015AF&_nc_sid=dbad39,https://www.facebook.com/NVIDIAAI/posts/pfbid0vT2MdDPYXKhvcbu73G4Aw1eLDgeyNxd8uG2MPPr62GyC8APnKG8eU897gKXtcnZxl?__cft__[0]=AZUmUXFIdLN5bSrQ8uUO3LXPoiJH5sYwVZ9kxrbh7mRzm_UPrE942HolkdprUOkIsi9SljdzvwSXT-kC9whpcx4h3YEiUY1mqmYGVBlf8bRM_TTxwznfzsenoMCCJ1gMJv8FtHhPMi_hNDWCe12MGALsW0aqOCHD8rYGrjo-_yIW1jIDoTj1Zu17fdNo7T9Qa68l9DYDVkBsYEtXn3avZeDl&__tn__=%2CO%2CP-R,10,0,positive,10
1147328052600129,NVIDIA AI,0,5,0,0,1,0,0,0,6,0,"Join us at #GTC23 to discover how Intuitive continues to explore the limits of where data and #AI can take the art and science of #surgery. With better patient outcomes as the target, what tools can be built today to make healthcare smarter tomorrow? https://nvda.ws/3mlhomU",2023-03-10T00:00:00,[],https://scontent.fcai19-7.fna.fbcdn.net/v/t39.30808-6/335303930_6512538782107484_3856446710192343329_n.png?_nc_cat=110&ccb=1-7&_nc_sid=9267fe&_nc_ohc=3emzBWyxZ8gAX_w9Vyt&_nc_ht=scontent.fcai19-7.fna&oh=00_AfBBFwU8_HPEaF4RGpyq7ncE4J8OUGHA7JAJtu7F7TwGpQ&oe=64E38DBE,https://www.facebook.com/NVIDIAAI/photos/a.119492422050369/1147328052600129/?__cft__[0]=AZWhpyVsKLJ7v62jANYh7a-OoBQ3uu6jf7CQ8NDStOHwcU5XcDoWrdlMocBRwQNr1kLtilcPxZZR4bQ3hQ45ERc32Wx-SdN9q8sKGcFjO2FejaKIqEho4eCkZiiPbaqCg9LgwA1bvrOJAKhK0pcIy5MHXfeXf6U7VfPEqDeIsImy9JWFsBtGieCUFTmbzWyWWfsfd7ACMoVNis9PMY-1nm6d&__tn__=%2CO%2CP-R,6,0,positive,6
1147311275935140,NVIDIA AI,0,6,0,0,1,0,0,0,7,1,"Saudi Aramco, FortyGuard, and government officials in the Kingdom of Saudi Arabia, Oman, and United Arab Emirates are adopting #AI in #energy for sustainability, efficiency, and security. Join the panel at #GTC23 on March 23 at 2:00 p.m. KSA to learn more: https://nvda.ws/3YbjaE3",2023-03-10T00:00:00,[],https://scontent.fcai19-7.fna.fbcdn.net/v/t39.30808-6/333374647_969468470907825_601739705935813427_n.png?stp=dst-png_p180x540&_nc_cat=104&ccb=1-7&_nc_sid=9267fe&_nc_ohc=P4uw-f9evEcAX9t-11S&_nc_ht=scontent.fcai19-7.fna&oh=00_AfDzDZKJ8MvtHBN1ADLJex9HtOM2LMYLBD1GLGSnfZAJQg&oe=64E4A06A,https://www.facebook.com/NVIDIAAI/photos/a.119492422050369/1147311275935140/?__cft__[0]=AZXUW_S4jKMt6ymtXqHsTaEE8tNOZ4qyH0QqmJdORzWPD1hBbmvmSOtzPFR1xh6GWZtypWJ6ebsv4zr4j3oJoeZlmUhYrM-YAsZWrUvku5z8hkFmdf0aAg1s507Tf7_M9SM_h4Wc27LtODJkQ-MsRpvO-sSTvLGJI_8fKKmCvAemxE8LPVuSqKaa9uuHnK6897vCc46oipi6P5q8FXA8cb-8&__tn__=%2CO%2CP-R,7,0,positive,7
pfbid0TXyXFWr8FV5DemJCTsJsLykQvJwi4LbETLDQZrCQ2UCBrm1rRJwY2LPfNF2zjTmtl,NVIDIA AI,0,11,0,0,1,0,0,0,12,1,"Chris Deotte, Kaggle Grandmaster and Senior Data Scientist at NVIDIA joined What's AI to discuss all things Kaggle and data science - check it out and learn how you can win an RTX 4080 by attending #GTC23: https://nvda.ws/3T2AASw",2023-03-10T00:00:00,[],https://external.fcai19-7.fna.fbcdn.net/emg1/v/t13/15049573836095718528?url=https%3A%2F%2Fi.ytimg.com%2Fvi%2FNjGnnG3evmE%2Fmaxresdefault.jpg&fb_obo=1&utld=ytimg.com&stp=c0.5000x0.5000f_dst-jpg_flffffff_p500x261_q75&ccb=13-1&oh=06_AbEjvIiS1pmrcAKAxQ8YGYyyLP01fiYsaSGhtkL5ry7RNQ&oe=64E08AE5&_nc_sid=dbad39,https://www.facebook.com/NVIDIAAI/posts/pfbid0TXyXFWr8FV5DemJCTsJsLykQvJwi4LbETLDQZrCQ2UCBrm1rRJwY2LPfNF2zjTmtl?__cft__[0]=AZUB0fLZJdhc0JFFutRSPQGM0SNf9F1kVQBlNSUDl6iGpENfYN66aPVITQAcckfxKhyI22URRr30HsjhmaEiRNCsGMnr2IbWH9_2AQXWiRJTqbPztfwwqgNrKc-a16Nz4hHwIREH2zm4fK-2jDEV6PtD4273IVt3PvG00fH6zH1aOYtDCtuM2uWfAWRgjooala-kP1d9vf5zRkF3MRCiFS4a&__tn__=%2CO%2CP-R,12,0,positive,12
1147279782604956,NVIDIA AI,0,16,0,0,1,0,0,0,17,1,"Join Intuit's SVP and Chief Data Officer and NVIDIA's Global VP, Financial Services for a fireside chat on Intuit's strategic focus on #AI and best practices to deliver innovative AI-enabled applications to market.Register free for the #GTC23 session on March 22 at 9 AM ET: https://nvda.ws/41FT8fs",2023-03-10T00:00:00,[],https://scontent.fcai19-7.fna.fbcdn.net/v/t39.30808-6/335183118_181528924629058_4426349707524055313_n.png?stp=dst-png_p526x296&_nc_cat=108&ccb=1-7&_nc_sid=9267fe&_nc_ohc=11wiFyy3mqEAX-d5vH-&_nc_ht=scontent.fcai19-7.fna&oh=00_AfB_g8La9kBov8CWScI8TXvT4ZBplARWQttbY8bxisdYMw&oe=64E337A4,https://www.facebook.com/NVIDIAAI/photos/a.119492422050369/1147279782604956/?__cft__[0]=AZUKSumzC_sk63N4cqpZ9MN0XRM_8hwRoZtKF_nlqQP1C8z_Cowa5OdpSHdW2lz1dDWSc5VE4N9FnKedNUbQTfWtsKeo0RF7e4y3-ODe6TEvGta8hEQvZE8SDkeXeJ9RQ3PkRz6nd4zyJyWUl6F3UjfeCRO-ZRzJpF2-F_KTzEACX3MbPHpx8WhKT3XxnI2Aodd-qydgKCxr3h9fwtoz3VKx&__tn__=%2CO%2CP-R,17,0,positive,17
1147263415939926,NVIDIA AI,0,9,1,0,1,0,0,0,11,1,"Don't miss dozens of essential #GTC23 sessions for business leaders, featuring execs and industry luminaries discussing #AI business strategy to improve performance, innovation and scale. Learn more from our NVIDIA blog and register today for free: https://nvda.ws/3YtJp8V",2023-03-09T00:00:00,[],https://scontent.fcai19-7.fna.fbcdn.net/v/t39.30808-6/334951807_115557664810605_5247050383943898972_n.png?stp=dst-png_s960x960&_nc_cat=106&ccb=1-7&_nc_sid=9267fe&_nc_ohc=mwBzMTHy1qMAX_pOpt2&_nc_ht=scontent.fcai19-7.fna&oh=00_AfDGaTzIfYiqLwpfmh02qSABiHsDXz-O7C34uW1YuEMx-A&oe=64E39DBF,https://www.facebook.com/NVIDIAAI/photos/a.119492422050369/1147263415939926/?__cft__[0]=AZVbSuW40a8_Gk78nkCpOHAi15yFMfQhNHw9qzM9SWAQbyDhErTZOgdYcyuNsNosCKtJ6IwaFLaQ85zlV2bR7gUnKEe0JjKMKHB1a2eASRtYSfcHRDSJVYnVD9hhGvg5tKpMTWfCRBeHiAZfKYmgK08vKt-2HXRhHqX0iegHiSmDupENhTl2pSDqXtpkGUhp28YhHgbdnWxWjIpx66TlroUo&__tn__=%2CO%2CP-R,11,0,positive,11
1147249919274609,NVIDIA AI,0,12,0,0,1,0,0,0,13,5,Are your #AI models ready for #inference? Focus on writing your business logic rather than spending engineering time optimizing your infrastructure to improve performance. Check out these tutorials and get started with NVIDIA Triton. https://nvda.ws/3ZQf1aB,2023-03-09T00:00:00,[],https://scontent.fcai19-7.fna.fbcdn.net/v/t39.30808-6/335320788_1428490597965282_3413883001280267669_n.jpg?stp=dst-jpg_p526x296&_nc_cat=102&ccb=1-7&_nc_sid=9267fe&_nc_ohc=LzUqqcu7wwQAX-SqteX&_nc_ht=scontent.fcai19-7.fna&oh=00_AfCzSzCoKxLB2LbF7HUKX4fJb_iYMuAXFAZWs9bbQ1ZeWQ&oe=64E341AE,https://www.facebook.com/NVIDIAAI/photos/a.119492422050369/1147249919274609/?__cft__[0]=AZXsqCu57i-oy2vK7erMkddRHjOFsbHm4Abp3Je53IO4ZObSrk6qewcLhTX06bt8kcMdMPenWrHsRnEDwx968HKp18IxR4HYpndtN4TOEkuRZuvt9eMXF3CkywozZox98T75nmYbhAH3IWkbFsDVMSMKkVhs8qY-2sxRSKXIgQ-zJO3hC4w_hkcsPvWa_gpZxLZpG7YJb96Ov9VmqiSYDmq5&__tn__=%2CO%2CP-R,13,0,positive,13
pfbid09MsxRN9RdLm4nCYJk3UvYyMDidWmu9dWYNcogzjSG39qMY2SrxKA9LGoynWsuvJNl,NVIDIA AI,0,3,0,0,0,0,0,0,3,0,"Boost your startup. Learn from #VentureCapitalists Radical Ventures, Madrona Venture Group, and NVIDIA experts on the latest breakthroughs in #GenerativeAI and how NVIDIA's platform is powering the next generation of #startups. Register now for #GTC23: https://nvda.ws/3jsIEi4 #NVIDIAAI #GENAI #VCs #Funding",2023-03-09T00:00:00,[],https://external.fcai19-7.fna.fbcdn.net/emg1/v/t13/11861539913183507145?url=https%3A%2F%2Fprod2-sprcdn-assets.sprinklr.com%2F50276%2F8d6fd046-1709-45e4-8daa-3eeaab3c6366-863710300%2F2623389-gtc23-spring-social-in.png&fb_obo=1&utld=sprinklr.com&stp=c0.5000x0.5000f_dst-jpg_flffffff_p500x261_q75&ccb=13-1&oh=06_AbGPHcbKfY29_VB6zYipkKde2c6s5V4-e1fHLqmD3zyggQ&oe=64E07EB9&_nc_sid=dbad39,https://www.facebook.com/NVIDIAAI/posts/pfbid09MsxRN9RdLm4nCYJk3UvYyMDidWmu9dWYNcogzjSG39qMY2SrxKA9LGoynWsuvJNl?__cft__[0]=AZWu8EzPt5uWuM_GA0XEzHWoNCpBctF-5tSHS1G311MVISY-yLtTfVLcs535Tc97Jk63Ub4kbON2PrzgpMxpOdVjDWXPlq9PH9nccxQJa4daxvGdQrOLVY0W-TvJrWuHaeLvQqNQYifTGDil9OhFC8hzbljoUFgg4lswSHojYsdY5UW8UoicYpLnoAdSgPqbjObwNRugU8rr7yaUIHviih_u&__tn__=%2CO%2CP-R,3,0,positive,3
pfbid0Buy64wvieyYropSzRR7ts8fFUGyDWuDhc4KmGfLFUbFMi1dUkdLKRKFkoA2r66Zkl,NVIDIA AI,0,14,0,0,1,0,0,0,15,1,NVIDIA's Data Science platform offers a suite of software to streamline and accelerate end-to-end data science pipelines using the breakthrough performance of NVIDIA #GPUs. Attend data science sessions at #GTC23 to learn more: https://nvda.ws/3ZQWCdb,2023-03-09T00:00:00,[],https://external.fcai19-7.fna.fbcdn.net/emg1/v/t13/473968281635096410?url=https%3A%2F%2Fprod2-sprcdn-assets.sprinklr.com%2F50276%2F96b16736-7303-470e-a567-0d62d86c1433-1160939167%2Fgtc23-spring-social-ai-for-dev.png&fb_obo=1&utld=sprinklr.com&stp=c0.5000x0.5000f_dst-jpg_flffffff_p500x261_q75&ccb=13-1&oh=06_AbHDETN_HKih00X-kHhtRqjkN_iQXL0HjQy7asd_raHugQ&oe=64E063F6&_nc_sid=dbad39,https://www.facebook.com/NVIDIAAI/posts/pfbid0Buy64wvieyYropSzRR7ts8fFUGyDWuDhc4KmGfLFUbFMi1dUkdLKRKFkoA2r66Zkl?__cft__[0]=AZWP_xbymuCZELybESlD6IZhAjelhykUHS41HGRd_OX5q_CFyOC3AszGMkFkVGzsq-VJ9mmy92hISGTsgZzf4UJ-8KIztZ8V6fMLsYldDaulFLnFo3R9-d3lV23cwFI4TCoji7EoXmDsyz4ygdcD8peR5gHXxXvaqmIPVdcnIYIR0xgT41ihnMoyp_zORah5MkL1jnGU1nqa2isczEf4fQq0&__tn__=%2CO%2CP-R,15,0,positive,15
pfbid0bNqQddKSucRjFqSgbraEEBF5PKiDaenxzuCa1CNaSXqYqr6wh83A3FgHd9VeNEKRl,NVIDIA AI,0,12,0,0,1,0,0,0,13,1,"MLOps is confusing—it's broad, diverse and complex. Join us at #GTC23 for our Enterprise MLOps 101 session and get past the confusion. https://nvda.ws/3IZpedj",2023-03-09T00:00:00,[],https://external.fcai19-7.fna.fbcdn.net/emg1/v/t13/9824288059146813763?url=https%3A%2F%2Fdeveloper-blogs.nvidia.com%2Fwp-content%2Fuploads%2F2023%2F03%2Fmlops-graphic-1.png&fb_obo=1&utld=nvidia.com&stp=c0.5000x0.5000f_dst-jpg_flffffff_p500x261_q75&ccb=13-1&oh=06_AbGgIlQAZMsiBPY3j1SIZevaZSjeG4vI_i8B0BoZqwrwuQ&oe=64E088FF&_nc_sid=dbad39,https://www.facebook.com/NVIDIAAI/posts/pfbid0bNqQddKSucRjFqSgbraEEBF5PKiDaenxzuCa1CNaSXqYqr6wh83A3FgHd9VeNEKRl?__cft__[0]=AZVtBk44IoHePmDd-6RsTyRDCumyIOAScBPK87XGOBU6rn7lrbOBGVCDqHSVPMR6ROJ2fQzobzxHjcLnx9Vh-upHGDGwJ-Z7BRo6-kB-sNOo7m6Wte-1lDrRzYaseCvlPoahrg4MdGOV7fLDI-POVpOtzOC3P_7QU_Dych4QcJAxzTaQXvRk6CRjs9LmkaxbVNmT6Q3KYhyVppB8B0ZUAC2A&__tn__=%2CO%2CP-R,13,0,positive,13
1146828939316707,NVIDIA AI,0,12,0,0,1,0,0,0,13,1,"Find out how #AI empowers #banks to increase productivity, expand services, reduce risk, and improve customer service using innovative solutions from Dell Technologies and NVIDIA. Explore the infographic: https://nvda.ws/3ZLENMB",2023-03-09T00:00:00,[],https://scontent.fcai19-7.fna.fbcdn.net/v/t39.30808-6/334284145_536735871918782_1684608379355192110_n.jpg?stp=dst-jpg_s960x960&_nc_cat=111&ccb=1-7&_nc_sid=9267fe&_nc_ohc=Jklhu-U0x6EAX9a6xq4&_nc_ht=scontent.fcai19-7.fna&oh=00_AfAO_x3kvn2eMHBGBKAsX45AlCikgno2rff4cqHl2bY4hg&oe=64E3EC37,https://www.facebook.com/NVIDIAAI/photos/a.119492422050369/1146828939316707/?__cft__[0]=AZXwxfMMCCCa3HkKjyGNDsKakniuXWKsiQ8d_Jm85jtIxEc1P6haJ0mBJVut9-d0k0S0BMQEYbUzByHCGq7j9boGZtp03HzXlx156GYsaou7jj9DhvfFpffX6nlKmr0aFrHuOlDDmWH061Y8GGQWM1hpibSMXa9ngzdQsGFqbU7Gwy3ZQ0IZegA-a_F-ULPn3pBmglnM7Z1_v44k2I38kQnh&__tn__=%2CO%2CP-R,13,0,positive,13
1146796975986570,NVIDIA AI,0,16,2,0,1,0,0,0,19,0,"Join us at #GTC23 on March 21 to discover how color science research is providing solutions for more realistic lighting in VP, thanks to USC and Netflix Research. #VirtualProduction  #ColorScience  https://nvda.ws/3SnGnlp",2023-03-09T00:00:00,[],https://scontent.fcai19-7.fna.fbcdn.net/v/t39.30808-6/334681489_5951392711608647_3386054665443793906_n.png?stp=dst-png_p526x296&_nc_cat=110&ccb=1-7&_nc_sid=9267fe&_nc_ohc=Q-tr_dgB5NQAX8T1rYs&_nc_ht=scontent.fcai19-7.fna&oh=00_AfAowR2wEb8irQCxEze7w1aJlRBNstlG9jkuhmwEo3wwKg&oe=64E371E1,https://www.facebook.com/NVIDIAAI/photos/a.119492422050369/1146796975986570/?__cft__[0]=AZUmS28aiT0qyBAWTM4jG1-P_gZfuY64-ZQZCq6X_AdU5H-9exlh4iFs8_dEREa6Qi_8al7inW1UVpMdpLwVTo2iXZ-kmBPBNitnrMy-qMb2q7lEYTgfkSGAfqLIIlIei9SCWbFGRJNpBJIhEsIdQXdQT4U5j_diHv2Qn1OArr3T2Y7fq8DD_T4xnBq3I2_22XlgNaZ7huN_MVQRh8_7nVht&__tn__=%2CO%2CP-R,19,0,positive,19
1146756789323922,NVIDIA AI,0,8,0,0,1,0,0,0,9,1,"Join NVIDIA's CSO David Reber, Deloitte's Kim Crider and DARPA's Kathleen Fisher on March 21 to learn how to infuse cyberdefense into a modern #AI-driven business and transform cyber programs to address today’s threat landscape. Register now! https://nvda.ws/41UWHhA #cybersecurity #GTC23",2023-03-08T00:00:00,[],https://scontent.fcai19-7.fna.fbcdn.net/v/t39.30808-6/333316665_884022546046831_1919209533918130117_n.png?stp=dst-png_p526x296&_nc_cat=111&ccb=1-7&_nc_sid=9267fe&_nc_ohc=0Vwte3SQtS4AX9hUZJa&_nc_ht=scontent.fcai19-7.fna&oh=00_AfDgeUNRN6kNGvUhKqIodSxxyWz8w3uloBy8Hq4qXdNz8A&oe=64E2C869,https://www.facebook.com/NVIDIAAI/photos/a.119492422050369/1146756789323922/?__cft__[0]=AZX0da-VM7mFf3gna4rZat4KC3D0GnTJ5Eo5_fAwloLGUNt7ctGCNj0DpW4qUC8hV-1ML2oMua-65Jil7fxMUrA2J2GZBpZ6jOsDaJhSEvOd5D3O4m9ar0u56iXvLyInpnOtII2xC53tiZ_HVYq8-yDsIT1os8EgJ4wjcv5lHkoIbWdYKKPfNTvBV3VwJ6d9iMKboJIsshso5Wu3u_x-sDT4&__tn__=%2CO%2CP-R,9,0,positive,9
pfbid0jPrMBMLi4uQXdkhkb7RJtspuVKM18suVUjxSAUyAKGq38NJZpuFYETLe6BZGVYEXl,NVIDIA AI,0,17,0,0,1,0,0,0,18,1,"If you need high-performance data storage and retrieval for your application, a GPU-accelerated hash map can be a great choice as your core data structure: https://nvda.ws/3IW9doC",2023-03-08T00:00:00,[],https://external.fcai19-7.fna.fbcdn.net/emg1/v/t13/12813302194268311154?url=https%3A%2F%2Fdeveloper-blogs.nvidia.com%2Fwp-content%2Fuploads%2F2023%2F03%2Fabstract-graphic-rectangles-arrows-1.png&fb_obo=1&utld=nvidia.com&stp=c0.5000x0.5000f_dst-jpg_flffffff_p500x261_q75&ccb=13-1&oh=06_AbEF7Mc2c-zRr9Ekli_iKoiLZZXEjaw6hiAYvmc3eeRRQA&oe=64E0635B&_nc_sid=dbad39,https://www.facebook.com/NVIDIAAI/posts/pfbid0jPrMBMLi4uQXdkhkb7RJtspuVKM18suVUjxSAUyAKGq38NJZpuFYETLe6BZGVYEXl?__cft__[0]=AZXI4WhPGV3L2pENmAo9Fy555NZfANGA0CASA0IGzXtxhGUZ1Sikxg2Xm6FYXrQovjXR4t3MxIOWxasv0Wc0dbWMdIAY_7JWKOvUyp0PfKrKvK7VsfVZ7YI8_7x-zSal2pxy_db0qM9zcR4UXkkAZA4--1LfU12jGVxUixxJM24hqEIkRP7S6uKD38IwR8QWFZPabXMzL-trAacjMGeXNHQ4&__tn__=%2CO%2CP-R,18,0,positive,18
1146715659328035,NVIDIA AI,0,7,0,0,2,0,0,0,9,0,"Looking for inspiration to achieve a career in #AI? Hear from a panel of innovators developing AI solutions that are changing the world of healthcare, climate, generative AI, social impact, and more. Join our #GTC23 special event, Change the World with a Career in AI on March 22nd. https://nvda.ws/3x5wKxE",2023-03-08T00:00:00,[],https://scontent.fcai19-7.fna.fbcdn.net/v/t39.30808-6/334493696_570568921693062_8984753690742050186_n.png?stp=dst-png_p180x540&_nc_cat=108&ccb=1-7&_nc_sid=9267fe&_nc_ohc=hqUXWkcCmdQAX8HKlOE&_nc_oc=AQlyrNyIC3MxoYHuTWOH8mJBFC3eT3Golk1aOLRpYpyR3O7YirMlmD1fi5UeSzIp2Bo&_nc_ht=scontent.fcai19-7.fna&oh=00_AfB2PN_GTC0WAiPrljVb_AqeoIvTnfDazeMikGhgbSZv1w&oe=64E3E1BE,https://www.facebook.com/NVIDIAAI/photos/a.119492422050369/1146715659328035/?__cft__[0]=AZUXzZjzu9QDTRN_YdcpiBvu92vqDKohuwOCclHUU_9965YievgJ28ZmR6uaRMSl4OA60riWaE83J4xm71n5hHBEpdkB79grMgq7U8pIudWHwvPwi8E5RTAWV_vLf8PrKUUtclRs8c96bCM4bgAlePMW-QhAKIRyLuJfC9HGeGrYHrnRooVcQl9d-Joku2srKg2HEAyM0RYbZpTc22Fhudlu&__tn__=%2CO%2CP-R,9,0,positive,9
1146691465997121,NVIDIA AI,0,6,1,0,2,0,0,0,9,1,Join #Target at #GTC23 to see the latest innovations in machine learning models designed to improve the customer experience through multimodal learning. They’ll share how they’re enhancing search and recommendations with a specialized visual search language model for #fashion. https://nvda.ws/422iHHN,2023-03-08T00:00:00,[],https://scontent.fcai19-7.fna.fbcdn.net/v/t39.30808-6/334675108_162635532898209_1102037645411478903_n.png?stp=dst-png_p526x296&_nc_cat=106&ccb=1-7&_nc_sid=9267fe&_nc_ohc=evNonMBYuYMAX8wek7l&_nc_ht=scontent.fcai19-7.fna&oh=00_AfAQWDUVO6f4L_EhQwd71ihFIBVGDEJEh8rr-rLunufc5Q&oe=64E48EE0,https://www.facebook.com/NVIDIAAI/photos/a.119492422050369/1146691465997121/?__cft__[0]=AZW02crzMRFPzLUJAmez5zzuBiBLtprPnX5I-gmUcgu6fuyIvY7vqvqjqBNjniw3HnBp2Tp7GkaXB5x27H7ZTWicmlw593i_QYIORHOzQ2Cs6LUzz9S3RqkkrbVirgjK0X7_dmuU25DJw6DdqFENgXDExsK8_MM9GEKU227K4_Mc70YgPpOoFNNHg9GfZmNPSZiO1Z7nIy8VCL1lXdgcKldQ&__tn__=%2CO%2CP-R,9,0,positive,9
pfbid02PpcStdcQ591BfxUadsJiC93REF2Qckam4DwHrKNUwm9ftiHeedF71jEtkQ7ULRtml,NVIDIA AI,0,14,1,0,1,0,0,0,16,2,Learn how AI Is transforming cybersecurity at #GTC23 https://nvda.ws/3YvrFdw,2023-03-08T00:00:00,['blob:https://www.facebook.com/9272b82c-24f3-4963-8a20-84b3a988e890'],https://scontent.fcai19-7.fna.fbcdn.net/v/t15.5256-10/334912344_607057917437948_2443942920311809203_n.jpg?stp=dst-jpg_p960x960&_nc_cat=104&ccb=1-7&_nc_sid=ad6a45&_nc_ohc=_1qpcZptz6kAX9Jr0Kg&_nc_ht=scontent.fcai19-7.fna&oh=00_AfDP53Y_1M0Yu-DSr2SKMuqOmvY55COjWOizJCadu_44pA&oe=64E371C6,https://www.facebook.com/NVIDIAAI/posts/pfbid02PpcStdcQ591BfxUadsJiC93REF2Qckam4DwHrKNUwm9ftiHeedF71jEtkQ7ULRtml?__cft__[0]=AZVpV-voCdMYf8KjZ5BnxloiS9EretWSAkUP7h20OzJGQ2AoUkFXBcGxwwqNBUpLSxsORhCcaESYszFbjM7Hz2esXZ_ahQpCPnviXQrDMWZIJeDHaJA6fzlIvoTHIeQ50588QUD2G5UbUZgg30bXcVJIXdv4hyt7l-Tk6wNoPeTSkWiX_5UjmOEBoK-qjoEjeKr_L1z4GiUSx6v8Lb1ewNyhWVL9-OfNOohVwe_N59H37w&__tn__=%2CO%2CP-R,16,0,positive,16
pfbid0sUh2ze4HQ69sAF5JJffvuyhSGvzeRzNhZtebr366FYU9C5XiFbKZAaAxESKFvfRSl,NVIDIA AI,0,11,1,0,2,0,0,0,14,3,"Don't miss this #GTC23 session to learn how #generativeAI and #InstantNeRF will enable us to build #3D virtual worlds bigger, faster, and easier than ever before. https://nvda.ws/3ZrDzq9",2023-03-07T00:00:00,['blob:https://www.facebook.com/3bde28f2-982f-4ee5-8941-1be2ba217b2c'],https://scontent.fcai19-7.fna.fbcdn.net/v/t15.5256-10/335007690_220624500378949_5387893514180612267_n.jpg?stp=dst-jpg_p960x960&_nc_cat=105&ccb=1-7&_nc_sid=ad6a45&_nc_ohc=aWIbUKKHQMoAX_ojCqk&_nc_ht=scontent.fcai19-7.fna&oh=00_AfAyGbALRse3TWDkG0T-AtBNLFGBP-QYQCRcK9VZ2--SPQ&oe=64E3B6C2,https://www.facebook.com/NVIDIAAI/posts/pfbid0sUh2ze4HQ69sAF5JJffvuyhSGvzeRzNhZtebr366FYU9C5XiFbKZAaAxESKFvfRSl?__cft__[0]=AZVfNd9eIKU2VRBZapAmueVMo-u9hhXp79OkmKRj8fvP914If5RD3XadG7V3JE5wd5F5Pc5keqajVB5bQqg_5T8Ko6VCFEws_WjTCVGWzjv5dIFISB2Pw5stLU-xaZVgpdZKANY7NrdKon8UDOLBGnNvNKh0JkFUaCVETYJxag60DtLt5Xc-fXXVm5lbxQ4Bfr006SM95CatVazhjCgxPaTDHbftD8m2C2brb7TMjQvL9A&__tn__=%2CO%2CP-R,14,0,positive,14
1146187102714224,NVIDIA AI,0,13,1,0,1,0,0,0,15,5,"Register for our top #deeplearning sessions at #GTC23 to learn about the latest tools, see real-world use cases, and discover optimizations and best practices for training and inference. https://nvda.ws/3KzwuPB",2023-03-07T00:00:00,[],https://scontent.fcai19-7.fna.fbcdn.net/v/t39.30808-6/332710577_1368903247207285_2942518264642062069_n.png?stp=dst-png_p526x296&_nc_cat=102&ccb=1-7&_nc_sid=9267fe&_nc_ohc=OklJdIJq--8AX91kKDP&_nc_ht=scontent.fcai19-7.fna&oh=00_AfCViYVJVaejmzoV3Np12xuob6wfIDruu09NpKvWKIkJQA&oe=64E2C1DC,https://www.facebook.com/NVIDIAAI/photos/a.119492422050369/1146187102714224/?__cft__[0]=AZV_frECkgRvDkV3fmH07C2Kv0IIMnr1O5PW0xNfBJ-tMEYRppQUiL_pqC5w5Scb_JH6ghF2mhKzEN8ZOGQJtaVTFtT4lDr8pgiYsbAozYZB_7CsfuKVzsFlEiWe6ZI8SmYxyJUat4mERDmy14HDir5mGZd0TathYLH2sMRC_v1NBKWxJxzAj-dT6r3eQ-Anp0OeBqagSb-IQJjjzZj_M-LL&__tn__=%2CO%2CP-R,15,0,positive,15
1145845592748375,NVIDIA AI,0,8,0,0,1,0,0,0,9,1,Discover how Amgen's digital innovations are taking R&D to new heights with #BioNeMo. Pretraining #LLMs on proprietary data is key to their success in generative design of biologics. Register for this #GTC23 session for all the details! https://nvda.ws/3SaSnXb,2023-03-07T00:00:00,[],https://scontent.fcai19-7.fna.fbcdn.net/v/t39.30808-6/334494872_762401752023721_3161167713135205440_n.png?stp=dst-png_p180x540&_nc_cat=108&ccb=1-7&_nc_sid=9267fe&_nc_ohc=ml4n3je8OCIAX8B7gom&_nc_ht=scontent.fcai19-7.fna&oh=00_AfBLRx5B4_s0j9zrL1eg0smujHxVNty4JwPBZe874JkRYw&oe=64E2DAF5,https://www.facebook.com/NVIDIAAI/photos/a.119492422050369/1145845592748375/?__cft__[0]=AZVK1ic_0z3JmM9Yfa2iKkYeIMZ0appKUyhzVJzGLWL6a7HK2k4ThvTA8r1CCfU0eXRspKmM0iui5J-IfRPm2Z7Yei17zi_It1n_Wy3sJJ2k4u5wNFZotzEyAst1vZnlAIZh4O6WaK0xr2rbjAPVSeZl5ainBsF4hqGkKFenW2WytcSBNvYrmlrcc185Y0hye-WNpRqARng0iV502rccLFES&__tn__=%2CO%2CP-R,9,0,positive,9
1145841019415499,NVIDIA AI,0,6,2,0,1,0,0,0,9,0,"Hear from industry leaders LinkedIn, @Roblox and more on how they've harnessed the power of #recommendationsystem to pioneer products that shape the online consumer experience. #AI #GTC23 https://nvda.ws/3Iv7ckp",2023-03-07T00:00:00,[],https://scontent.fcai19-7.fna.fbcdn.net/v/t39.30808-6/334624798_683876126825319_4941293555132290567_n.png?stp=dst-png_p180x540&_nc_cat=111&ccb=1-7&_nc_sid=9267fe&_nc_ohc=om5upPJgcloAX-CggfV&_nc_ht=scontent.fcai19-7.fna&oh=00_AfA30fvKB428LPrvYp-MYq95L3yMGePhN6MVK7tl0Y3Qcg&oe=64E495D0,https://www.facebook.com/NVIDIAAI/photos/a.119492422050369/1145841019415499/?__cft__[0]=AZXiFw2iDVKpKaQMs5gQ-bTCfD1IUVAEXnQSqMrDQuYoJFfkKUjBPOREeVZoi2bdIcCg5w_dL6xFHXb0NQOagBd9L-zUJThxbCKrrqE0mxkqHQrECdPuDElRXymw-D5IEKnTYnpNEQAJSjhfd26Cjng0EzxcESWWdTFoFWunu6-cZLwr0U1BWw4YcKefIGclwGMwszvXcej8xUqamaRJiLVs&__tn__=%2CO%2CP-R,9,0,positive,9
pfbid02caHtdJRwvGxxrCJhwEyMhKpKwhvuXUK5bQxxgxiNQF4Qi5ka1rb1SSNrm7cUtB7ol,NVIDIA AI,1,14,1,0,1,0,0,0,16,1,"#NVIDIAMetropolis Microservices offer #cloud-native, customizable building blocks to develop #visionAI applications. The early access version includes multiple microservices and three ready-to-use reference applications for retail loss prevention, multi-camera tracking, and occupancy analytics to jump-start your vision AI development. SIgn up for early access > https://nvda.ws/3ZfC9yJ",2023-03-07T00:00:00,[],https://scontent.fcai19-7.fna.fbcdn.net/v/t39.30808-6/333603301_1640064896455867_5331430046826498564_n.jpg?stp=dst-jpg_p526x296&_nc_cat=111&ccb=1-7&_nc_sid=9267fe&_nc_ohc=I6kuqv9TY58AX8546Pa&_nc_ht=scontent.fcai19-7.fna&oh=00_AfC5UAZDEWySUomUzDFwsSqP5FXmBZRCCtoXbmeef4oFxA&oe=64E448EE,https://www.facebook.com/NVIDIAAI/posts/pfbid02caHtdJRwvGxxrCJhwEyMhKpKwhvuXUK5bQxxgxiNQF4Qi5ka1rb1SSNrm7cUtB7ol?__cft__[0]=AZVPm22EiycCMw3m7QqhnAUrmnrnESHbNvzm9FYog8m0tl5o521AvTFk8T94-D7wR_M-IOI088oxoZaJTyFWZ7Lermx-XlUc7NF1jMuzYC4ciup65E7URgjys__GZt55xR3OWAJtduCKJyc_qBpI0wjmGNPrJ172TWY8-eqqfqXxJ8yiubAHCqGKzrIf0ZDrxfF7mjHmfbEatdI-XT_CstAilrylOzmGjMdHg4ClS7hZjHyuYZLdh5PW2Y-nXYp8FDoHIz4eqRgPF-xJtsYDGBHP&__tn__=%2CO%2CP-R,17,0,positive,17
pfbid04GgdGKTWQNfWvr2mfRKvMVF1Q3ZciKa6QqciVmKe2VGRTQJSYnzbrZXLYDjXUCvGl,NVIDIA AI,0,9,0,0,1,0,0,0,10,2,Learn how to write scalable GPU-accelerated hybrid applications using C++ standard language features alongside MPI in this new self-paced course. Enroll now: https://nvda.ws/3SMBmDa,2023-03-06T00:00:00,[],https://external.fcai19-7.fna.fbcdn.net/emg1/v/t13/480757047843703095?url=https%3A%2F%2Fprod2-sprcdn-assets.sprinklr.com%2F50276%2Ff9ec6284-0a61-4862-a1c7-9849f23e106c-340906127%2Fdli-self-paced-course-social-l.jpg&fb_obo=1&utld=sprinklr.com&stp=c0.5000x0.5000f_dst-jpg_flffffff_p500x261_q75&ccb=13-1&oh=06_AbGxGolCoJiCUdK6-cuBq5W_sPRLoM47D8sufE7CLf75pQ&oe=64E05D88&_nc_sid=dbad39,https://www.facebook.com/NVIDIAAI/posts/pfbid04GgdGKTWQNfWvr2mfRKvMVF1Q3ZciKa6QqciVmKe2VGRTQJSYnzbrZXLYDjXUCvGl?__cft__[0]=AZXX3Hwd2M_fHBhuemQSV0iDpaJBFwxknGnvKF7SkZUaiqRlkMkZ79u_JGh0s00IzSJMi6ZjA31TfmfQxt-LNBYJk5ZkFQVRyGNtstwP_pgOgQCgMJ_vDdBEPnA4mBGmw_-_Jjljn9WcuzpFBa6tRgzIPxRZl8T2Tjykwz0UMzjeTFH26NnQXI3_3kO91-s004qb9X8PZA_5KdGydDq7kknn&__tn__=%2CO%2CP-R,10,0,positive,10
1145691439430457,NVIDIA AI,0,5,1,0,1,0,0,0,7,0,"Join early #LLM pioneers from @inworld_ai, @LatitudeGamesAI, and @Get_Writer as they share best practices of training models and the challenges they face using LLMs at scale. Register at #GTC23 https://nvda.ws/3X0Zp1q",2023-03-06T00:00:00,[],https://scontent.fcai19-7.fna.fbcdn.net/v/t39.30808-6/334933414_1522561868230365_1208171739937701622_n.png?stp=dst-png_p526x296&_nc_cat=104&ccb=1-7&_nc_sid=9267fe&_nc_ohc=fUmdN8MCEIQAX_ZT7Td&_nc_ht=scontent.fcai19-7.fna&oh=00_AfDHhcR1m1a_55HCkYudQXGLIyVwMX2e81c_j-rgeeFq4w&oe=64E4081A,https://www.facebook.com/NVIDIAAI/photos/a.119492422050369/1145691439430457/?__cft__[0]=AZWMFRpOimYGD_PSrPqc38__f8QlF47d1oP5MWqB7-BVJ9vttETHMXPJW2cau4jyHjM4X1fgorNOPsrVKK1WPQn6XmrM3_vsS-XlqSfKPzxr_I0hNAYyLTuuuh1pyWuW1YF8_a3R6NTq6QEEBvo1JqIWJ-u7rI26jjUeotHDB-MxnWIIKipuJniOFvNaEMD1zBxgVPwW4bnHevPDj0zaHc0H&__tn__=%2CO%2CP-R,7,0,positive,7
1145164509483150,NVIDIA AI,0,11,0,0,1,0,0,0,12,1,"Portland General Electric, Utilidata, and NVIDIA plan to bring distributed #AI to the grid edge to empower #utilities with real-time visibility and decentralized decision-making and control for distributed energy resources. Learn more in the #GTC23 session on March 23 at 7:00 a.m. PT: https://nvda.ws/3IKaoam",2023-03-05T00:00:00,[],https://scontent.fcai19-7.fna.fbcdn.net/v/t39.30808-6/333551582_616812470287428_569530144377635119_n.png?stp=dst-png_p526x296&_nc_cat=102&ccb=1-7&_nc_sid=9267fe&_nc_ohc=YstQejvGBQEAX87xEk9&_nc_ht=scontent.fcai19-7.fna&oh=00_AfDX8Bk5u1h6Ytv36Ji_Toay5F2JGxH_53yhGJkShV7U2w&oe=64E417D0,https://www.facebook.com/NVIDIAAI/photos/a.119492422050369/1145164509483150/?__cft__[0]=AZWPjOKlm79LfG65mgkpVVwABnQCFeedhPnhSCBPHCO5R-LUm4xbVvnI4Y4o_cmtAuR_NKgzNmNTyO3uwCVsNApaXIX6K6rcvte6Xp6HexK105nJQg90R2A-gdg8tOH29GEKSEJLCsuJ6cQ0aHq6L-S0_coJbodrUC5D7XfLWkA_h5Hfui6-pCN35tDqeM3bVq9eDTNjw8fZs04F_zocOgKF&__tn__=%2CO%2CP-R,12,0,positive,12
1144716822861252,NVIDIA AI,0,15,0,0,1,0,0,0,16,0,Want to improve the performance of your risk/pricing application in the #banking industry? Join us as we explore the use of multiple #GPUs on virtualized servers with NVIDIA AI Enterprise. Discover how to optimize the virtualized application on VMware and learn about performance comparisons using different VM configs: https://nvda.ws/3Zx9tRH#GTC23 #machinelearning,2023-03-04T00:00:00,[],https://scontent.fcai19-7.fna.fbcdn.net/v/t39.30808-6/330285307_593549332649351_1354386218373878833_n.png?stp=dst-png_p526x296&_nc_cat=105&ccb=1-7&_nc_sid=9267fe&_nc_ohc=Eq-yAi7KcRYAX8SNawn&_nc_ht=scontent.fcai19-7.fna&oh=00_AfCs1BhYxJaiFYf7sTsaXXU3Reyu0eCxql0bG5mRTxGCNg&oe=64E404C1,https://www.facebook.com/NVIDIAAI/photos/a.119492422050369/1144716822861252/?__cft__[0]=AZUsP7__U5qMZeD3VlSClaecloj_q3eJvTuNPwt5hEfLs1EDSG3bYchOLLAJiqm7VzMI1agceC_nU-JT6V5R93wkL9UBjrebyWUVYe7d6d2Jt4xPTTVfAQbmORHgHed4jtQ-YYK6MHH07l8S6BIMGeyMyfskNJGay3AJ96NAXU9Fm5pafbf-hWB3oeQ6J-CEtqWsMuJ4GJZuI1xcqe0NkDk7&__tn__=%2CO%2CP-R,16,0,positive,16
1144667186199549,NVIDIA AI,0,10,0,0,1,0,0,0,11,0,"NVIDIA’s Earth-2 platform connects data-driven #weather and #climate models and deep earth models to thousands of downstream applications with unprecedented speed, resolution, and interactivity. Hear from Shell and NVIDIA at #GTC23 session on March 23 at 7:00 a.m. PT: https://nvda.ws/3IIdmfz",2023-03-04T00:00:00,[],https://scontent.fcai19-7.fna.fbcdn.net/v/t39.30808-6/334177489_723573422767667_7738496486493461129_n.png?stp=dst-png_p526x296&_nc_cat=102&ccb=1-7&_nc_sid=9267fe&_nc_ohc=svP_z29R7tkAX_mR_M8&_nc_oc=AQlxI4J2_jLxGNg7qyv-WjMa45lrp_46RfpeFBYMPiF9GYnPZ7XFWcbHcIz_293PiwE&_nc_ht=scontent.fcai19-7.fna&oh=00_AfCmIF11jZp5aG69Uxzo-owcUk88_uH7RX0VBqTSU28QCQ&oe=64E3C86F,https://www.facebook.com/NVIDIAAI/photos/a.119492422050369/1144667186199549/?__cft__[0]=AZUe__yv4qud_bLH4WIjzxmNPKrUj_IvVmqTUu1J_y9fQHNOekrxs1Af3GCWuxOLoMD5-E7-206ZFb0z2c8j_ib7MMOZsAOrE8fMSuu41iGx6xbh9trHbADvG0vwaA_EjHR1MGBe50XcV778RM9Se36AL_5Fe7bKaztjTsLbGJvNlO1JLtkl4gyA6TsJ9G6ipGhQyFKz8tXRAtmpOj3_IFjG&__tn__=%2CO%2CP-R,11,0,positive,11
1144283329571268,NVIDIA AI,0,12,0,0,1,0,0,0,13,1,Is it possible to detect financial fraud by modeling transactions with billions of edges and 100 million nodes? Mastercard shares details on their work on temporal graph learning for financial services at #GTC23 on March 22 at 10 AM ET: https://nvda.ws/3ZaUflp,2023-03-04T00:00:00,[],https://scontent.fcai19-7.fna.fbcdn.net/v/t39.30808-6/330300805_572088988190138_3882904260489562683_n.png?stp=dst-png_p526x296&_nc_cat=101&ccb=1-7&_nc_sid=9267fe&_nc_ohc=HfboQxi_dwoAX-29Seg&_nc_ht=scontent.fcai19-7.fna&oh=00_AfAC_Hwyb6iW44-da0-J8gpiAggPE5sOwCA9q8gkQriFhg&oe=64E49B15,https://www.facebook.com/NVIDIAAI/photos/a.119492422050369/1144283329571268/?__cft__[0]=AZUefEDimV-VrNzfwkbwAj4FuvBcuke7OkuqieuR4OSVmeveYwT3QgS5LScvkxCVc7wLHwZUmy2_Meh9qBEQSBrNdYs6LpMASzYr6MWeeGEmZ5AwrqBMwwad9EU8JtopMp6eA9mULnA-ZxxM8knOF8-__VmC9wEW9BlV8fDFClbWpoVFX_VCyp8eRhO14aGFbDbQCxOVV227rRC9MZh4BBx2&__tn__=%2CO%2CP-R,13,0,positive,13
1144237212909213,NVIDIA AI,0,11,2,0,1,0,0,0,14,3,"Join Kimberly Powell, VP of NVIDIA Healthcare, at #GTC23 as she discusses the intersection of #generativeAI with biology and #healthcare. Exciting breakthroughs in diagnosis and treatment could be on the horizon thanks to the potential of generative AI. https://nvda.ws/3IGDWWz",2023-03-03T00:00:00,[],https://scontent.fcai19-7.fna.fbcdn.net/v/t39.30808-6/330394965_837557221265287_3765286868479725914_n.png?_nc_cat=100&ccb=1-7&_nc_sid=9267fe&_nc_ohc=zuJ6AK42UBIAX9NwUz1&_nc_oc=AQn1wIJ2HtKZlQ0KP1sgukMxOeM-mefphe12TyefrLE2l5dy9cwKqyUC-cyzzZGRQh4&_nc_ht=scontent.fcai19-7.fna&oh=00_AfDq56vlexDgmBTpQzq0O5ck2th534osyRi_msHf94xyfg&oe=64E314D8,https://www.facebook.com/NVIDIAAI/photos/a.119492422050369/1144237212909213/?__cft__[0]=AZXoA72ROz2aB1J-Y6whJFV_yiRLNBxMeTiWguIQNC-kpl2LGZ0mQT5hzApiyhLFi4CN8hz70cBG8WJCGV5ouznMHA81pEEo-u_f0vxsTlYslPFOaIun06IM8e_51f652cih9oQ6ZfauapIx0fIuBCE9VzAHaZuP-3tAiQV5zMYE9F9aIXFwFuYsFyoVYC2AS0JM2Fl3rLUS50LeW1PGO-qb&__tn__=%2CO%2CP-R,14,0,positive,14
1143660716300196,NVIDIA AI,0,6,0,0,1,0,0,0,7,0,Hear professors from Stanford and UT Knoxville share their #AI-based methods for microelectronics to reduce cost and time-to-market for chip design and fabrication. Register! #GTC23 https://nvda.ws/41fK5S4,2023-03-02T00:00:00,[],https://scontent.fcai19-7.fna.fbcdn.net/v/t39.30808-6/330349160_886692722579070_6834229369690555822_n.png?stp=dst-png_p180x540&_nc_cat=103&ccb=1-7&_nc_sid=9267fe&_nc_ohc=3fx4-BRW0E0AX-ks0J4&_nc_ht=scontent.fcai19-7.fna&oh=00_AfAoO1QYCBLkSI-j9XlBkTsqPDmRGD36zEx04rjJ2OIaVA&oe=64E3C7E7,https://www.facebook.com/NVIDIAAI/photos/a.119492422050369/1143660716300196/?__cft__[0]=AZWm1cDaW3RRkXusATPMflmq7pUbHK1z9odtOPoGulSaKSNhNDorfUs6PWVxQRyY-8g7dRI8PSSIf0L2EyiMzMY0oWL769gdnRv46VdHhkK77XfE6jgxL9SnkfqhxlZ8I2O0r0Vri_7kkOXRrW3X3d3PfxkK_8FqgVz6EVS4J-5j1QURJ5jqqqVFjJIK_bAKQLyLjDVGsT2_gpU7U-rBXBWJ&__tn__=%2CO%2CP-R,7,0,positive,7
1143612416305026,NVIDIA AI,0,18,1,0,1,0,0,0,20,1,Hear how #RTFKT is using #AI and 3D avatars to create engaging experiences across different digital and real-world touchpoints and how the next generation of creators are using 3D avatars to create original content. #GTC23 https://nvda.ws/3ENXVkR,2023-03-02T00:00:00,[],https://scontent.fcai19-7.fna.fbcdn.net/v/t39.30808-6/334210697_528417739433603_7516473797932562245_n.png?stp=dst-png_p526x296&_nc_cat=107&ccb=1-7&_nc_sid=9267fe&_nc_ohc=fqRpoQAGtWoAX9EbQml&_nc_ht=scontent.fcai19-7.fna&oh=00_AfBr2iGS2WSKRdI3O7kI-H7Nf76tGX0YvWlk2cBVDFsP7w&oe=64E40132,https://www.facebook.com/NVIDIAAI/photos/a.119492422050369/1143612416305026/?__cft__[0]=AZV6B5wy6-WmXC1dPAtbqomg87Fhrlj5xM36Pyk8U8SBAhIwVKB7AnSde_DOCra67sUdl7uT1rWiP0kOTfKGWZSIlHYYSy3A8HrdzXzkg5-y7ByzqZRzBWLNI5X4BazVbI5DvYOHVALXIhhnYn0mqknEBTTh-Hak9pUcOSVFVcgdm7Oozar5fRvtv_Dt1jGRE5p7pbrTbVGtC2k0Cf1WVGbf&__tn__=%2CO%2CP-R,20,0,positive,20
1143306186335649,NVIDIA AI,0,9,0,0,1,0,0,0,10,0,"In Episode 190, of the NVIDIA’s #AI podcast, Glean's Founders Deedy Das and Eddie Zhou discuss on how #LLM can become a source of intelligence, helping spend less time searching for data and more time working. Tune in now: https://nvda.ws/3y7ZbLS",2023-03-02T00:00:00,[],https://scontent.fcai19-7.fna.fbcdn.net/v/t39.30808-6/333461091_3278584002382652_1290262782006214904_n.jpg?stp=dst-jpg_p180x540&_nc_cat=111&ccb=1-7&_nc_sid=9267fe&_nc_ohc=ZAwizE6jnCUAX81F38i&_nc_ht=scontent.fcai19-7.fna&oh=00_AfDmsqs5tcGBRPQM0R-dACxG6YvSTvIMZ0SsSwDmhSltiA&oe=64E407E5,https://www.facebook.com/NVIDIAAI/photos/a.119492422050369/1143306186335649/?__cft__[0]=AZULS0Xp5Ryc-TejfUT3U9wK2qmo8NC70zqArF7BDn1d1tiPrkkl2gh515hs0sa2_OYssH4AUf6tufsX8nxdI11Tma1Msh_uR81gqPbNwDeyxWy7t5cfKhl3SyPBLManZl6u5pETeSInSCZ0qq43Z164DvpCl0IkC4g5pZ5qHFKHNBIF4HNaB0Rw21bL7ItmiZG1YraRCQ62VKhQZe_sE6x48RWl0ur3nWqRBVfcfISNOQ&__tn__=%2CO%2CP-R,10,0,positive,10
pfbid037C4rVStjHCkjpKMMj4VwjyKMRS4yCmGtS2G8Nt1prcNW4oLpccKCg3H8JU1Ddarbl,NVIDIA AI,0,17,2,0,0,0,0,0,19,4,"Technical walkthrough: Train and save an #ML model to deploy as part of an ML system.Learn how to create a #Python script that, when executed, trains an ML model and then saves it for future use. Read the 2nd in our ML blog series: https://nvda.ws/3K5CHCt",2023-03-01T00:00:00,[],https://external.fcai19-7.fna.fbcdn.net/emg1/v/t13/15096022487672972531?url=https%3A%2F%2Fdeveloper-blogs.nvidia.com%2Fwp-content%2Fuploads%2F2023%2F02%2Fai-for-dev-social-blog-machine-learning-in-practice-2598934-tw-li-2048x1024-option2.jpg&fb_obo=1&utld=nvidia.com&stp=c0.5000x0.5000f_dst-jpg_flffffff_p500x261_q75&ccb=13-1&oh=06_AbF-uyhbxJSEvDKHiYuwVZInV9kVdgOda36qaR4ouZzEzg&oe=64E074B4&_nc_sid=dbad39,https://www.facebook.com/NVIDIAAI/posts/pfbid037C4rVStjHCkjpKMMj4VwjyKMRS4yCmGtS2G8Nt1prcNW4oLpccKCg3H8JU1Ddarbl?__cft__[0]=AZVGYG6whE0-i8YAabrtk1X0-RCYpyFn_-FFPVNCXCTG49OSIJHv1XoJQCl8NnJ3FQCl4mgq94JchyPZ32eY9HVqsHHiEFAOh4kCFPaaBHKkopnXjGcVp9_6KSydvSXaTo38FYtV35JHW-IUKdMqIvnTKCFw-bwWpzIDHZyIvSUqO5Jm7Oox7dJGXr1bjT2RDSsQwX7BZfDdVYrtwM2g2sJjStOfNNjN2F9MAwIWGJoFiw&__tn__=%2CO%2CP-R,19,0,positive,19
pfbid034GuCXWoqEhPEutdQgQG4kKLafXf96KAsaUdTKisS6SnEWhxvNNn3MWAc7LRyE8hnl,NVIDIA AI,0,16,0,0,1,0,0,0,17,3,Get started on a #zerotrust approach to #cybersecurity. https://nvda.ws/3XU5DAF,2023-03-01T00:00:00,[],https://external.fcai19-7.fna.fbcdn.net/emg1/v/t13/9989585301664412201?url=https%3A%2F%2Fprod2-sprcdn-assets.sprinklr.com%2F50276%2F494421ba-5abc-41aa-8f02-424ebc448f21-1976569886%2Fsecurity-gtc23-spring-cyber-se.jpg&fb_obo=1&utld=sprinklr.com&stp=c0.5000x0.5000f_dst-jpg_flffffff_p500x261_q75&ccb=13-1&oh=06_AbG7J1AqU9T2odTl3120tWiMD2fIyiqAqbL1g0Q4Jp3VHA&oe=64E09F00&_nc_sid=dbad39,https://www.facebook.com/NVIDIAAI/posts/pfbid034GuCXWoqEhPEutdQgQG4kKLafXf96KAsaUdTKisS6SnEWhxvNNn3MWAc7LRyE8hnl?__cft__[0]=AZWerWlngcH1LB7xvxt3t2zvEzIJO4Qfb0Pd0t27jCooM6f8uBRxfSP2H5XSf-vGCQFZ9gNL6yMH0q6etWlHKM2ycGF6pziaiaIrfwNKlNkfTp0J1rkmhKccrbUcPVuVy4PBKnHbmi-qe8lP6PtAWfo8Oe3AbKrzmJV_zsfpH-WaID627pBRIUCvGj6xk5u-U-uANJLwCakHfmXPT1jpcTvO&__tn__=%2CO%2CP-R,17,0,positive,17
pfbid09R3d61PniD7nj1Zu7q6B7129Ym7L5fRANPwjvAMqMudq7a6GxAUDtFue9Ff7gz2Rl,NVIDIA AI,0,14,1,0,0,0,0,0,15,1,Marktechpost listed NVIDIA’s Megatron-Turing Natural Language Generation (MT-NLG) as one of the top #LLM for demonstrating unparalleled accuracy in natural language tasks. LLMs are the workhorse of #generativeai applications. Read the article to explore the full list of top LLM models of 2023. https://nvda.ws/3m2K0Rt,2023-03-01T00:00:00,[],https://external.fcai19-7.fna.fbcdn.net/emg1/v/t13/13804249824937832982?url=https%3A%2F%2Fwww.marktechpost.com%2Fwp-content%2Fuploads%2F2023%2F02%2FNewsletter-Banner-Thumbnail-Beehiiv-1-2.jpg&fb_obo=1&utld=marktechpost.com&stp=c0.5000x0.5000f_dst-jpg_flffffff_p500x261_q75&ccb=13-1&oh=06_AbGT9njXQxxXvsNkQmNHKzV-w9aZe-VZ94spDahzKaw-0A&oe=64E05DED&_nc_sid=dbad39,https://www.facebook.com/NVIDIAAI/posts/pfbid09R3d61PniD7nj1Zu7q6B7129Ym7L5fRANPwjvAMqMudq7a6GxAUDtFue9Ff7gz2Rl?__cft__[0]=AZWNIHC5_Y1eU9F-uWy9GwVZIm5KrUOjXtvoIYg7dY6HN6KJ-DTIpEUAulVMztltq8P6EfVEcl8dAV4VsfXm6Ca93D8g7QNVayUVHFihy0rgNqSdPHoDB0YTUU0FcRJtqgSpva3EKBIUNIuNXd4uauebKtASmDjHnCTQ5pA5GSTjfVW8ipAU5MZ2Ct-TFQq4PurWcfekok4KN_gAeDmxhRem&__tn__=%2CO%2CP-R,15,0,positive,15
1142815213051413,NVIDIA AI,0,12,1,0,1,0,0,0,14,1,"Learn how Siemens Health is using their #photoncounting CT to help clinicians detect blockages, guide treatments, and assess challenging patients like never before! #GTC23 #medicalimaging #CTscan https://nvda.ws/3SsnUnz",2023-02-28T00:00:00,[],https://scontent.fcai19-7.fna.fbcdn.net/v/t39.30808-6/334329902_590827856240984_2051720556018086494_n.png?_nc_cat=106&ccb=1-7&_nc_sid=9267fe&_nc_ohc=R2iBqokBgqkAX8P7WAv&_nc_ht=scontent.fcai19-7.fna&oh=00_AfA-p8LsZfNtlFASqrznnoiMet2RwVcEbJL5VXHK4wK_aA&oe=64E3E12B,https://www.facebook.com/NVIDIAAI/photos/a.119492422050369/1142815213051413/?__cft__[0]=AZXUqunLDGOKLUkkF57ZN7VKb6SSteccgh2Q8zoNZ7_OYMV4zAEMi80NOSKpN7d_J5zeAetvmpyyBSuDAmOWSLqeXnAXzVIvuAAKN8q6EiS3uAkbD4ILKzjbUWIPCJiMUIWfhynFovLHzc8wpwhnY9oDmavQnTa9c44tW6rv3fuKK5JCOh1U-NS70MJbVFjNh7JCDs7iYUpQNQgzI9tm0mOl&__tn__=%2CO%2CP-R,14,0,positive,14
pfbid0HU8xn42yBqSJ465wReZuHnoCEvxL3LYUzMWTv2VEMn9c1JUEDtYtYQnPHVc36yvwl,NVIDIA AI,0,12,0,0,1,0,0,0,13,2,"At #GTC23, hear from enterprises that have successfully leveraged #NVIDIADGX Cloud and implemented a hybrid #AI infrastructure that unifies AI development across on-premises and cloud.Register for this #GTC session now: https://nvda.ws/3y06NAg",2023-02-28T00:00:00,[],https://scontent.fcai19-7.fna.fbcdn.net/v/t39.30808-6/334051987_5927654397329274_6251051611043944105_n.png?stp=dst-png_p526x296&_nc_cat=107&ccb=1-7&_nc_sid=9267fe&_nc_ohc=CzP0m7yLzdEAX_ySVWZ&_nc_ht=scontent.fcai19-7.fna&oh=00_AfDZYxmSS5Ga10aYf3grktZSYWuK43WHDx5tprwHX6e5WA&oe=64E4054E,https://www.facebook.com/NVIDIAAI/posts/pfbid0HU8xn42yBqSJ465wReZuHnoCEvxL3LYUzMWTv2VEMn9c1JUEDtYtYQnPHVc36yvwl?__cft__[0]=AZW28hDyde91vcODZ_qx20iw0waJo-eVKWLhKe2UabXLyJuvxFH2hm3jqF2Cznx_5jzEqXvSnQisFwOFd5JYgx_4aKtZIYGi0oyfUFsIKVZgxs5ROGHOfTxGltBpafWANpP-c4Wq5LiefTriaAsnLabJ9HGUsn3LOfbcSmrfzplGiYsW4VkCY9jBa-8ZKg5l48CdSb_a4YXMMmtRuBewuIL1pmw36_TfiXA2i-aDrdwveECeJu6CWbbQ4QUa0EFlh8Oci25er0UEgXUQ590qcH7b&__tn__=%2CO%2CP-R,13,0,positive,13
1142760559723545,NVIDIA AI,0,7,1,0,1,0,0,0,9,0,"Get training, insights, and access to experts on the latest in recommender systems at #GTC23. Register now. https://nvda.ws/3Sy1Hof #recsys",2023-02-28T00:00:00,[],https://scontent.fcai19-7.fna.fbcdn.net/v/t39.30808-6/334094308_156475810555140_5927721126828368039_n.png?stp=dst-png_p526x296&_nc_cat=106&ccb=1-7&_nc_sid=9267fe&_nc_ohc=RhID16ktoF0AX_O2Ji6&_nc_ht=scontent.fcai19-7.fna&oh=00_AfB88EyCdLilARSFnNB2C9mzw6PHW34kSNSblj-q1tcuuw&oe=64E2F5EA,https://www.facebook.com/NVIDIAAI/photos/a.119492422050369/1142760559723545/?__cft__[0]=AZU4Mo-pkre_sM2Rj7UjjaI3VDQusicDVX8w3ylw8qaiCn2LgdUW2APDsycM5bsrwvHXP6eMMAq2YaPiRWLUuIuXHuY4S6pH254SqyU423DC-YB9K3BSV_EdZUu8xI0oSSz2y2zEM0sjO1F0hMh_PCpcq78uCywVMM6e5DB3RMtc2ijWwvtvl1WxqOCozjIlwozZnLZkZtepviabeK8JLzds&__tn__=%2CO%2CP-R,9,0,positive,9
pfbid0523Kg1j8or2zYNcGXgnuwfNvPZkZaLMVoJb4dcvtUQ6kcJQRg43B23ym2jcoNNnLl,NVIDIA AI,0,6,0,0,1,0,0,0,7,1,Looking to purchase 5 or more seats at a Deep Learning Institute workshop at #GTC23? Take advantage of a special price of just $99 per seat (usually $149 per seat) and purchase a group package. https://nvda.ws/3JEKKpB,2023-02-28T00:00:00,[],https://external.fcai19-7.fna.fbcdn.net/emg1/v/t13/7861304584734618810?url=https%3A%2F%2Fprod2-sprcdn-assets.sprinklr.com%2F50276%2F513e2e89-5b83-4dd5-9359-4c8f97cd437e-644219421%2Fgtc23-spring-dlil-x4-drive-reg.png&fb_obo=1&utld=sprinklr.com&stp=c0.5000x0.5000f_dst-jpg_flffffff_p500x261_q75&ccb=13-1&oh=06_AbEPNAcoL66intWlZTtl1kKpTlyiDpOUM3DoU-gZcwIVOw&oe=64E074B9&_nc_sid=dbad39,https://www.facebook.com/NVIDIAAI/posts/pfbid0523Kg1j8or2zYNcGXgnuwfNvPZkZaLMVoJb4dcvtUQ6kcJQRg43B23ym2jcoNNnLl?__cft__[0]=AZXVaNQYLFebv0ncUBS0Ifcv6Ue1xrUb44HqqQQsq6dEL4zZK3dGtzgeJtQl09CV308W0tNqOtbOf1y0F8OoQg-Rlvk0gmey8tU3Y67dNgZhIvE1sE_xy5YaeeTdpD4P5gNhb9ZtThV0pe-QT3YILf1Y9ppr4zMau8xcv_V403vnE6dX6Yk6vd1uLy37IdaGnx9EfNa7OEWsrblJaJe5ZnAU&__tn__=%2CO%2CP-R,7,0,positive,7
pfbid02pdZgiyztGeMWwMiCyzEY3R2JfJRCVMNqdapeDvswKcVQVVjJgVehRzfJGj1AnjAwl,NVIDIA AI,0,11,2,0,1,0,0,0,14,0,"Choose from over 30 two-hour training labs at #GTC23 and learn about the latest breakthroughs with NVIDIA experts. Topics include data science, digital twins, edge computing, 3D workflows, and more. Register now for free: https://nvda.ws/3YICUzW",2023-02-27T00:00:00,[],https://external.fcai19-7.fna.fbcdn.net/emg1/v/t13/11087826754013560662?url=https%3A%2F%2Fprod2-sprcdn-assets.sprinklr.com%2F50276%2Facfffecf-3939-4c9f-b324-4a94374f8f01-1573538532%2Fgtc23-spring-dlil-x3-drive-reg.png&fb_obo=1&utld=sprinklr.com&stp=c0.5000x0.5000f_dst-jpg_flffffff_p500x261_q75&ccb=13-1&oh=06_AbGhTcu1BnM4SWFo_e-lHbbVTGG7vW1dCm5D-tDL57kgXA&oe=64E03FBA&_nc_sid=dbad39,https://www.facebook.com/NVIDIAAI/posts/pfbid02pdZgiyztGeMWwMiCyzEY3R2JfJRCVMNqdapeDvswKcVQVVjJgVehRzfJGj1AnjAwl?__cft__[0]=AZW8AZo8T6Iabf2fG9VHzpcdQQhEmZaBEljahVuClEs3ELE9mZbmouvDx99EusFCvT3LqdS6TBH_8AIFFbwnsrKI9lRuSimmktZDd2n_erNgt0fdoRlPck1jdtbD3qBcLX2_yK74saK-r4BqgTgKh9_5g1-ioITUBGmR-HfSN7Jmybcy3tgn53JNDE8onDqmlKGEb1U-WtebU_FJ4dp6dKtK&__tn__=%2CO%2CP-R,14,0,positive,14
1141754023157532,NVIDIA AI,0,10,1,0,1,0,0,0,12,1,Learn how LinkedIn is improving the quality of their #FeedRecommendations by using GNN model in the feed candidate selection and recommendation system. #GTC23 https://nvda.ws/3m3ctH4,2023-02-26T00:00:00,[],https://scontent.fcai19-7.fna.fbcdn.net/v/t39.30808-6/333690800_648519453703393_7766409215184684014_n.png?stp=dst-png_p180x540&_nc_cat=109&ccb=1-7&_nc_sid=9267fe&_nc_ohc=0Grzx06OE-UAX93ykt4&_nc_oc=AQmUViXPF4wBEoNnpo5hWAC1jVn1mu56ARyePkCcwNNinS9136d4Ps2Kj-rXiwMWOas&_nc_ht=scontent.fcai19-7.fna&oh=00_AfCtjJJGNITXRpWaMh40qshtZtuuygd72FcLeiBgHjAofA&oe=64E4971F,https://www.facebook.com/NVIDIAAI/photos/a.119492422050369/1141754023157532/?__cft__[0]=AZVhzTJ-gXvzhX31lsXuJT9O1hHCuFoGEFv1L0MOmIqsci0jrVgMO8xss0e4xCSmnPSMVGXbapZgv4drBRnwdWmf4sCJkqcTdnrWUyBDR7rTQmSLZIN43lX8aUM9If-gJ6gruD4XkaKZWoac5A25gfMyycOIGvmnTnbrdE_PuLwFiv7RyWXrbB8-XZRB42LClkTneq_8wwsQpSbsx1bP8Zm0&__tn__=%2CO%2CP-R,12,0,positive,12
1141729559826645,NVIDIA AI,0,21,0,0,0,0,0,0,21,4,"Join us at #GTC23 on March 23 to learn about RadImageGAN, a new #generativeAI for #radiology capable of generating 165 classes with various pathologies over 14 anatomical regions from CT/MR/ultrasound.  https://nvda.ws/3lURtC2",2023-02-26T00:00:00,[],https://scontent.fcai19-7.fna.fbcdn.net/v/t39.30808-6/333666833_595704755376535_6366301129730790766_n.png?stp=dst-png_p526x296&_nc_cat=108&ccb=1-7&_nc_sid=9267fe&_nc_ohc=RKy9Im7KSYMAX9XrIpu&_nc_ht=scontent.fcai19-7.fna&oh=00_AfAM_xEthXGn80A68xoYOoTbYSP7J9XzhQvDY0lunWQ-LQ&oe=64E37638,https://www.facebook.com/NVIDIAAI/photos/a.119492422050369/1141729559826645/?__cft__[0]=AZUTxwD6YL7Y8cgMPYL84_CZQbyMpdiW9tJWhnluc76Q5MmVp2ZtGUPoMdSDsqK9jgRLz0Dx4GgKYAJIzBImOvrn4vHkz4-uwW-4ucNTBZBe3tVBBR-ZuAM0ghe9fW4Mvm1ab2QULxrSJC6cn5aAbcO2fEPL1IHLSIa-Ij0g3s6z9ISBVJOf5Quwq-z0p5q73BdWV7x98CwkfZ47R3LGdzTY&__tn__=%2CO%2CP-R,21,0,positive,21
1141690366497231,NVIDIA AI,0,7,0,0,1,0,0,0,8,3,"Quants, or quantitative analysts, are using #AI for smarter securities trading. At #GTC23, hear how High Flyer developed a custom cluster optimization software suite, HFAI, to improve financial decision planning.Join the session on March 21 at 5 PM PT: https://nvda.ws/3m1lUqi",2023-02-26T00:00:00,[],https://scontent.fcai19-7.fna.fbcdn.net/v/t39.30808-6/333474233_522872276632727_2703396458896578040_n.png?stp=dst-png_p526x296&_nc_cat=101&ccb=1-7&_nc_sid=9267fe&_nc_ohc=MgL0ruK8ZJwAX-nKsmy&_nc_ht=scontent.fcai19-7.fna&oh=00_AfBI2RCG2Tq6B2XcjZm4kmX8cSSBvPam-0Srjp1nx3j4pQ&oe=64E49B47,https://www.facebook.com/NVIDIAAI/photos/a.119492422050369/1141690366497231/?__cft__[0]=AZXiowkvzsIhDLvfXqB17v18x9a-KDUwcljas0dBjB1xp35eVEQ3VKNpPw6lWuGTmXMQvZE4XZSER6hRUri06bzQqngsr0wAkG2u1PuLaC1lK8x9srjlf9EBj-Y6_6T4Rnwvog0zEz-AC5wyezCsoCkYN6ae7AMHYdpxwTfkNMaEuDaTeBMUrLQke4-95rkGiXAvXQaHZMvcnvK-VeQbcdeY&__tn__=%2CO%2CP-R,8,0,positive,8
1141152493217685,NVIDIA AI,0,25,3,0,0,0,0,0,28,2,"Deutsche Bank details their LLM journey and model training approach using Bert, FinFormer, GPT and T5, and strategy for model adaptation via fine-tuning and prompt learning using NeMo Megatron. Learn more in their #GTC23 session on March 23 at 9 AM PT: https://nvda.ws/3EWaCdN",2023-02-25T00:00:00,[],https://scontent.fcai19-7.fna.fbcdn.net/v/t39.30808-6/333442501_962524288079705_3880739450271554269_n.png?stp=dst-png_p526x296&_nc_cat=102&ccb=1-7&_nc_sid=9267fe&_nc_ohc=ZpwQAvc_y3oAX8PvPDX&_nc_ht=scontent.fcai19-7.fna&oh=00_AfBtvexU4kC4reEi2aqkAOFq40e3jIcQEutJBuhx6_vd3g&oe=64E39915,https://www.facebook.com/NVIDIAAI/photos/a.119492422050369/1141152493217685/?__cft__[0]=AZVx42GokGMsIuIZFT06ODsynsOT_NmfJBFGoHUMr1zqIJrAWHmRL_4GiL8rfnfVv1qWOlNCwH98mOBK2FZxLJvlebSfTAyXFcRRlL_MmU3KjyEcRJSMTmzO4E93J-k51mFk7nmYoMvkSVFiigkdCwqrK031qwJFTkN3BSn1_5zCpRILdZkLSGBiW0993BQRb7x1hajshKrGLEWEBII7bz33&__tn__=%2CO%2CP-R,28,0,positive,28
1140749673257967,NVIDIA AI,0,8,1,0,1,0,0,0,10,0,Intuit is scaling #AI across every business unit to create more personalized experiences and deliver value to its customers. Join #GTC23 to get the details on their strategic focus from Intuit's SVP and Chief Data Officer.Register for the session on March 22 at 6 AM PT: https://nvda.ws/3IMlsFj,2023-02-25T00:00:00,[],https://scontent.fcai19-7.fna.fbcdn.net/v/t39.30808-6/332856006_625765296028917_4619477729040997832_n.png?stp=dst-png_p526x296&_nc_cat=108&ccb=1-7&_nc_sid=9267fe&_nc_ohc=9qL8yQiforUAX_jPRVv&_nc_ht=scontent.fcai19-7.fna&oh=00_AfBHg2Gccd6XGvltWqPeheUzVZvr2HaSwWPbbo0GozLhOg&oe=64E36FBF,https://www.facebook.com/NVIDIAAI/photos/a.119492422050369/1140749673257967/?__cft__[0]=AZWt5XjSg8ZaTzDaCqPb8Cq2cZqTvIdYSMCs3bTomZGZIPv3nnXQceaguth6lBVd3YdwCnZdNSK9Lypp-tCucm0g3KDaXLURhCnOI-3I2ljwLRB0nw4WThzbzX5Ezn4t9IdaghCe_9MXNQLWxw1JyozCzaFSXwOhMeMBN4l_z3lX6o_MgB4vS3pe-TtPi0kls360g4yF3YNcEIk-nnCHUv0r&__tn__=%2CO%2CP-R,10,0,positive,10
pfbid0Be8ezo8VtDhQzGvzdEgccwB57ZsvrgdHjVgWtY2gEVRuPWAzscto6RVQJkXhLCyDl,NVIDIA AI,0,18,2,0,0,0,0,0,20,3,Improve your #cybersecurity posture and detect threats faster with #AI. https://nvda.ws/3IAL0UO,2023-02-24T00:00:00,[],https://external.fcai19-7.fna.fbcdn.net/emg1/v/t13/8035559198060484848?url=https%3A%2F%2Fimages.nvidia.com%2Fnvimages%2Fgtc%2Fagenda%2F2023%2Fcybersecurity%2Fgtc23-spring-web-rf-target-agenda-og-cybersecurity.jpg&fb_obo=1&utld=nvidia.com&stp=c0.5000x0.5000f_dst-jpg_flffffff_p500x261_q75&ccb=13-1&oh=06_AbGUjzaLxuPXfZ24o_D_PFJdJD23CoVJMNHrCqK9I8nshA&oe=64E0AC2B&_nc_sid=dbad39,https://www.facebook.com/NVIDIAAI/posts/pfbid0Be8ezo8VtDhQzGvzdEgccwB57ZsvrgdHjVgWtY2gEVRuPWAzscto6RVQJkXhLCyDl?__cft__[0]=AZVNqE4QUT9mhnFkD1IWK6G2ifkjAD4wytkGNy5goMke0hN_wA-j3hdap2XTHKSP2i4tbejQy_D24N-ljTcV1Y-F826FFVrdxEEucrHSQnpkxBPB1sgRC-dQhgi75NM4_dNRC5Vm756RoheaIUUf_G_N_ihfjlv5emY5P-Q6EnAPa9-3Pcbk7Ig9KJIqajqGLKQtvSrTtVu9TxGgEMvm3iUb&__tn__=%2CO%2CP-R,20,0,positive,20
1140666926599575,NVIDIA AI,0,9,0,1,1,0,0,0,11,2,"Open Climate Fix, a member of #NVIDIAInception, built transformer-based #AI models trained on terabytes of satellite data to improve #solarenergy generation predictions by 3x.Learn how the nonprofit is helping decarbonize the UK's electric grid: https://nvda.ws/3IADOIi",2023-02-24T00:00:00,[],https://scontent.fcai19-7.fna.fbcdn.net/v/t39.30808-6/332860244_1261233177797264_2103926764852932844_n.jpg?stp=dst-jpg_s960x960&_nc_cat=109&ccb=1-7&_nc_sid=9267fe&_nc_ohc=67JwaK8P--sAX9Udb5p&_nc_ht=scontent.fcai19-7.fna&oh=00_AfAHKJhV8X6eELBmiJimfPz3NfRktPgUhkc8w8J_XItLhA&oe=64E4AC1A,https://www.facebook.com/NVIDIAAI/photos/a.119492422050369/1140666926599575/?__cft__[0]=AZWcOOZasUQ80zpUx3PVwu1L1uVaTZvN3DRFCYUMYb8vQBqqhjlvPffeBetO3TJIxlxCA88hXASibLhJXEsjgjtHQzBeCOGPU6ghgT1ic5KinS_YHIkKU4QnQbb9kZ_AeOuzKlF1kHwtLI2Co2enGUJEvW2Iud-v1XJQrgDtoz9rFSUjFrPvbEn9Fs3ygpewSIo4r2sCPsw_pvUBNAMBup3J&__tn__=%2CO%2CP-R,11,0,positive,11
1140612456605022,NVIDIA AI,0,20,0,0,0,0,0,0,20,4,Explore free downloadable teaching materials for educators that will empower the next generation of innovators with critical computing skills. Join NVIDIA’s higher education leadership and instructors to learn more about the DLI Teaching Kit program at #GTC23! https://nvda.ws/3IKE6xh,2023-02-24T00:00:00,[],https://scontent.fcai19-7.fna.fbcdn.net/v/t39.30808-6/333227744_574104571316440_6821324084275784245_n.jpg?stp=dst-jpg_s960x960&_nc_cat=103&ccb=1-7&_nc_sid=9267fe&_nc_ohc=kjTmDCkDXcsAX8_jgNX&_nc_ht=scontent.fcai19-7.fna&oh=00_AfDRpoVLMBO9NgwiI_FG9JZ0Prxd1ijsX2u-CtRrI-NgQg&oe=64E2BAE0,https://www.facebook.com/NVIDIAAI/photos/a.119492422050369/1140612456605022/?__cft__[0]=AZXkEKLbYmDUHVQMRYi5GElSu_Wh6RNQDV-5p_vMW5q_E5kcorjOYgTANsPp7xrcy5J9Eh9aMWencYHuG3ixb3NxFhmpmSTHHUy5e1YgeXToVvDTJb6ZDtwmKWtvyc4M7scoSDTVo4hYY6gf-tq6bYNODrtDYXqNpUtZ_y4zR1LxeDlU1MYotKPWBbxDaX2CrZTxbbm2zPivCDdFkLTrkBQo&__tn__=%2CO%2CP-R,20,0,positive,20
1140268649972736,NVIDIA AI,0,13,1,0,1,0,0,0,15,2,"How are large language models (#LLMs) unlocking new opportunities in quant #finance? Learn more from HPE and Ioana Boier, Senior Principal Solutions Architect, Applied Research - Financial Services at NVIDIA at #QuantStrats on March 14 at 10:15 AM: https://nvda.ws/3lSTLSa",2023-02-24T00:00:00,[],https://scontent.fcai19-7.fna.fbcdn.net/v/t39.30808-6/332921000_5922012461187307_6822567864124559825_n.png?stp=dst-png_s960x960&_nc_cat=101&ccb=1-7&_nc_sid=9267fe&_nc_ohc=inM9sebKziYAX8uykiB&_nc_ht=scontent.fcai19-7.fna&oh=00_AfAsNA5Hil6Nae6J0un8ohjY7Cb-p-qp4sr3-RkiKG5ONw&oe=64E3A790,https://www.facebook.com/NVIDIAAI/photos/a.119492422050369/1140268649972736/?__cft__[0]=AZV_rYh_VNh63NfXEsAzXShj1cqGFKVK2faQRXlEsUEyDpwzzBfRWTYkSLhhb-Ojp-3sLt3H4kltT2RebqI6i2pDOjPb_qXhfc1EaASBv4cUCMq5u0yEW2bOQhJnYui3TztzdVw2Os2QLYXLZ4_kpgwz6aFr1Kss2bfLHmP1eR9OPtNXjdoZMyP18WVrT68fbJ5VRp1KrqdDwOxcOvr4MlmR&__tn__=%2CO%2CP-R,15,0,positive,15
pfbid05autTnGCQSg4K2vQYqpymuKvEqrFM4jfRzGRM1LGFmAXBaCnZQEhRD8vdC3uZCa4l,NVIDIA AI,0,7,0,0,1,0,0,0,8,1,"Learn how to build and deploy sophisticated #cloudnative vision AI applications using #syntheticdata generation with NVIDIA Isaac Sim, transfer learning with #NVIDIATAO, and pre-built microservices from #NVIDIAMetropolis. Register now > https://nvda.ws/3YZkieT #GTC23",2023-02-23T00:00:00,['blob:https://www.facebook.com/13349d20-5b88-42ad-a6db-169f5a3eeaf5'],https://scontent.fcai19-7.fna.fbcdn.net/v/t15.5256-10/333109231_1709283446141054_3516625634167009302_n.jpg?stp=dst-jpg_p960x960&_nc_cat=103&ccb=1-7&_nc_sid=ad6a45&_nc_ohc=804TxhW3yacAX9UWplG&_nc_ht=scontent.fcai19-7.fna&oh=00_AfDtixrwNwMbnvOeWXRQoWvp4asIa1YBhl14KOsu3giWPg&oe=64E3F42F,https://www.facebook.com/NVIDIAAI/posts/pfbid05autTnGCQSg4K2vQYqpymuKvEqrFM4jfRzGRM1LGFmAXBaCnZQEhRD8vdC3uZCa4l?__cft__[0]=AZURqNVerhw4Af7WluzQD-Os2cCSkG6N0tLbTorLr3_V48-djk9ptSIPJ7FSfg0iU_HBtQ1bdAz9MQgD73LbRi_QlcFeuuW1GOBcg2uNZdr2NxMtDoB42K-0FqyH1Hklovnu0yOXfoC_970VaY2ATBTr8_tqokn2aLCMc8jUduIGIWtervIH87iSyqD308XF5rhPjwnZNLyfIvUx2dhT-V6QnqbU_5C4aKn-ec5D3sXLAVaXol56S7jlgF7V_nx_m5M&__tn__=%2CO%2CP-R,8,0,positive,8
1140177329981868,NVIDIA AI,0,12,0,0,1,0,0,0,13,0,Learn about the exciting potential of #machinelearning in #proteinengineering from Microsoft using pre-trained models for predicting protein function and generating functional protein sequences. https://nvda.ws/3SmX4NO,2023-02-23T00:00:00,[],https://scontent.fcai19-7.fna.fbcdn.net/v/t39.30808-6/333042271_1570567316779643_499021732944978582_n.png?stp=dst-png_p526x296&_nc_cat=107&ccb=1-7&_nc_sid=9267fe&_nc_ohc=vpokwqFscQgAX_H2CxR&_nc_ht=scontent.fcai19-7.fna&oh=00_AfDghzC96vjlpsF-ScmC9rTZNlh7N8wdleBqltZ0iEtD7Q&oe=64E321B0,https://www.facebook.com/NVIDIAAI/photos/a.119492422050369/1140177329981868/?__cft__[0]=AZXXUkYXi2XdgTlU_FotpTJKHjQnahsBb1MLiR5wOdKx0uYG94CEG9vX8IiQjM2Hdh7kn_AK-_h_c71jiNL9fE1TKVtfblhAQjQ4IUYaXQk43LPF4BYoiqA_7FP5j1YjxI_kZz-a61qFEvw29Al5_PQFc7dWOR-d8p3xTilp-Zu1K2pENaik5APxuRB6wh-btvhwf2_FUgkCMKuC7TIKdEhV&__tn__=%2CO%2CP-R,13,0,positive,13
1140148196651448,NVIDIA AI,0,7,2,0,1,0,0,0,10,1,Join us at #GTC23 to learn how some customers standardize and streamline #inference without losing model performance to achieve the key performance indicators they've set for their businesses. Register now: https://nvda.ws/3IpFuE7,2023-02-23T00:00:00,[],https://scontent.fcai19-7.fna.fbcdn.net/v/t39.30808-6/333048874_586341826429311_4319859675982627923_n.png?stp=dst-png_p526x296&_nc_cat=101&ccb=1-7&_nc_sid=9267fe&_nc_ohc=EVULAQOYYtgAX9X5udc&_nc_ht=scontent.fcai19-7.fna&oh=00_AfCP10fNUueRVbFAn1IhnGVHQNES-REqQFmXuO89ynx1yw&oe=64E33243,https://www.facebook.com/NVIDIAAI/photos/a.119492422050369/1140148196651448/?__cft__[0]=AZVnjIOQhoVl-ZzbSpPM7KhEOKPcYh_6EzFvDY69KVonI1pG9Z2llXleg_F50JIxa_CzzWuTL17xBE0xBF-AeGneSQ6DCbto4vXWOOYDvP1kP1H3cV6505m1Zv4dTk6Dv2aMWRhRSw-0nK4d6SlcEtCQRMVhVihfl7hl6Tw06C5qd-OC1U-uCwrc51wjxWVIdAWVoH0ET23lMHRqmYV03Tub&__tn__=%2CO%2CP-R,10,0,positive,10
pfbid02gZAMsjwWVWLPoPrgTALDy51VLT4CnwqZSSB25D1UcsqsAPjqs1ZGKC1jxakpnxSTl,NVIDIA AI,0,23,3,0,0,0,0,0,26,1,"Handling an ""it works on my machine"" problem? Avoid the need to reproduce environments or install dependencies with tox. Try sample code in this how-to blog: https://nvda.ws/3KqX9y3",2023-02-23T00:00:00,[],https://external.fcai19-7.fna.fbcdn.net/emg1/v/t13/18348518208451223571?url=https%3A%2F%2Fdeveloper-blogs.nvidia.com%2Fwp-content%2Fuploads%2F2023%2F02%2Fcomputer-screen-with-code.jpg&fb_obo=1&utld=nvidia.com&stp=c0.5000x0.5000f_dst-jpg_flffffff_p500x261_q75&ccb=13-1&oh=06_AbG2TozQk0dM67Aaw8Y931h1xwkYOGi7CNy9i4tq7NJWUg&oe=64E032FE&_nc_sid=dbad39,https://www.facebook.com/NVIDIAAI/posts/pfbid02gZAMsjwWVWLPoPrgTALDy51VLT4CnwqZSSB25D1UcsqsAPjqs1ZGKC1jxakpnxSTl?__cft__[0]=AZWPz2uXQxELVZEocsmxnidxRV1he735NinCStvODiUIKgV67gq2cIWl0ICrZZoOoFQlna3ehQ3kQ779Z9jwDljU7205qFp0kQ3RVvsXRmlqOjx_wdX7nfGYjgSy4chl1C0dIeEoMxcl9gntLp_PKMOaccZmz5hvzYVQMBWv-DR0BXd6xzmf6VcWz-mINEuYOMzWowXL0x5IGLfNeWCYRqIQ&__tn__=%2CO%2CP-R,26,0,positive,26
pfbid02wX492LpUFPXGGsDWNKvGvZn25fr8733rfbkBFbSyUnHk6ZnTvnFXYAUt7qv1nYwml,NVIDIA AI,0,14,2,0,1,0,0,0,17,0,"Are you ready to take your AI development to the next level? #NVIDIATAO provides new #visiontransformer models to revolutionize your #AI development. Join the talk ""AI Models Made Simple Using TAO""  to learn more about the groundbreaking features of TAO at #GTC23 > https://nvda.ws/3YK70U2",2023-02-23T00:00:00,['blob:https://www.facebook.com/9b737180-2989-486a-abd2-aaf1fe60ba6f'],https://scontent.fcai19-7.fna.fbcdn.net/v/t15.5256-10/331373504_510378871253266_2503250343739101815_n.jpg?stp=dst-jpg_p960x960&_nc_cat=106&ccb=1-7&_nc_sid=ad6a45&_nc_ohc=kOJ8Ja-qWCUAX8WFehK&_nc_ht=scontent.fcai19-7.fna&oh=00_AfB8viqaXiwcg-M_3E2uivR1OpOVM7THtUJpejtiOJjmow&oe=64E33344,https://www.facebook.com/NVIDIAAI/posts/pfbid02wX492LpUFPXGGsDWNKvGvZn25fr8733rfbkBFbSyUnHk6ZnTvnFXYAUt7qv1nYwml?__cft__[0]=AZWC7C5g4cS6MqCUoSVsttsoLyr3YJY4X9E_pCDisKesK0TebYMxra9fgUj0MUUJklkJLMubcZxc8CaTC9gsKtCDROhErbtxSpBUMnsIJp2BHzVsBxoeIa-myLgatXAhlk-AYyy7pTFo7UZAm3YwnWGQ_8vmxsrC3fJ6rMP8T6K7AcXk8d_0tVPxLbIj3bsdevYm_jPirKA2HfpA1reXibJfnfI7wEnk_4fhpWDuqbDOu5eAcmZPXSuFinpWBDqYQr4&__tn__=%2CO%2CP-R,17,0,positive,17
1139553906710877,NVIDIA AI,0,16,4,0,0,0,0,0,20,1,"AI helps protect endangered species from wildlife crime.  Learn how Wildlife Protection Solutions (WPS) uses AI technology for the conservation of endangered species and ecosystems, recognize threats, and aid anti-poaching. Read the #HPCwire article: https://nvda.ws/3YRDZG3 #MakeAIYourReality #NVIDIAonAzure",2023-02-22T00:00:00,[],https://scontent.fcai19-7.fna.fbcdn.net/v/t39.30808-6/333017877_2600738780091929_6762727433100570209_n.jpg?stp=dst-jpg_p180x540&_nc_cat=110&ccb=1-7&_nc_sid=9267fe&_nc_ohc=C2zB0gLjeRoAX8d9hRY&_nc_ht=scontent.fcai19-7.fna&oh=00_AfBA90dyufClErhUePfZmbx3mTCQpXL_7-hdVdnKoWmdPA&oe=64E3C6DC,https://www.facebook.com/NVIDIAAI/photos/a.119492422050369/1139553906710877/?__cft__[0]=AZXHUHpjpn1H9xMoCKAmrPqC28rrYRTypjPCKV6O004U6C4pY1JSuO-0Xihg_saOjQzEpXYXvgtm5dlvY-pb6wrQ81xpOJOAPTWJaMmzTW1YoSDupWEuZAFLbGOOxe1yiN8a9pLHHG_sRKscgAi-QYQmkNZB_HusbyDyfTo_NF_VLjhh7Buf7Ep6-IluuZ1nvmvA5sZ5xe8e7GZfJTCF5iZD&__tn__=%2CO%2CP-R,20,0,positive,20
1139484560051145,NVIDIA AI,0,7,0,0,1,0,0,0,8,1,"The National Science Foundation is leading an effort to create a national network of #AI research centers by facilitating partnerships between government agencies, academic institutions, and industry leaders. Hear from experts about the model example of such a partnership - the University of Florida and NVIDIA. #GTC23 https://nvda.ws/3Kt1AIL",2023-02-22T00:00:00,[],https://scontent.fcai19-7.fna.fbcdn.net/v/t39.30808-6/332625664_760116485195979_8406523066683682474_n.png?stp=dst-png_p180x540&_nc_cat=109&ccb=1-7&_nc_sid=9267fe&_nc_ohc=Z1M70zobbSEAX_Rt-7j&_nc_ht=scontent.fcai19-7.fna&oh=00_AfBD80G6iH0Br_m7pZR156wwyYWPPQxnxPDcr2iDy82cqQ&oe=64E44AEC,https://www.facebook.com/NVIDIAAI/photos/a.119492422050369/1139484560051145/?__cft__[0]=AZUdlTF8szxjmQUlaeoABAE0b6N2911dtzYR32x6Aq8vt-m1anzPWIDVZZe0YlIaoJkE9Kfq3I8foU4NpxXu8l787vJuNb9sqNJ3u23dQufuipLgje9R-pQiSh14n60Kq1QtDNC9Rs1V1-Sf1XDo1N7MZVPyczmre2sZCe4Yo5XUFRLw_EwQNs8Q-jexEZoEVpxjdouWagTjJxVX9l5fDPmB&__tn__=%2CO%2CP-R,8,0,positive,8
1139077996758468,NVIDIA AI,0,13,1,0,1,0,0,0,15,2,"Tomorrow at 8 AM PT, learn how financial exchanges, hedge funds, and data providers can accelerate market data analysis with converged accelerator hardware and software from NVIDIA. Register now for the free webinar: https://nvda.ws/3Ksio2f",2023-02-22T00:00:00,[],https://scontent.fcai19-7.fna.fbcdn.net/v/t39.30808-6/332225371_5991373420901020_3716886825765045974_n.jpg?stp=dst-jpg_p526x296&_nc_cat=104&ccb=1-7&_nc_sid=9267fe&_nc_ohc=1l2iKQyUZMwAX-cUTe8&_nc_ht=scontent.fcai19-7.fna&oh=00_AfC0cb_cn01oIRsgQGzgN9BJCZ3l_833x_5FWOSaW4QsPA&oe=64E3C504,https://www.facebook.com/NVIDIAAI/photos/a.119492422050369/1139077996758468/?__cft__[0]=AZXy-KgwmzWQjr1_Sn3kwkkmg_S2i6lHBMgN2o4b1pjZN2EMEPhlcyE3OjkwhJJ3j5owLi0lHbpk_DOr-nclvd3XLE7mBu6ktvL1lBjWKuUdM6ABQNNTL0XrgCgPO-M5sHmDjK7piK2jvaRNIcFMzhiNYBO1wfRJAmOZKcrhvcfEKRSNISpHU6PwmS6fUINlcmHJ5hDjZS3yDFcZVZAgK9ao&__tn__=%2CO%2CP-R,15,0,positive,15
1139037963429138,NVIDIA AI,0,21,0,0,0,0,0,0,21,1,"Join us for a news-packed keynote from our founder and CEO Jensen Huang, and sessions covering the latest advancements in #generativeAI, large language models, the #metaverse, robotics, and more. #GTC23 March 20-23. Learn more: https://nvda.ws/3IlwcZY",2023-02-21T00:00:00,[],https://scontent.fcai19-7.fna.fbcdn.net/v/t39.30808-6/332417672_1318328885613549_2045282647614732011_n.jpg?stp=dst-jpg_s960x960&_nc_cat=102&ccb=1-7&_nc_sid=9267fe&_nc_ohc=j7txde70YTgAX-FrI6a&_nc_ht=scontent.fcai19-7.fna&oh=00_AfChXiwoWdRPRKY1gfXUQm5zDZAPtcJW09WtFSJVVeskww&oe=64E315C8,https://www.facebook.com/NVIDIAAI/photos/a.119492422050369/1139037963429138/?__cft__[0]=AZXOgpYyB1WOoKd3cbKGAzv06g-Wq6QXI5diHvqb1VzbXgrzZjC5KjgUy79pUqnsbW8OiniUonPCJHOW8WuTH_gBe1cWHNWLGsNpQ3RBmvVfdREaNxhUzlZI8qD8Poe56aVap6nQ62C6Dh_tYoPRxluKyYBkvVpsZybuFpIwKnQC41gncvZLn1iJf6Cww2an4UT6Oz0Ot_Kzd3Tn3csomxuO&__tn__=%2CO%2CP-R,21,0,positive,21
pfbid0Uo34us8FVURXQDUdrCs1zMw6FEoSdtSEt4VsxQVAgv6b3eWBaAMhSgZKqdSLCp1Al,NVIDIA AI,0,16,2,0,1,0,0,0,19,2,Last but not least: deploy your ML model into production. Learn 3 ways to deploy a web service in Google Cloud in the newest ML in Practice blog series: https://nvda.ws/3K4yMpu,2023-02-21T00:00:00,[],https://external.fcai19-7.fna.fbcdn.net/emg1/v/t13/2894335532805161185?url=https%3A%2F%2Fdeveloper-blogs.nvidia.com%2Fwp-content%2Fuploads%2F2023%2F02%2Fmachine-learning-in-practice-option3.jpg&fb_obo=1&utld=nvidia.com&stp=c0.5000x0.5000f_dst-jpg_flffffff_p500x261_q75&ccb=13-1&oh=06_AbFKF88Ic9Ey96ySVrKlToNDfRw5bK9A7tc5FbH5GZCang&oe=64E050B2&_nc_sid=dbad39,https://www.facebook.com/NVIDIAAI/posts/pfbid0Uo34us8FVURXQDUdrCs1zMw6FEoSdtSEt4VsxQVAgv6b3eWBaAMhSgZKqdSLCp1Al?__cft__[0]=AZV1MPsMpvzfjkpOZk4e8YwUJG6XHuSd-FxZi4H5EV6Kruu2kA2t9T4EkfW-VLoZRNkVaWNRhXyAl3hF0SRJ0dqAtTGxSmL2GR3tWPADOsFxRUtNFgBvQJz22qUoOwBW8-hNqCzyE-ENUdwz5B7S2gpBwh6N4T-0Fv1MpQo4AASwUbxezDGD2TCVHAL1xUUijIpIGHjdr9ZlGk0HFV2Ikczt&__tn__=%2CO%2CP-R,19,0,positive,19
pfbid0ext1SUT1cWjg25LstAheH4F8wqs6hzEV7adTcm8GZW9P9mksGC8mY4wKi8D4zBk5l,NVIDIA AI,0,5,0,0,1,0,0,0,6,0,"Join this special interactive session at #GTC23 designed for business leaders who recognize the importance of #AI and want a better understanding of terminology, concepts, and benefits. No technical knowledge or practical experience utilizing AI is required. Register now: https://nvda.ws/3S0UvRk",2023-02-21T00:00:00,[],https://external.fcai19-7.fna.fbcdn.net/emg1/v/t13/4944133298062637411?url=https%3A%2F%2Fblogs.nvidia.com%2Fwp-content%2Fuploads%2F2021%2F04%2Fgtc21-inception-corp2-1280x680-1.jpg&fb_obo=1&utld=nvidia.com&stp=c0.5000x0.5000f_dst-jpg_flffffff_p500x261_q75&ccb=13-1&oh=06_AbEAan7SjIUCFpT-5WMGRjdqdvboD5NqFZbroujuzkOHBg&oe=64E06662&_nc_sid=dbad39,https://www.facebook.com/NVIDIAAI/posts/pfbid0ext1SUT1cWjg25LstAheH4F8wqs6hzEV7adTcm8GZW9P9mksGC8mY4wKi8D4zBk5l?__cft__[0]=AZV9wf-mIto5wVsFxUj_2SSjDMJefTmFL_Uqyd5guyqJo6toC_Lm6UcDdFP3OKo8crZq0825H42QjguWrbtNpCOD1BIjSRxq2o1nA9ilBWSHUc8mOg2SvtzvZmxhN6_mtDzqIZ8QLgYRA0bhMSx9vryCUXrvYIVoI-aMylepYopVy34IVdHDSEgnBtMX9KOKX4V2ytNCLeAg9uaSJrWF_d2y&__tn__=%2CO%2CP-R,6,0,positive,6
1138924846773783,NVIDIA AI,0,15,0,0,1,0,0,0,16,0,"Join our data science sessions at #GTC23 to learn about the recent advances in accelerated #datascience, how you can now take the advantage of GPUs to enable near real-time optimization, apply Kaggle's winning models to real-world applications, and much more. Register now: https://nvda.ws/3HBlu0V",2023-02-21T00:00:00,[],https://scontent.fcai19-7.fna.fbcdn.net/v/t39.30808-6/332681787_572214311607179_6302137117675751882_n.png?stp=dst-png_p526x296&_nc_cat=108&ccb=1-7&_nc_sid=9267fe&_nc_ohc=jpZjtL9qBAkAX89IVLc&_nc_ht=scontent.fcai19-7.fna&oh=00_AfCk20ujREp8I0PXtTlQy4wiXVdPtVcDKurv2gxipuiB-Q&oe=64E30ACF,https://www.facebook.com/NVIDIAAI/photos/a.119492422050369/1138924846773783/?__cft__[0]=AZVF5fiR9vjMKsS2xdJUJEkHZAd2QC42xzxW_O-oS0JFDq1faPIbRWB_YL_BJB1tZ-zohli9rknVoWOdkXdj1CCBtGsl-IvUmoOG-3uWQRDirW8gY0MaG_mMj3QfWPtjJ5AVs64Jf-kCdayanX-5ZpE2j6RdqySHhU5_NZ7CWXIFo_LHGeqLTNoiJuY62wvsJFp6qzT-qo2SIEVY8RCv53lA&__tn__=%2CO%2CP-R,16,0,positive,16
pfbid02ZK95cHEHz5fgmh1Ak6HHUhjZRgf4vzUVuq6PngK3gNQMnQAp3aB7TdpzCyU2sBRbl,NVIDIA AI,0,11,1,0,2,0,0,0,14,0,"Discover key technologies, frameworks, and services for #Startups at #GTC23. Learn about the performance, cost, and scalability benefits of using NVIDIA SDKs for accelerating #generativeAI with NVIDIA technologies. Join us: https://nvda.ws/3HtDF8M #NVIDIAInception",2023-02-19T00:00:00,[],https://external.fcai19-7.fna.fbcdn.net/emg1/v/t13/10738112739460356581?url=https%3A%2F%2Fprod2-sprcdn-assets.sprinklr.com%2F50276%2F28b1cf95-0dc1-4e35-9975-b6362c25e1a6-1961394753%2F2623389-gtc23-spring-social-in.png&fb_obo=1&utld=sprinklr.com&stp=c0.5000x0.5000f_dst-jpg_flffffff_p500x261_q75&ccb=13-1&oh=06_AbFGBG0lryejkNM7HZ-wnTW9h6tOVk5jZ6cO251DevlJGA&oe=64E02E41&_nc_sid=dbad39,https://www.facebook.com/NVIDIAAI/posts/pfbid02ZK95cHEHz5fgmh1Ak6HHUhjZRgf4vzUVuq6PngK3gNQMnQAp3aB7TdpzCyU2sBRbl?__cft__[0]=AZX997-RyHj5KnV2j6S8r87Wooj7SBnT0ZptDO2u6GlZaFaEfH3qwG-gf4UGCHqUe_3DM5_VxXMgCpVJgvW_U1aPfSYtL8b3qefWX0dIFfRcwBaAcuBFUnP5B63ut9eMobRAEWEygLWb3_rsNDB7ngcihUvIWoyZwwSdqlMy2nGiuCk1aC8FR3MQmSb5Hxn8t1fr0SSSxTp97ENwRjjcnwwr&__tn__=%2CO%2CP-R,14,0,positive,14
1136440370355564,NVIDIA AI,0,10,0,0,1,0,0,0,11,0,Leading #retailers are leveraging #AI to deliver better shopping experiences—both in stores and online. Learn about the most important AI use cases in retail today at #GTC23. https://nvda.ws/3lNXOz5,2023-02-17T00:00:00,[],https://scontent.fcai19-7.fna.fbcdn.net/v/t39.30808-6/331280017_520274516854286_7016832886059922616_n.png?stp=dst-png_p180x540&_nc_cat=111&ccb=1-7&_nc_sid=9267fe&_nc_ohc=5TlqMtAeSnAAX8cb0f5&_nc_ht=scontent.fcai19-7.fna&oh=00_AfABSLkcLjSqb4V9trKji6A6iwF9_nwAVlrZaA0UyYs_sA&oe=64E40181,https://www.facebook.com/NVIDIAAI/photos/a.119492422050369/1136440370355564/?__cft__[0]=AZU2d0peFt3eSWGecLIOMoKgHfNntKbn4R0n16C_DnUYUfFFq9PP1ixXndpbKRosq79-e30E-fa17zX-SEycqXTjur6Vd6wAaXf66w3CrZp8zTxUt3xCkH0digjdcf689bzk2jJkq_UN4Mzg21opSQucGcEmXldr7bn-zN9obHeC35qLwIzPbZxAJAHEhDPbjYDkTgC2T3LqLwH3uYz-2UEB&__tn__=%2CO%2CP-R,11,0,positive,11
pfbid0M7MFgn3zp8RF6XxdaBJPMLiWQnrKnuh2c4vjS9mTXBw8BGLU3E571URATHZrdjD2l,NVIDIA AI,0,17,0,0,1,0,0,0,18,3,"#OCI architects and engineers are always collaborating and innovating to solve tough customer issues in the cloud. Learn how they designed the new ""Superclusters"" to support thousands of GPUs with ultra-high performance. https://social.ora.cl/61813oMfB",2023-02-17T00:00:00,[],https://scontent.fcai19-7.fna.fbcdn.net/v/t39.30808-6/330417939_738995657848497_7335713197113256521_n.png?stp=dst-png_s960x960&_nc_cat=101&ccb=1-7&_nc_sid=9267fe&_nc_ohc=of1mAmgTliwAX-Q6tuq&_nc_ht=scontent.fcai19-7.fna&oh=00_AfCekP7t4JqpdUTD-s-IPWmEV9IPi0uA9le0Jq1xAf800g&oe=64E44460,https://www.facebook.com/NVIDIAAI/posts/pfbid0M7MFgn3zp8RF6XxdaBJPMLiWQnrKnuh2c4vjS9mTXBw8BGLU3E571URATHZrdjD2l?__cft__[0]=AZWgTmoktTf1Ef7SpgLCTTJqIrM64rvKQs2DwoNGNziH8FGKlXrQmI8zGsTF_GkCaIM4tSj_gXA2gJ5nXVPnnvm-Ad2DToenXSnk8QRZuuxFhGc8ulQ3Vd-wM3EnX8CA9Ml6SaaM3FOeEMD4STjLrpsPd__VjN4b6KEKf-CJh5gAzB0OQrtDIKKbCvxBCUKBcnLjJkWeTsd_VtEv-73apDRPTEiETRB9PLAoyqMarkZxgNL_p00a9LEBF4CIoK3fbWF6cDtQfcz9TLvwxD0lH3F-&__tn__=%2CO%2CP-R,18,0,positive,18
1135879327078335,NVIDIA AI,0,18,0,0,1,0,0,0,19,1,Discover how D-ID is leveraging #GenerativeAI to build livestreaming solutions for talking digital humans at #GTC23.https://nvda.ws/3wP5q6X,2023-02-16T00:00:00,[],https://scontent.fcai19-7.fna.fbcdn.net/v/t39.30808-6/331279998_584426713586234_4540923727316760811_n.png?stp=dst-png_p526x296&_nc_cat=110&ccb=1-7&_nc_sid=9267fe&_nc_ohc=z1I1k27V3_MAX8gBbO3&_nc_ht=scontent.fcai19-7.fna&oh=00_AfAuJJwTOCFvELU63wESvWvd99gwCLtqNFR1JztP5b9vDw&oe=64E39455,https://www.facebook.com/NVIDIAAI/photos/a.119492422050369/1135879327078335/?__cft__[0]=AZXqHRzSv3q-apP10W5K3WX2zvr1wo4V-wTbchhtWgKfvUUBdfqJcFhbMSjfT66es0sfeYGTYpTzhc5Zvz4oZOdOkRMr3fcXq8jWN7G9ewkteSLC4j8J7oXMvJyM56lY2IqbUC3WdR2K2-s4bNjc7iSY1jcseqaWgWArgL1Bk1S_22MQDCnFB4FsVxLUFksMUHuo2SLrRmzPEdwRhBibDkDC&__tn__=%2CO%2CP-R,19,0,positive,19
pfbid02HeWdErCJ7QGqjA2um2EgbBYpztmYifE4QxkJBGCdp2Lyf7LSjxJHUSvyuHfFFxSjl,NVIDIA AI,0,8,1,0,1,0,0,0,10,1," Just released: #NVIDIAKaolin v0.13.0With new lighting features enabling #3D DL works like DIBR++ or NeRD, check out our tutorials on diffuse and specular reflectance. Kaolin is now pip installable.Installation guide: https://nvda.ws/3k3QKOyRelease notes: https://nvda.ws/3k76v7l",2023-02-16T00:00:00,['blob:https://www.facebook.com/f6d2f3ce-ea12-4a0f-aa4e-92102fbd5573'],,https://www.facebook.com/NVIDIAAI/posts/pfbid02HeWdErCJ7QGqjA2um2EgbBYpztmYifE4QxkJBGCdp2Lyf7LSjxJHUSvyuHfFFxSjl?__cft__[0]=AZU5GttfxV5Ijt9TSuMdqhQFklyae2p2GoymSDR-ctD3CmvjPZ9Dw7BLw3EutT5KqZiyYQD-_9ZMDIPIUMWzrpbfBwj7C9ckmmc8au4NsAUmEIwmgFjfuEeRahqllYFkPTkiRsepg4BUyylBSCx5NW-WDfYCDx4y8TX334MwJ1E5Vtu6WKMybfHaviw-vAECl-1tjuP4XwnBJG9wpj1SoIXz2NJB8IoIuNMkcshMrehDRg&__tn__=%2CO%2CP-R,10,0,positive,10
pfbid0WBdirfm2U4rwpZnLrdb94M8PSLa8jKhKoiYLyjGoi8LPPWy6819NrqMDQA4JEyT3l,NVIDIA AI,0,23,0,0,0,0,0,0,23,2,"How can you tell if your Jupyter instance is secure? Technical walkthrough: . jupysec is a tool that evaluates the user’s environment against almost 100 rules that detect configurations and artifacts that have been identified as potential vulnerabilities, attack vectors, or indicators of compromise.https://nvda.ws/3I9pSV4",2023-02-16T00:00:00,[],https://external.fcai19-7.fna.fbcdn.net/emg1/v/t13/2020689667977428735?url=https%3A%2F%2Fdeveloper-blogs.nvidia.com%2Fwp-content%2Fuploads%2F2023%2F02%2Fcomputer-jupyter-code-1.png&fb_obo=1&utld=nvidia.com&stp=c0.5000x0.5000f_dst-jpg_flffffff_p500x261_q75&ccb=13-1&oh=06_AbHKtNl4hIY1-NaM9boUMg_Yv2JayvF-VTg5wJaEFwAtOg&oe=64E04DF9&_nc_sid=dbad39,https://www.facebook.com/NVIDIAAI/posts/pfbid0WBdirfm2U4rwpZnLrdb94M8PSLa8jKhKoiYLyjGoi8LPPWy6819NrqMDQA4JEyT3l?__cft__[0]=AZUou8OaIGidirZY5YJhx9u7_uzHa2Z8aUi8i2Q7kO4hwTa8wJPiXykZSC04g0Gx2f1zReTEZ7dTqxjrvnUi6w8vmdmnOJF2FQRTRKiVz_53i8rLDvIg9Fxmkz609EGs3jh2KCAF7XtkOATvO5nTGN1Mv7hyQmpmRDqPhyt4ewDTJv6afu5sKKw-fqCdFSH5IE-Qhv5IlCCx516QdJO8hGH3&__tn__=%2CO%2CP-R,23,0,positive,23
pfbid0WfUv37aTMrsLvv5QmQ9bpjgHMnphmUm9v1UmNJyEySaZbBSbJ6hSTuvJGTPJpT1Hl,NVIDIA AI,0,15,1,0,1,0,0,0,17,4,"From model selection to dataset size, data scientists must strategically plan out their resources. Unravel model training tips in our newest post: https://nvda.ws/3K5CHCt",2023-02-16T00:00:00,[],https://external.fcai19-7.fna.fbcdn.net/emg1/v/t13/15096022487672972531?url=https%3A%2F%2Fdeveloper-blogs.nvidia.com%2Fwp-content%2Fuploads%2F2023%2F02%2Fai-for-dev-social-blog-machine-learning-in-practice-2598934-tw-li-2048x1024-option2.jpg&fb_obo=1&utld=nvidia.com&stp=c0.5000x0.5000f_dst-jpg_flffffff_p500x261_q75&ccb=13-1&oh=06_AbF-uyhbxJSEvDKHiYuwVZInV9kVdgOda36qaR4ouZzEzg&oe=64E074B4&_nc_sid=dbad39,https://www.facebook.com/NVIDIAAI/posts/pfbid0WfUv37aTMrsLvv5QmQ9bpjgHMnphmUm9v1UmNJyEySaZbBSbJ6hSTuvJGTPJpT1Hl?__cft__[0]=AZUWnVEBlH-CVoHbbi94hQRrm21iBt3Wj0bjfzyf0Lvu8uPMDCsEShi4lXcEo9TiPRvuiqm-nqKPrXRe0v-LGJ-iBH_nqt7iAJ4STiXDOZ2rCZAa1nHOc8UNXlzxoFhZt98AsqaS31CGVuH0su5Wnzlp_OiaPdcSEhpqEttmTJNHYxvs2y5Ic7TdLEk6Vzbbix4pgJXrITlMxu3rB5WeTCT0&__tn__=%2CO%2CP-R,17,0,positive,17
1135255953807339,NVIDIA AI,0,12,0,0,1,0,0,0,13,3," #SpeechAI Developer Day at #GTC23Explore the latest advances in accurate and customizable automatic speech recognition, multi-language translation, and text-to-speech.Register for free: https://nvda.ws/3IqShro",2023-02-15T00:00:00,[],https://scontent.fcai19-7.fna.fbcdn.net/v/t39.30808-6/330921792_723614089337494_8997785097234173543_n.png?stp=dst-png_p180x540&_nc_cat=108&ccb=1-7&_nc_sid=9267fe&_nc_ohc=tr1TqEthZ-8AX82aYIR&_nc_ht=scontent.fcai19-7.fna&oh=00_AfCe18ZAlG0fH4FB9jPL-kOsi5ZMDmkIp98b9PQ4Ew4HVQ&oe=64E35438,https://www.facebook.com/NVIDIAAI/photos/a.119492422050369/1135255953807339/?__cft__[0]=AZWtp3XuTZWaKE8GSz_P_7ejE-9n83OafED18EZFMcRBtmP8oiFCpzE4KbnjkBdEK1lccU6AXhW1mgazeQihkeK9WlGCM1LOyKlzdAhoUcPEUV60mnPmQb5c6e2tpopU1DKLjtrothUBgFoZs2yoVwnrfXX6U8jPcL3kHnmnTDxbxYPppDuzZyVv4MkFNb9xtdX6lRUrM3SIkkawSIfNQXrS&__tn__=%2CO%2CP-R,13,0,positive,13
1135230533809881,NVIDIA AI,0,13,1,0,1,0,0,0,15,3,"Reimagine what’s possible at #GTC23! Discover technical details and popular use cases driving next-gen generative applications, as well as how it enables businesses to develop better products and services and deliver original content tailored to the unique needs of customers and audiences. Register now: https://nvda.ws/3xthEm6",2023-02-15T00:00:00,[],https://scontent.fcai19-7.fna.fbcdn.net/v/t39.30808-6/330424469_1954945868178211_6881277316522044377_n.png?stp=dst-png_p526x296&_nc_cat=100&ccb=1-7&_nc_sid=9267fe&_nc_ohc=Nb9NcEyc-s0AX9sZ7ZS&_nc_ht=scontent.fcai19-7.fna&oh=00_AfA-7kMKQbvvj5JoSBre_8s8H3Kc1t78dGhHGCYCXQIaUg&oe=64E2C301,https://www.facebook.com/NVIDIAAI/photos/a.119492422050369/1135230533809881/?__cft__[0]=AZWNpKkBuzFeDfjFkFF7n8bzx4_YFakkVzX3QBijBtfkPSgH-OlY-NRXPBSripo2fWbxd25PFtzI-2R3nxe7l1to3Dzxw_KICIAKsuE3rcZY9WHEs42Y617Vs7rwurTijfQ2_OnbWgEimIq0fbsau_rU_d8_HplUYucUffZOwwHpDgokiG_wmJ-f_wjNm8dcqxH_A4m6sJCS4muw3-v2QthZ&__tn__=%2CO%2CP-R,15,0,positive,15
pfbid0amfoNNJ1yZPVeqHvCv6gR1Ai6PzPUy7HQtBAsPds2tTCvk4uGn4CjQq3SNszmbXsl,NVIDIA AI,0,19,0,0,1,0,0,0,20,4,Don't underestimate ML project planning — low-quality datasets mean poor results. Get a quick overview of each ML workflow stage: https://nvda.ws/3jZPKL5,2023-02-14T00:00:00,[],https://external.fcai19-7.fna.fbcdn.net/emg1/v/t13/18144418407072435998?url=https%3A%2F%2Fdeveloper-blogs.nvidia.com%2Fwp-content%2Fuploads%2F2023%2F02%2Fachine-learning-in-practice-option1.jpg&fb_obo=1&utld=nvidia.com&stp=c0.5000x0.5000f_dst-jpg_flffffff_p500x261_q75&ccb=13-1&oh=06_AbFRK47HWMGZy76V7BCngSEOPl_pwbXgAPBTu11cTSBiIQ&oe=64E043A1&_nc_sid=dbad39,https://www.facebook.com/NVIDIAAI/posts/pfbid0amfoNNJ1yZPVeqHvCv6gR1Ai6PzPUy7HQtBAsPds2tTCvk4uGn4CjQq3SNszmbXsl?__cft__[0]=AZXLAkX42hnK471Numi1eTFtyZyMHmleQLWItbzBVoVR8By1gTx81hL-HX7A1GHYXbjy7JmpBGiKAkjCjuv1fGmoiTAGSSCA7NAcUyZZj4xUBqQ7X5dOQEueZY-9o8T8_F1ZCe5ikVUiwNMRvAkkfqOO2tssWJTW61FWP1Ezt8guLkCYLRnmU4bkjVOo26kvcIAcgBJ2phvH-L0BQ4-NjH6d&__tn__=%2CO%2CP-R,20,0,positive,20
pfbid02w3XvZGdGJHiptX3cZjTTV3sYkBVx5WwWro8JnA8QQ8XQrmozzXLL6fXx5iGxpDR8l,NVIDIA AI,0,14,0,0,1,0,0,0,15,2,"Join leading avatar developers on their best practices and challenges of building lifelike digital humans.Featuring Ready Player Me,  Hour One, KLleon Register for #GTC23",2023-02-14T00:00:00,[],https://external.fcai19-7.fna.fbcdn.net/emg1/v/t13/14493508256526745693?url=https%3A%2F%2Fprod2-sprcdn-assets.sprinklr.com%2F50276%2F6063cce5-f9da-4fbc-a683-5949f68f116e-612721346%2Fproviz-ace-social-gtcs23-S5190.png&fb_obo=1&utld=sprinklr.com&stp=c0.5000x0.5000f_dst-jpg_flffffff_p500x261_q75&ccb=13-1&oh=06_AbFFs6LpIri5vYx9fuEAHty52kDVvk4hkiJZcZzBCvehZA&oe=64E0B477&_nc_sid=dbad39,https://www.facebook.com/NVIDIAAI/posts/pfbid02w3XvZGdGJHiptX3cZjTTV3sYkBVx5WwWro8JnA8QQ8XQrmozzXLL6fXx5iGxpDR8l?__cft__[0]=AZX9nihJ_8LgvKadl7FMF9RjZBXFKByw5D4It8KLi4dvfZzpupOK7ghY9WcdpEPaOqOYAm7LfAMS_J6JMjVVwRtnvkEV6UXhJ32zWiWle7IjxZD3WnkVB23uZT3-XBpEHiVt-pw94p6ZOzpCFJiQnuiR2XE2IhCxHFK5grRKaqbQClNkAWgF8cyT7-58VXlJ80TdeeyEnr5iI4lS5R8i7Py2&__tn__=%2CO%2CP-R,15,0,positive,15
pfbid0RfK1MrtNXDfHQYJRzVdfwpeZiH9asHV65RpE3wiw5N9bjDDCuyVxfEiqwSdbYzhXl,NVIDIA AI,0,10,0,1,1,0,0,0,12,4,"Discover how VinBrain, a NVIDIA Inception member, is able to detect abnormalities and accelerate time to diagnosis with AI, leading to improved patient outcomes. Read more: https://nvda.ws/3JUYUTG",2023-02-13T00:00:00,[],https://external.fcai19-7.fna.fbcdn.net/emg1/v/t13/5767165110582094120?url=https%3A%2F%2Fblogs.nvidia.com%2Fwp-content%2Fuploads%2F2023%2F02%2FImage2.jpg&fb_obo=1&utld=nvidia.com&stp=c0.5000x0.5000f_dst-jpg_flffffff_p500x261_q75&ccb=13-1&oh=06_AbEfc8_nJMrm9C5sVnyInD0wEw1xDzmmDxYM2cltS4jjuQ&oe=64E02AE6&_nc_sid=dbad39,https://www.facebook.com/NVIDIAAI/posts/pfbid0RfK1MrtNXDfHQYJRzVdfwpeZiH9asHV65RpE3wiw5N9bjDDCuyVxfEiqwSdbYzhXl?__cft__[0]=AZW5_olZW_BklwylldOcQOs6L3DTd4wD3RXLmGaC3lLygMBW5LQuy_0Om-QhI38GuAPf5dXvHAUqQhHN1kmULvoLzmj-BRxgGyZ44nbb5lDmlxWPEgr4Own8ltacKM8ZX1MTiF-WO4iDxPuk2kAriT6SqPClJGBDqwphrpr6Laggo8fD15xwrYFSZxDZHSM9jhcTvsihkXIJBbHJ60n6FIU-&__tn__=%2CO%2CP-R,12,0,positive,12
1134001683932766,NVIDIA AI,0,18,1,0,1,0,0,0,20,2,"Register for our top #GTC23 conversational AI sessions to learn about the latest #speechAI, #NLP, and #LLM advancements including how #generativeAI is transforming every industry. Register now: https://nvda.ws/3wYSBa7",2023-02-13T00:00:00,[],https://scontent.fcai19-7.fna.fbcdn.net/v/t39.30808-6/330818549_572646358215897_3186344945767083618_n.png?stp=dst-png_p526x296&_nc_cat=103&ccb=1-7&_nc_sid=9267fe&_nc_ohc=KWPDVAr7nNgAX_iJM4o&_nc_ht=scontent.fcai19-7.fna&oh=00_AfB7PO9XQrSXLNMXL8v417P7RY3YAEqW0EbmYrbLC6KTUQ&oe=64E453DE,https://www.facebook.com/NVIDIAAI/photos/a.119492422050369/1134001683932766/?__cft__[0]=AZWZ3B4Qhcf9L3R9RC_LnCvVGVCwcbkY7tvpYo5vyHaFu4DQdMDkrbr1A7UrPZBz8fcwCpjtEmLK6L44cn-9O9-pGPSAvDR5FnqzRZmqvTMBZfPvNgsJh_qoBuPhxD-Q0jdnfjMLCxLSC_mQNHGOY13yYUoGbYn8yB80J1NYLVH7XtvgI8yilarayKTzkKqV_Iayfc2U5ZWU0GFRRntZezIr&__tn__=%2CO%2CP-R,20,0,positive,20
1132354167430851,NVIDIA AI,0,4,0,0,1,0,0,0,5,0,How can financial services firms effectively detect fraudulent transactions across millions of endpoints? Mastercard is using transaction graph networks and #machinelearning to detect fraud in real-time. Register free for their GTC session on March 22 at 7 AM PT: https://nvda.ws/3YznEoz,2023-02-11T00:00:00,[],https://scontent.fcai19-7.fna.fbcdn.net/v/t39.30808-6/330154827_502928792024526_5256746211371061998_n.png?stp=dst-png_p526x296&_nc_cat=102&ccb=1-7&_nc_sid=9267fe&_nc_ohc=k08kLsOGuOgAX-5GGrf&_nc_ht=scontent.fcai19-7.fna&oh=00_AfCOvsL6rIIXnoEwxKGSm_n088_dchGLsPCeeKN9R6p3xA&oe=64E3BE9E,https://www.facebook.com/NVIDIAAI/photos/a.119492422050369/1132354167430851/?__cft__[0]=AZVDwj2qtzKL_R57vwLgDOZrYE40k1Ame1v_JVnuy-_2baueywBW5uDuk29H-9Fav3PrJvlGPR_UKszkCMV20hRfTB_4R9aq7hh8AlYYVkF7le-Y8YLAg06XTH7uBXY8TRjLI6h1H3VVN0o9KjvyTxGP17IBUjV6ILEPtdQtxc_pkaB0Jjgizs3aJ6PvU61YPsxNALpaqY3Zk_QmNc7mzMGr&__tn__=%2CO%2CP-R,5,0,positive,5
pfbid022zRLvWyhXBKsxfHs98hGKWrLL3LezZQzdGx1bmCtTiRxhHN37MdroQZrht54fwjRl,NVIDIA AI,0,14,1,0,1,0,0,0,16,6,"Startups, last chance to save 50% on a #NVIDIARTX 6000 Ada Generation graphics card! Members of #NVIDIAInception can take advantage of this offer through February 15th, 2023. Apply today: https://nvda.ws/3xbF5QLAlready a member? Contact your NVIDIA Inception Partner manager today.",2023-02-10T00:00:00,[],https://external.fcai19-7.fna.fbcdn.net/emg1/v/t13/852591984283352218?url=https%3A%2F%2Fprod2-sprcdn-assets.sprinklr.com%2F50276%2Feaebf61c-100f-4f25-a283-24434d364336-1393252801%2Fproviz-web-rtx6000-2048x1024.jpg&fb_obo=1&utld=sprinklr.com&stp=c0.5000x0.5000f_dst-jpg_flffffff_p500x261_q75&ccb=13-1&oh=06_AbHcOXHtUgumUIpyv66raaV9JTR9e5-g5lFOn0om4XYjSA&oe=64E01982&_nc_sid=dbad39,https://www.facebook.com/NVIDIAAI/posts/pfbid022zRLvWyhXBKsxfHs98hGKWrLL3LezZQzdGx1bmCtTiRxhHN37MdroQZrht54fwjRl?__cft__[0]=AZXn_oOT9aKzPy2kT2B09DgyqC69OsV_IFEzEsAMwFw76kwLWFITf2Zr7N5gsxH0xDlTa4ZQRr2e2JZyQ0NLGbDUR0-MMN5tn2L56xKeMtMGr6DqQin7XbYOKh-vd8NKZJ920PIOZCkvL76ULzdA_0-stWH-FV3y9g146krm2xPfFk1_h_XhzdpI_YkokM6pkgEuxjFIA-qZO9b4g59GmcsE&__tn__=%2CO%2CP-R,16,0,positive,16
1132283787437889,NVIDIA AI,0,11,2,0,1,0,0,0,14,1,Have you ever wondered what it takes to bring a virtual character to life? Learn more about the foundational #AI building blocks to create interactive avatars at #GTC2023: https://nvda.ws/3DwG81c,2023-02-10T00:00:00,[],https://scontent.fcai19-7.fna.fbcdn.net/v/t39.30808-6/329051756_944272283400185_4380153767532781303_n.png?stp=dst-png_p526x296&_nc_cat=109&ccb=1-7&_nc_sid=9267fe&_nc_ohc=kGHp9kuJsUoAX8RQuJ0&_nc_ht=scontent.fcai19-7.fna&oh=00_AfCNlswQp3ilKlHDU50phxysql9CDOc7tnllqGVZrzuldA&oe=64E4AC9E,https://www.facebook.com/NVIDIAAI/photos/a.119492422050369/1132283787437889/?__cft__[0]=AZXeyZfx71m7_83H-9KR8GrbIlEdFDFJ_W9HNIQh-YRHCCvWjT4sM7GViaWgYZeXHFyBX-RnJZdLRL-PA9dWdatCOjZqdNO9nBotMfvERl8OI6kRfo16C2HGVZSNhskXCyuiRJ0pVdFjfrv2FXQMp9vDJSJ9j2BeYcqhZgXkqh4Oyviag4rcAYniw0-1YALU4KaMLs3jOMLJqagJiAVpx2eA&__tn__=%2CO%2CP-R,14,0,positive,14
1132256180773983,NVIDIA AI,0,22,0,0,0,0,0,0,22,4,Financial firms are moving to the cloud to optimize #AI performance and reduce operating costs. Find out why 75% have made the move—and more—in our 2023 Trends report: https://nvda.ws/3lf7Wkn,2023-02-10T00:00:00,[],https://scontent.fcai19-7.fna.fbcdn.net/v/t39.30808-6/326947854_1111942146153963_4712069331839364120_n.jpg?stp=dst-jpg_p526x296&_nc_cat=104&ccb=1-7&_nc_sid=9267fe&_nc_ohc=pM_HB1SldbIAX99yWsb&_nc_ht=scontent.fcai19-7.fna&oh=00_AfBoHr1LJ2AB34fwD6aG_F_EHtzaoVmsldpMD_SSzUB0Tw&oe=64E2E770,https://www.facebook.com/NVIDIAAI/photos/a.119492422050369/1132256180773983/?__cft__[0]=AZUJ7c0CkAISRPBvVlMU5jolP75K2dV0bQtx4EFP9BdoTWSemWqUKxZT9V73SRbtuMjP43W3-rJpG4eZBX1KpS5jnM9pfy0_ch4jE7uGt2WVJC7yWvylbAHQ5M9TO0oprm1Ap_swpuzcVN9Wqtuvwr1FzTp2ML884gLQ-KYxWODZgljTrSF4oTM5YFl9BhMHIItm_M0e9GnNsrzpqPgqU00y&__tn__=%2CO%2CP-R,22,0,positive,22
1132225330777068,NVIDIA AI,0,7,0,0,1,0,0,0,8,2,Read how Artisight developed smart hospital solutions powered by NVIDIA Riva text-to-speech to automate check-in and notify waiting patients via voice-enabled kiosks reducing wait time by 50%. https://nvda.ws/3jTlLEB  #SpeechAI,2023-02-10T00:00:00,[],https://scontent.fcai19-7.fna.fbcdn.net/v/t39.30808-6/328711350_2333973980133739_6022014291586271242_n.jpg?stp=dst-jpg_p526x296&_nc_cat=102&ccb=1-7&_nc_sid=9267fe&_nc_ohc=G86mJNs4qasAX8cto8c&_nc_ht=scontent.fcai19-7.fna&oh=00_AfBZsNpL41sYAnno-JDEovUY0cxykJTJQ33r-HQXcGyJuA&oe=64E31413,https://www.facebook.com/NVIDIAAI/photos/a.119492422050369/1132225330777068/?__cft__[0]=AZW6mW9V6uM6KgMqS9vK2e3z-_bqAQu6S_2lHSIWo-hFL4vXaddd9b3CzAxWOalWnG0j1v5DuoSm0VU1mSNLQzp27GoB3gOe98m4t2CuorXb_43OpQAm_A1FrqWsOIV4gs-lXy6SHuBITQR5q3Uk1BxLqVIjdmh0Gtzps6nqFWixxaWILhZvADa-bymH5NaQakKrMN4Hy-piyHAJhIFZmyyk&__tn__=%2CO%2CP-R,8,0,positive,8
pfbid0HhTjUn7USpKdAGCVqvGeunqJtw5nVXz7ivLUxqUufht6swhDvY7M4EkXt4bHG8ZCl,NVIDIA AI,0,8,0,0,0,0,0,0,8,1,"Take our interactive, self-paced course to learn the crucial skills to deploy, administer, and manage your NVIDIA Omniverse solution. Enroll now: https://nvda.ws/3R1YjkT",2023-02-10T00:00:00,[],https://external.fcai19-7.fna.fbcdn.net/emg1/v/t13/12179906158086495738?url=https%3A%2F%2Fprod2-sprcdn-assets.sprinklr.com%2F50276%2Fa0215b06-bf57-41c4-a694-60c2fe4e058b-1353805818%2Fdli-social-training-course-fb-.jpg&fb_obo=1&utld=sprinklr.com&stp=c0.5000x0.5000f_dst-jpg_flffffff_p500x261_q75&ccb=13-1&oh=06_AbFOqaI3kYoSlPeZdgKuBpkui5ew-P2R2IbUDIMTtYvjRg&oe=64E09043&_nc_sid=dbad39,https://www.facebook.com/NVIDIAAI/posts/pfbid0HhTjUn7USpKdAGCVqvGeunqJtw5nVXz7ivLUxqUufht6swhDvY7M4EkXt4bHG8ZCl?__cft__[0]=AZXFLIhVQ8Pf5L1cN172cW2UOIXeD379D7gl8jtlztxERSA8Msu2mlDdBUSM5GztbHgZmsqLTEi1yRxrPgZftBz4PoJKvNdcS8lphi-sO9yAw_yZtn0yptciSdDXUZ8DfiOF6CZks6aRo8H0Kn8ASFMzcUdq9zwVRZIC9v2_R9kCesVrqB_qt_NV6q9Z5K9mR7NVwNOFs6j8RpWlL0LftyAY&__tn__=%2CO%2CP-R,8,0,positive,8
pfbid0vDbGyXCNBCs2a342aznq6Hr6VyDyMncQnaUiK2iYQsQRAuViSDSQtLqYaQcPn83Al,NVIDIA AI,0,13,0,0,1,0,0,0,14,2,No need to slow down: Simplify your JSON data workloads with the RAPIDS cuDF JSON reader to extract clean dataframes from complex JSON objects. Get the code and best implementation practices: https://nvda.ws/3JWU0Wr,2023-02-10T00:00:00,[],https://external.fcai19-7.fna.fbcdn.net/emg1/v/t13/1586619048983210335?url=https%3A%2F%2Fdeveloper-blogs.nvidia.com%2Fwp-content%2Fuploads%2F2023%2F02%2Fjson-code-featured.png&fb_obo=1&utld=nvidia.com&stp=c0.5000x0.5000f_dst-jpg_flffffff_p500x261_q75&ccb=13-1&oh=06_AbG_iMfQO_gOE4vYnUYOv7OwzDoEmmJtDZ4kLfCNGfmkDw&oe=64E093A7&_nc_sid=dbad39,https://www.facebook.com/NVIDIAAI/posts/pfbid0vDbGyXCNBCs2a342aznq6Hr6VyDyMncQnaUiK2iYQsQRAuViSDSQtLqYaQcPn83Al?__cft__[0]=AZXxPqiCYK3e521b7EQDnVdHM_07cOCxEryfol-vrRD78VBObtdphCAz_wcs91sfmDEHwPLYbR61fBnGKVw75ZFFoNNpA6x80rpkekbwsjyFak0lh7lC_sTEXX4X3y99V4VwH4KZZlxfZvDDC67dzSiY9Cbzvi9uGYmcI1zX7xF4ZJlAiBV1hLtbIxXqLzr8LkJYCi3fSRkHoDezJrZDOz8c&__tn__=%2CO%2CP-R,14,0,positive,14
pfbid02xdVHSgUQ9QoLKj6KgoevNg8EpL1WfhH9paMesj6XVBCeDuwbyaS2pJY449Eng9nXl,NVIDIA AI,0,15,1,0,1,0,0,0,17,2,"Working with categorical data? Avoid manual encoding all your categorical variables, and try an XGBoost experimental feature to save time and fit more accurate models: https://nvda.ws/3IdXiDo",2023-02-10T00:00:00,[],https://external.fcai19-7.fna.fbcdn.net/emg1/v/t13/13490352219182448726?url=https%3A%2F%2Fdeveloper-blogs.nvidia.com%2Fwp-content%2Fuploads%2F2023%2F02%2Fxgboost-categorical-featured.png&fb_obo=1&utld=nvidia.com&stp=c0.5000x0.5000f_dst-jpg_flffffff_p500x261_q75&ccb=13-1&oh=06_AbHQ5tbbLCJCaKV57z6GGqDqgiqtou_jcv3UCTTJfUmq5g&oe=64E013EF&_nc_sid=dbad39,https://www.facebook.com/NVIDIAAI/posts/pfbid02xdVHSgUQ9QoLKj6KgoevNg8EpL1WfhH9paMesj6XVBCeDuwbyaS2pJY449Eng9nXl?__cft__[0]=AZUmLiWWCm2R4UGffI4bFIZ4Zl1hKDbGOmbMiw-hzEhIIZYsFMh2STWBDSWn06uZxdnAh-fNpZYvYKwAgg2F2B6yOlaD7ybBNuVqM8Rw2BZhhA5GzU0I54oYegY4DZZZoCdNDnFbUpctUlZ85TL0tqTnQErxvoa30BvEt5Hn-WxGcctYkRFSINPX6H6-3WIhrf-lIif_7hbPF6RMyumoHrch&__tn__=%2CO%2CP-R,17,0,positive,17
pfbid0hRBTEYsMHALGPNFy8gPkYR8a3HFZZ78VnVFsjftftboSowzCfxB82aCcu3vyKsszl,NVIDIA AI,0,7,0,0,1,0,0,0,8,0,"From #generativeAI applications in #LLMs to imaging, see the latest implementations of AI in biology, medical devices, and imaging to unlock efficiencies and accelerate time to market. March 20-23, 2023. Register free. https://nvda.ws/3REtAL0",2023-02-09T00:00:00,[],https://external.fcai19-7.fna.fbcdn.net/emg1/v/t13/13017521986382547068?url=https%3A%2F%2Fimages.nvidia.com%2Fnvimages%2Fgtc%2Fagenda%2F2023%2Fhealthcare%2Fgtc23-spring-web-rf-target-agenda-og-healthcare.jpg&fb_obo=1&utld=nvidia.com&stp=c0.5000x0.5000f_dst-jpg_flffffff_p500x261_q75&ccb=13-1&oh=06_AbFSTQTEYlENxMw5gB0GBa1xdJGnl2BQs2xCXv2IvVDU0g&oe=64E03A4B&_nc_sid=dbad39,https://www.facebook.com/NVIDIAAI/posts/pfbid0hRBTEYsMHALGPNFy8gPkYR8a3HFZZ78VnVFsjftftboSowzCfxB82aCcu3vyKsszl?__cft__[0]=AZUmsG4gNbo_fIZW5k8MUBTHO69-l65l-nSodW6i13gdgdiG0OSr_Oc4POBzt9T_g_z5RcUWMUK07xeq1okEBMlLC2XA1rZWa6j7UBHdGlbyzbLvtnXnDLa1JszkzBcYN24N-8BZ8Yj86t4msMqqiSZbKWNA9YoGcvamAvaTUd-wtSkyyrXqlLTLJm1NxuNyPCw9K6H9Zykl_cPUuDfCz6uu&__tn__=%2CO%2CP-R,8,0,positive,8
pfbid02skdjymi7fi9VcpzEMDHLyKJLFaQwUyJ9ezyQB14mkeEPANNHYA71qf1R9D4CWh8Nl,NVIDIA AI,0,10,0,1,1,0,0,0,12,0,Transcription for good: Unravel the inner workings of #NVIDIAInception member Pendulum's #AI engines that can identify falsehoods in social media content. #SpeechAI https://nvda.ws/3IbF9pF,2023-02-09T00:00:00,[],https://external.fcai19-7.fna.fbcdn.net/emg1/v/t13/6980870334201616696?url=https%3A%2F%2Fdeveloper-blogs.nvidia.com%2Fwp-content%2Fuploads%2F2023%2F02%2Fspeech-ai-spotlight-story-pendulum-solution-workflow-featured-image.png&fb_obo=1&utld=nvidia.com&stp=c0.5000x0.5000f_dst-jpg_flffffff_p500x261_q75&ccb=13-1&oh=06_AbH7mPplAf8MsuWY056bOh4VbP3cN4uU_7crOq2O37Gqug&oe=64E03F86&_nc_sid=dbad39,https://www.facebook.com/NVIDIAAI/posts/pfbid02skdjymi7fi9VcpzEMDHLyKJLFaQwUyJ9ezyQB14mkeEPANNHYA71qf1R9D4CWh8Nl?__cft__[0]=AZUvG8BH4uWf1gl-LJjWgUsc2RPeRT1ilOiCxVm6RnGAfiYI4APqQuafKFB5xZu0Gi0G9TL76Mo9Tf_UyV4Q9Ww0cyjsx76WyaumHuyIs9AKtu_o5BUumxnTaCoUS_6Lu9vrugOAltegGbvLMBWlDEHUBYDr_T5erH4GOjlBLaROqmIASqbxtSGEN6cRATAGtSj8feQTmJzZAkRgK-Dl4GOB&__tn__=%2CO%2CP-R,12,0,positive,12
1131549307511337,NVIDIA AI,0,7,0,0,1,0,0,0,8,0,How is one of the world's largest #banks using deep learning to accelerate Monte Carlo option pricing? Join #GTC to hear from JPMorgan Chase's Executive Director and VP. Register free for the session on March 21 at 11 AM PT: https://nvda.ws/3HHhaxa,2023-02-09T00:00:00,[],https://scontent.fcai19-7.fna.fbcdn.net/v/t39.30808-6/329239432_1357335371690622_5056040115226259522_n.png?stp=dst-png_p526x296&_nc_cat=107&ccb=1-7&_nc_sid=9267fe&_nc_ohc=m6dCoQ2ajdwAX890let&_nc_ht=scontent.fcai19-7.fna&oh=00_AfC-1D7-D0YjltX5BWisYLMfQRGX5a2qDOhLMYYE_hC0kw&oe=64E45F57,https://www.facebook.com/NVIDIAAI/photos/a.119492422050369/1131549307511337/?__cft__[0]=AZVQbfZb1hiXJWczLM3u4ZnGwdiaQdizwh4c-2WGA5ym8HrCp0vLDXnZWQkkvrDHw4aJlInyizgoRA_uOuF8fmc0GTNyo5DMY7l2Q9UhGezqkRdiO5rTEXWOf3Jq0Mwl-5RknvsY2XARREMjs9PwQOqIzxg3H1CGkSHAkFrXbWmDT_XRpqRBY9iw3gnOgaPXIFeTMkNjh7PPxBIrno9iT-mP&__tn__=%2CO%2CP-R,8,0,positive,8
1131111114221823,NVIDIA AI,0,9,0,0,1,0,0,0,10,2,"AI and cloud infrastructure are helping organizations handle workloads faster and more efficiently. Learn from the experts as they talk about AI-first infrastructure trends, industry insights, and their interactions with customers worldwide. Read the HPCwire article. https://www.hpcwire.com/.../microsoft-and-nvidia-experts.../ #MakeAIYourReality #NVIDIAonAzure",2023-02-09T00:00:00,[],https://scontent.fcai19-7.fna.fbcdn.net/v/t39.30808-6/328712109_752518099911475_7045317813380566467_n.jpg?stp=dst-jpg_p180x540&_nc_cat=101&ccb=1-7&_nc_sid=9267fe&_nc_ohc=sNboeY-204QAX8kAVs3&_nc_ht=scontent.fcai19-7.fna&oh=00_AfCP9VfEac5FbJ9iS88-LXSXGNcWEzPAC0h5HXPz6CDReA&oe=64E30A37,https://www.facebook.com/NVIDIAAI/photos/a.119492422050369/1131111114221823/?__cft__[0]=AZWQ8WvRYzln-m0rwb_3sJ7m2rPw_S_CXQo5hYBaVxoZhP_95h0S6-ea4HS69KN7bVL0M1_YKIh7B6UrtxfSEC0adBm3Kg9te7D-Fefk4YluO58bHt0Njp0hl9SZVoDd09qVaqdAcw3pKDEcUpsC7x4hvxlPe_uyzQabVXf3EV3OJ6EqZLdqDlyl0iZsWmI6pwifkyqF_smY3YNNdnEF5qQc&__tn__=%2CO%2CP-R,10,0,positive,10
pfbid025TbSLyo8msDbQ3bFxUBuef1Y5jCgbZ6csbQ3tpiowvgWuj5Dfujvaw3aGSx4LL2wl,NVIDIA AI,0,18,1,0,1,0,0,0,20,2,Model cards help the development of #algorithms and #TrustworthyAI. Read how NVIDIA is advancing the AI model card with #aiethics: https://nvda.ws/3X1ZJgn,2023-02-08T00:00:00,[],https://external.fcai19-7.fna.fbcdn.net/emg1/v/t13/8648992021038556092?url=https%3A%2F%2Fdeveloper-blogs.nvidia.com%2Fwp-content%2Fuploads%2F2022%2F09%2FNEW.png&fb_obo=1&utld=nvidia.com&stp=c0.5000x0.5000f_dst-jpg_flffffff_p500x261_q75&ccb=13-1&oh=06_AbEzpeuEVMv4hhy8aWv1c6KCaNlq9O-ui_bEn_EXZXsqVw&oe=64E0AF82&_nc_sid=dbad39,https://www.facebook.com/NVIDIAAI/posts/pfbid025TbSLyo8msDbQ3bFxUBuef1Y5jCgbZ6csbQ3tpiowvgWuj5Dfujvaw3aGSx4LL2wl?__cft__[0]=AZUbcaGb-DEgnHiWeFIyQeKodrQG20kvT6RKNJE3zlv_W2I_Ow6ynNEBlBzRWmhkYroowWk6qVORBQbku5oz8e3REC2rEhYnCq5EgYxmu8XWkWU_wbJcD1gqBQqhaxjPMxEvqZ5KAAuxbJ-zov1A8xvmPWfpqtvAV9bjjQVKAkLSYHc69lovmhFJRhAsjAUQwEkBAxNpRVTgNwmok_RklEfz&__tn__=%2CO%2CP-R,20,0,positive,20
pfbid02BtsgmhUowcU9oqDZDoKRSwe77by1H4T9bAy4NmEPu8KFDtgCQoNvzHgkghxCbTEJl,NVIDIA AI,0,2,0,0,1,0,0,0,3,0,"Take advantage of a Deep Learning Institute workshop at a special #GTC23 price of $149. Choose from a variety of workshops covering #AI, accelerated computing, and data science taught by NVIDIA experts. Register now: https://nvda.ws/3kQ8rB2",2023-02-08T00:00:00,[],https://external.fcai19-7.fna.fbcdn.net/emg1/v/t13/17892194823627388879?url=https%3A%2F%2Fprod2-sprcdn-assets.sprinklr.com%2F50276%2Fc1314164-7a2f-4ff5-80e1-b5a20d5af331-644219421%2Fgtc23-spring-dlil-x4-drive-reg.png&fb_obo=1&utld=sprinklr.com&stp=c0.5000x0.5000f_dst-jpg_flffffff_p500x261_q75&ccb=13-1&oh=06_AbEaA7awdv4uCkZS0eLpXBB8Nw39Umr1k2rpOU6yoz5RTw&oe=64E0B89C&_nc_sid=dbad39,https://www.facebook.com/NVIDIAAI/posts/pfbid02BtsgmhUowcU9oqDZDoKRSwe77by1H4T9bAy4NmEPu8KFDtgCQoNvzHgkghxCbTEJl?__cft__[0]=AZX26Tnvpk71cUZZ_8B_Hj-Z5C2qE50tqYyubs4T1i3FkmzPtz0rZqJw3I_Dowo1E7MS4vxXa4ASOc5T-y77i0Q2WytEXZwMMvdcbUdVIDJNJmA4JNABGU6wYDqvS34YJxHGOuTuYgiivGpzUyiEz-eJd_N11qhkqFGpb8aBx2ncXD6UE7w_8NOBjw-2W5sI8aTy76uu5LbDWGLdy9Y6Ugku&__tn__=%2CO%2CP-R,3,0,positive,3
1130999190899682,NVIDIA AI,0,13,0,0,1,0,0,0,14,0,Accelerate the development and deployment of #transcription services on a large scale with NVIDIA #AI workflows powered by NVIDIA Riva. Learn the steps in our new free hands-on lab. https://nvda.ws/3ks6t9U,2023-02-08T00:00:00,[],https://scontent.fcai19-7.fna.fbcdn.net/v/t39.30808-6/328835767_597255478909632_8483241399213457253_n.jpg?stp=dst-jpg_p526x296&_nc_cat=101&ccb=1-7&_nc_sid=9267fe&_nc_ohc=iCJhPdxVMn4AX_NOf5q&_nc_ht=scontent.fcai19-7.fna&oh=00_AfCXwSUH9Ctn92w-1uShE1j4jxmUgFWgvH8jfdnR6-ooxw&oe=64E32D8F,https://www.facebook.com/NVIDIAAI/photos/a.119492422050369/1130999190899682/?__cft__[0]=AZU50IryiqBOXZX0tcRx_-6xCeAVmRF_WV6Dxv4M7CdKDOkacr_Y7WG__BhBc6gSIwKLLUuepG-bxzhbMhDQLXrZZlf-iecK6vnZ6Hq-v0zihnho9H_hAJjhPx7sCZUd5xXainZQiBK7nM6uLBJcZL4FBst3YhpE_7XvzY5FBmfHq9m8K0or1irflYe6szdMH1WLnAIuSesHbmliywvjxXy-&__tn__=%2CO%2CP-R,14,0,positive,14
1130521214280813,NVIDIA AI,2,24,0,0,0,0,0,0,24,2,"Honored to have our Chief Scientist Bill Dally inducted into the Silicon Valley Engineering Council Hall of Fame.  His work on stream processing at Stanford University, helped lead to GPU computing, enabling the #AI revolution. https://nvda.ws/3YBgctp",2023-02-08T00:00:00,[],https://scontent.fcai19-7.fna.fbcdn.net/v/t39.30808-6/326456446_5952983121391119_2450811681936011180_n.jpg?_nc_cat=104&ccb=1-7&_nc_sid=9267fe&_nc_ohc=ctZsYiMnWqAAX95FFFw&_nc_ht=scontent.fcai19-7.fna&oh=00_AfANUiU87NGtBJe2p-W2MyibHo5eka4R7C3Jvxw1p46Brw&oe=64E3F634 https://static.xx.fbcdn.net/rsrc.php/v3/y9/r/Z-dbClQDXLv.png,https://www.facebook.com/NVIDIAAI/photos/a.119492422050369/1130521214280813/?__cft__[0]=AZVcX-blViHupA2kefx736pmrEm7WxO1615Ugb1voQVrsMP-NRoYNSmT69PjZzJR-_hCC0v5a-SVdUR2GDoeOnxCFU0OPgzruj5x_RnePv71X8QDXjppm7t5lq5OampZkjA5T3BbQwgi0VMRk1K9xCW1lFhe5LFdTLM--JrgQh4SU07iRHjiZIu379nE3qwCiZZkHzow54iHTKoflDTeZQiz&__tn__=%2CO%2CP-R,26,0,positive,26
1130438857622382,NVIDIA AI,0,15,0,0,1,0,0,0,16,0,Check out NVIDIA’s new free hands-on lab and learn how to use an NVIDIA #AI workflow to build an intelligent virtual assistant. https://nvda.ws/3QSOO7g #AIvirtualassistant.,2023-02-07T00:00:00,[],https://scontent.fcai19-7.fna.fbcdn.net/v/t39.30808-6/329241702_2111501789051302_3745514490427914614_n.jpg?stp=dst-jpg_p526x296&_nc_cat=110&ccb=1-7&_nc_sid=9267fe&_nc_ohc=ZLR2HJLoetMAX_1P8Z2&_nc_ht=scontent.fcai19-7.fna&oh=00_AfCtXFLwKMlD4xO7I4MAhts-HHNbvk7vXHUM_IRu3-96JQ&oe=64E2CECA,https://www.facebook.com/NVIDIAAI/photos/a.119492422050369/1130438857622382/?__cft__[0]=AZXTkSeIinl7vrIpAPznsLdHGKMQ0nQUDpuYqgG9uCg2BMOVLSSjwkgCwAwU62awOWRASWuxcCCOeAHU1GTBs6MJd9ZOiRDwq7zmcPGKfLjzxSOoDLBEPnPTS6iGaWW8P4WJa58c64--jIYqj_lahVnJe_I_fzYLEBX9YoIBuwcZK82_TpBklYGreK64BL6txF9-xQzDMny-NzyDKUp2tpu6&__tn__=%2CO%2CP-R,16,0,positive,16
pfbid02ah5hpdhKYtKL16qKvSpMiaVX6avgQZrrJQMvgbjrBkBT9jC53CSpNaVw4q132Wrbl,NVIDIA AI,0,5,1,0,1,0,0,0,7,0,Interested in learning how startups use #AI to build their solutions faster and accelerate their growth? Check out these featured sessions at #GTC23 and register now: https://nvda.ws/3Y3VFgY #NVIDIAInception,2023-02-07T00:00:00,[],https://external.fcai19-7.fna.fbcdn.net/emg1/v/t13/15174563465531525844?url=https%3A%2F%2Fimages.nvidia.com%2Fnvimages%2Fgtc%2Fagenda%2F2023%2Fgeneral-conference%2Fgtc23-spring-web-rf-target-agenda-og-general-conference.jpg&fb_obo=1&utld=nvidia.com&stp=c0.5000x0.5000f_dst-jpg_flffffff_p500x261_q75&ccb=13-1&oh=06_AbFJ3p57vNGP8uRdWHGDD5ftGfIaEWOFx0Cm3vwNLLmHBA&oe=64E068C3&_nc_sid=dbad39,https://www.facebook.com/NVIDIAAI/posts/pfbid02ah5hpdhKYtKL16qKvSpMiaVX6avgQZrrJQMvgbjrBkBT9jC53CSpNaVw4q132Wrbl?__cft__[0]=AZXA05JoRGoQWHIQfyw7bkGeB4uhW7avupC92EX1eM_s50ucM-81UbMFZop7jZdVzDnpCLIAPiL6zNGb25f_blLalxulcMr8n9AThlEK9zDpgQkOh_BwMcka8Gvm3qywYrcFF9gICFtsKUkEvm82fn8toyx6I_nQNcpreiUTnMja36CoffKZtuaADdYoIzjp4ZKioH2PBuwKbp21uC-NTsaQ&__tn__=%2CO%2CP-R,7,0,positive,7
pfbid033UhpAYv4hMRocNVReJsucyhmWjCCfqpLa19afF1uUAQ2C9vZpBSUFPMSbm76yfR8l,NVIDIA AI,0,10,1,0,1,0,0,0,12,2,Join NVIDIA Inception on 2/22 in a discussion on how #AI helps meet the rising demand for quality food by leveraging #GPU acceleration in high-performance computing and real-time inference on edge devices in this webinar. Ask questions from the NVIDIA Inception team and experts directly. Register now: https://nvda.ws/3HSLiqO,2023-02-07T00:00:00,[],https://external.fcai19-7.fna.fbcdn.net/emg1/v/t13/9852953820181146733?url=http%3A%2F%2Forion.akamaized.net%2Fmedia%2Fcv%2Fvideo_library%2Fclient%2F25%2F37%2F3%2Frt%2F82%2F16%2F02%2Frt%2F2022nvidiacorporatekeyvisualwallpaper1080p_bTA3W_resized_medium.jpg&fb_obo=1&utld=akamaized.net&stp=c0.5000x0.5000f_dst-jpg_flffffff_p500x261_q75&ccb=13-1&oh=06_AbHrQ5AWwtDgwyRp9a8xd4eh5lGhUAq4ZtaHP7rQoiSLTg&oe=64E0426F&_nc_sid=dbad39,https://www.facebook.com/NVIDIAAI/posts/pfbid033UhpAYv4hMRocNVReJsucyhmWjCCfqpLa19afF1uUAQ2C9vZpBSUFPMSbm76yfR8l?__cft__[0]=AZVkJz4aHhrXOa-auASvsWtB5drsK3aTTWJD-zSo3UVIpR29Ct58BVJLTGfjvRb8_4WC7xij8r5qlHFn_P2tiJR4lLLZWOqQ3WlFpDwG9eByWM3XYO7L3yEa1aTg4Jc3cq2GRz0EysQ4N6HgpaKWt1lzt8n20jYdnz0-lwmJPu943g1Mlh-YmsJLESEUZBRuQobQMoytreucniTrHG9-2CL7&__tn__=%2CO%2CP-R,12,0,positive,12
pfbid02v3YUHerwLEW6CFZMwx3v3SaXFrERd6nQQGNCaRmXhoYG8JdAaTsQSs2PwjJ3mrzxl,NVIDIA AI,2,21,0,0,0,0,0,0,21,1,"In this webinar, you'll learn how to build Isaac ROS on your #NVIDIAJetson and your workstation. Starting with an introduction to Docker and Continuous Integration (#CI), we'll take a deep dive into Isaac ROS, how to set up a basic docker, and more. Register today > https://nvda.ws/3Y1b6GK",2023-02-06T00:00:00,[],https://scontent.fcai19-7.fna.fbcdn.net/v/t39.30808-6/328634691_1530352574125122_6525744726889309451_n.jpg?stp=dst-jpg_p526x296&_nc_cat=108&ccb=1-7&_nc_sid=9267fe&_nc_ohc=JWKkt0L2LWwAX_BCj45&_nc_oc=AQlvuSiWnIUfr4HZMcaiqbkrIRPABxoF8YUMAUmpXKQod9211BiRiyrbfrQDKLifWTc&_nc_ht=scontent.fcai19-7.fna&oh=00_AfAhNpOtV4hwOZjh6lhQaOPgdtL5iddg1pMdQShPUTnRHg&oe=64E32FFF,https://www.facebook.com/NVIDIAAI/posts/pfbid02v3YUHerwLEW6CFZMwx3v3SaXFrERd6nQQGNCaRmXhoYG8JdAaTsQSs2PwjJ3mrzxl?__cft__[0]=AZX5GHssoHqt6HdOUOyyentuLQMXMCSZ1PCFvpVr5QBvCtoBFRoxn6YR-ytzRFcXeN5R52YR2Muf72dPNHmi2-RpVg5SAvZNVEofbcMaCF5bkrqIhx_uN9fxGNpYwl0F3KCpF6ZM5Wdl9kF0mHtD0HC-hBPrBiWHEsfusiK_8_hZHuHacHuhgyMegIgBRNkOuxMjP_6-H64ZOmLRgFKePwhPTYefiLXulCTmuWWnSS8fgJNJdJ4RqOMonMJuI-vmO5FG2wddhr66XIs-5liV857H&__tn__=%2CO%2CP-R,23,0,positive,23
pfbid0XYV1EzgJkQmZhQrTt9Lh4mMMBWN5xLr12rWnVSKDiy2bSXaQB4A81iVfBTonNEsul,NVIDIA AI,0,11,0,0,1,0,0,0,12,0,"You can now visualize and compare multiple training experiments and easily determine the best tuning option that maximizes the performance of your #AI model, with #NVIDIATAO Toolkit 4.0 and Weights & Biases #autoML platform.Read more: https://nvda.ws/40uDKSs",2023-02-06T00:00:00,[],https://external.fcai19-7.fna.fbcdn.net/emg1/v/t13/5577540134654426231?url=https%3A%2F%2Fdeveloper-blogs.nvidia.com%2Fwp-content%2Fuploads%2F2023%2F01%2FStreet-view-with-cars.png&fb_obo=1&utld=nvidia.com&stp=c0.5000x0.5000f_dst-jpg_flffffff_p500x261_q75&ccb=13-1&oh=06_AbF4rNsFyQqFBJZHHx4bswjVzOH70WOHbhjDkENVmK08fQ&oe=64E0B770&_nc_sid=dbad39,https://www.facebook.com/NVIDIAAI/posts/pfbid0XYV1EzgJkQmZhQrTt9Lh4mMMBWN5xLr12rWnVSKDiy2bSXaQB4A81iVfBTonNEsul?__cft__[0]=AZWkYgAfUS0XwQf_R-aE6M81iBZj4zi9XdKyE0EmMmB7rl61I_aZEeuhvFYKu2zPsWa_FhoEgK3kdK9TNuuED2f7rCMz1bGQBC-i4EcuXgZDv6ennijLVwr70hwCQ_IQ7oKtjYUBIsTOwQWL0g0yMwS7byI0QyabaIFKqa3bKCnbhom_sItFX2kGthvGgLrNxnAGuBjH4Vma7cYKd6IVJ8v0&__tn__=%2CO%2CP-R,12,0,positive,12
1129838814349053,NVIDIA AI,0,16,0,0,1,0,0,0,17,0,"Join us at #GTC23 to find out the latest on generative AI, where it currently stands, what it could be capable of in the coming years, and how businesses can responsibly take advantage of the technology. Register now: https://nvda.ws/3YkNU6f#genAI #AI",2023-02-06T00:00:00,[],https://scontent.fcai19-7.fna.fbcdn.net/v/t39.30808-6/329274228_1327240514729474_8454584866211740142_n.png?stp=dst-png_p526x296&_nc_cat=101&ccb=1-7&_nc_sid=9267fe&_nc_ohc=TP3n5ltc5W4AX8flnKb&_nc_ht=scontent.fcai19-7.fna&oh=00_AfBB6m0mbyycN-Nicho3eu2gJsZGUqRgKngIQNSpVaFZfw&oe=64E3F0D8,https://www.facebook.com/NVIDIAAI/photos/a.119492422050369/1129838814349053/?__cft__[0]=AZVrF_e_dhKhtqV35O0ucL23CRpSFZWFiUBgpuNdMsxylx_iRQlHLy-x4r3cTlZSETLXiMRKslFtuGaLYdpwKgJoh86wacrt38ogRpMaHKbpLbJ0GW7vj3livv25CglBiLfKkSJHy6HfAgHG0Ij7_iTiryGZmaX98uXrDtzUFtMR3rtUKZBy4UZdoxhiSmKCMn1GvuJ4IJGPirqAg4QKt05p&__tn__=%2CO%2CP-R,17,0,positive,17
1129812601018341,NVIDIA AI,0,7,3,0,1,0,0,0,11,0,Customize and improve the voice quality of your #speechAI application with a free trial of NVIDIA Riva Enterprise on NVIDIA LaunchPad. https://nvda.ws/3ZIplS6 #texttospeech,2023-02-06T00:00:00,[],https://scontent.fcai19-7.fna.fbcdn.net/v/t39.30808-6/329123716_1274105233513534_7537507832339868882_n.jpg?stp=dst-jpg_p180x540&_nc_cat=103&ccb=1-7&_nc_sid=9267fe&_nc_ohc=GlwmWccSa58AX8onr24&_nc_ht=scontent.fcai19-7.fna&oh=00_AfC1LqszClkLkgaS9eB3g4zkm3vO8G-v4C83Q4t4HI1KLQ&oe=64E41502,https://www.facebook.com/NVIDIAAI/photos/a.119492422050369/1129812601018341/?__cft__[0]=AZX7ig7j8MnaZli4DlFdAaIlGoDkw_rC8T0LCA030p9Bze-5s92_-_Sx0LhQSldvgzJpJC5FsQZbEGd-QSJwtgyLUvg1yA4ZjnMtKQ_hyBw5j66HXOUQAFfloHDAAGYaIxTEmJk5v62EigGTlV92MK7FijvgxJkJIVAzuyI5zn5IYVTFNzcN4h-7dwUCrx4U4LchbcgwxC4iYTLvGHYSyFoR&__tn__=%2CO%2CP-R,11,0,positive,11
pfbid02z5MxsZkQyQN4D5Wk3vKyQ7iTMbhwBZFtuJrPpiXsSHgoYtSNgN4z1jRchSkVHoWel,NVIDIA AI,0,14,0,0,1,0,0,0,15,2,"Is #generativeAI good for security teams?NVIDIA CSO, David Reber and VentureBeat discuss adapting to #cyberthreats with defensive AI. https://nvda.ws/3wRObBZ",2023-02-04T00:00:00,[],https://external.fcai19-7.fna.fbcdn.net/emg1/v/t13/16165249198011528354?url=https%3A%2F%2Fventurebeat.com%2Fwp-content%2Fuploads%2F2022%2F12%2FGettyImages-1357255073.jpg%3Fw%3D1200%26strip%3Dall&fb_obo=1&utld=venturebeat.com&stp=c0.5000x0.5000f_dst-jpg_flffffff_p500x261_q75&ccb=13-1&oh=06_AbHS6gz_Je2fRA_ykSrwtwSyt3lgX8zbwNX-pmsZ7KcXtA&oe=64E09542&_nc_sid=dbad39,https://www.facebook.com/NVIDIAAI/posts/pfbid02z5MxsZkQyQN4D5Wk3vKyQ7iTMbhwBZFtuJrPpiXsSHgoYtSNgN4z1jRchSkVHoWel?__cft__[0]=AZUUYwotehfln18X8tYn_ogSf0xv8ffVoplCONFCICrxoEu0b3T_T0pNeiDa1u8yo5ii85ANQfaPsap2JRZojvxDilVyXniPDNI22TV3iCo4eQRliujQynMIIVfZutVrGv7THfolUdO7Dz9fWPgT4SOKfH2QkdcMEtcY3JHBslOvPwzgxvAg6ZfR6IA2viRkanHSkP42GpC5IvOI9oRPGlqn&__tn__=%2CO%2CP-R,15,0,positive,15
pfbid0q3haMm492xbY1E9ho5XM3tXTsNxNFch7xuyMbthNum4hA2Z89BnGLPFro35DnDZ1l,NVIDIA AI,0,7,0,0,1,0,0,0,8,0,Discover how to build cluster-scale accelerated computing applications that utilize multiple #GPUs across multiple nodes requires a distinct set of skills. Register now: https://nvda.ws/3XYKnLc,2023-02-04T00:00:00,[],https://external.fcai19-7.fna.fbcdn.net/emg1/v/t13/17790997941678934390?url=https%3A%2F%2Fprod2-sprcdn-assets.sprinklr.com%2F50276%2F7a368385-1743-463a-9b9e-3e40195b4b73-1661566813%2Fgtc23-spring-social-dli-worksh.png&fb_obo=1&utld=sprinklr.com&stp=c0.5000x0.5000f_dst-jpg_flffffff_p500x261_q75&ccb=13-1&oh=06_AbHNyyEIj5Kv51wP0bJ6AvHSWxa7Z7KEOigerDthbmralg&oe=64E012C2&_nc_sid=dbad39,https://www.facebook.com/NVIDIAAI/posts/pfbid0q3haMm492xbY1E9ho5XM3tXTsNxNFch7xuyMbthNum4hA2Z89BnGLPFro35DnDZ1l?__cft__[0]=AZUerwq2n79JTVK_sbkRtvyQQq5rV23ujwLH7HeDpPHTEB8be6O99EDY2wZIF4LYaXH4lM-q6slJWQyuWw2B5_f1XSONDUIIl1_PveXUCwRepQX8YYZhdhLEeVl6Q5CqZBNbgicSCc8TVBfvwgzd4lMONyK9QcehbJepe-xPfGXT6X9l1bopujwMN5jYJcJ0QRfh7_jldIDSRbtT41xbOGED&__tn__=%2CO%2CP-R,8,0,positive,8
pfbid0u9T8ACkbw4EtpqhcGDsBzTe4UKw51kAbKp5XCQyDwTitnudAX332MK8uWrVuXymQl,NVIDIA AI,0,8,1,0,1,0,0,0,10,1,Learn how NVIDIA Inception program member Gleamer is using AI to help radiologists identify fractures that are easy to miss. #NVIDIAInception #AI #startups https://nvda.ws/3JF8g5T,2023-02-03T00:00:00,[],https://external.fcai19-7.fna.fbcdn.net/emg1/v/t13/11274907256449775166?url=https%3A%2F%2Fi.ytimg.com%2Fvi%2Fgxn2tHaps0M%2Fmaxresdefault.jpg&fb_obo=1&utld=ytimg.com&stp=c0.5000x0.5000f_dst-jpg_flffffff_p500x261_q75&ccb=13-1&oh=06_AbFnF3bNLCcyXNqhPxIq9U6D_-tHly-hrU_1-rr1dnMpvw&oe=64E0A0C4&_nc_sid=dbad39,https://www.facebook.com/NVIDIAAI/posts/pfbid0u9T8ACkbw4EtpqhcGDsBzTe4UKw51kAbKp5XCQyDwTitnudAX332MK8uWrVuXymQl?__cft__[0]=AZUTOp3nRUYDgmhs8j5pokYAibmqQHVOU3OAqVFV0GAWuqd_CdQ5qNmnhKs8YG6_o7xX8Q_TCHsA9owl_mn3JN4n-hLSMM9HVZEYTOFgY7Qh13uiLnwQTmzYcO_jJNYv3cFUyie5QbgFqQFq9F7n4O1KEqacgMp56DyYVfvI0PdCK8t5zrZo3F3IoytX5_19GGAxLlnqgPCYb5hCi5PMnMa5&__tn__=%2CO%2CP-R,10,0,positive,10
1128040684528866,NVIDIA AI,0,8,1,0,1,0,0,0,10,1,"Leaders from startups such as Descript, Supertone, and Soniox share how they've transformed their businesses using #speechrecognition and #texttospeech technologies. Join us at #GTC23 for a great panel discussion hosted by Dr. Ahmad Bazzi. https://nvda.ws/3JxFFzA #SpeechAI",2023-02-03T00:00:00,[],https://scontent.fcai19-7.fna.fbcdn.net/v/t39.30808-6/328923536_579060660443908_4233272707036473951_n.png?stp=dst-png_p526x296&_nc_cat=101&ccb=1-7&_nc_sid=9267fe&_nc_ohc=d1NtPiZWNm0AX-qHGxS&_nc_ht=scontent.fcai19-7.fna&oh=00_AfBke5qbcHeis5OIft6ACU8bo_-KAyUGX1JfBmwTMaRkXQ&oe=64E44AE3,https://www.facebook.com/NVIDIAAI/photos/a.119492422050369/1128040684528866/?__cft__[0]=AZUeVgB-6iFjrjGc92_KbMh_f-CZtv4Tub_ZsViU2m-rJV3lNZMppY28dHQcEaZYPtIg6C5xSYZ0DSM_YxaQEaeqhH-ZA_Bb414T2ggDEfC45HuReDmsjEv7Btafsb7JXdKH85GD8hXqU90rQP0UOk2FqiMAh6TD_ygWlqaWAnjaEhUuZVdOy4_h6GxQyXRhbRqPUtAdOLATQXWHiHN5xsmQ&__tn__=%2CO%2CP-R,10,0,positive,10
1127956747870593,NVIDIA AI,0,8,0,0,1,0,0,0,9,0,"Circular recycling innovator Encina and CPFD Software deployed #Azure HPC, powered by NVIDIA, for one of the largest virtual reactor simulations run on any public cloud platform, helping design real-world #sustainability solutions. Learn more: https://nvda.ws/3YhAI1O",2023-02-03T00:00:00,[],https://scontent.fcai19-7.fna.fbcdn.net/v/t39.30808-6/326083100_2500800253401346_7099660490065881745_n.jpg?stp=dst-jpg_p180x540&_nc_cat=103&ccb=1-7&_nc_sid=9267fe&_nc_ohc=u0E64Fug62gAX-90y5V&_nc_ht=scontent.fcai19-7.fna&oh=00_AfBkH9qd9_OK0ljufdXUavlS7YXlSxPrVhqGFEeTj9ijFQ&oe=64E3C177,https://www.facebook.com/NVIDIAAI/photos/a.119492422050369/1127956747870593/?__cft__[0]=AZXsAAand3ptxdP5EqKTEd4eb__C6fLKy27wSaVqbk1eFtzCzeYcq_8Hxxf0A29wVgbLEqRh8d7sBplbs_aMnWwMP1Xort8FjkLrDwADqnMlnXJfRc2oFgo1pADL6NdsfaeBL52f-ldsiexd3dNuP3CsrVorOINyyV0WSnzKJyki5qgejaO1-sxfQvBeEBKwsZSMWQt2aYU_ceXH_OExmjQA&__tn__=%2CO%2CP-R,9,0,positive,9
1127469787919289,NVIDIA AI,0,8,0,0,1,0,0,0,9,1,"Check out our new free hands-on #recsys lab where you can prototype, test, and fine-tune a state-of-the-art session-based recommender system. https://nvda.ws/3Xo5Qg4 #recommendersystems",2023-02-02T00:00:00,[],https://scontent.fcai19-7.fna.fbcdn.net/v/t39.30808-6/326752805_1391322348366378_2808032625191769158_n.jpg?stp=dst-jpg_p180x540&_nc_cat=106&ccb=1-7&_nc_sid=9267fe&_nc_ohc=IwSlOuXg_NIAX-9Fmao&_nc_ht=scontent.fcai19-7.fna&oh=00_AfDaRr1DnxqCcp4OzOLnfSWDh_kPjrNWypDNLL8JDYCG4A&oe=64E3E7D7,https://www.facebook.com/NVIDIAAI/photos/a.119492422050369/1127469787919289/?__cft__[0]=AZVfLKVSmJJPdF4K6zYqRQKHJys6KgnD5EEbRU1sg2cASIQ3Je5s4RX9W-4F2uPh8vpqLkXGkxJ_lmXDisvvZH7wByOsffZ9kKUV986G11gYJgpagpze58YQ8ONjhHgsEvgWNUV-iV_tuI5qR5xD5poYZhXHGyuAnDmSbKkpg0SrbhAdjIUfWWtP-EHS4WuMPyzEmRjWMu-PRvEeSQHjxZmx&__tn__=%2CO%2CP-R,9,0,positive,9
pfbid0iyHBUzAX2SVBgUV33euTMWrMDqGYob8qcCxovYcH4YvnvLkKpEWtQqyYqka6d8jhl,NVIDIA AI,0,13,1,0,1,0,0,0,15,3,Why train a multilingual #speechrecognition model? You can transcribe speech in more than one language -- minus the complexity. Get tips for creating your own multilingual dataset. #NVIDIA #SpeechAI https://nvda.ws/3RoBDva,2023-02-02T00:00:00,[],https://external.fcai19-7.fna.fbcdn.net/emg1/v/t13/4386361791617344244?url=https%3A%2F%2Fdeveloper-blogs.nvidia.com%2Fwp-content%2Fuploads%2F2023%2F01%2Fmultilingual-asr-featured.png&fb_obo=1&utld=nvidia.com&stp=c0.5000x0.5000f_dst-jpg_flffffff_p139x139_q75&ccb=13-1&oh=06_AbFgLQEpNhPVWtcg68d4dwq-3wgXvis81Dx8G-wSoXoX3w&oe=64E0B4B1&_nc_sid=dbad39,https://www.facebook.com/NVIDIAAI/posts/pfbid0iyHBUzAX2SVBgUV33euTMWrMDqGYob8qcCxovYcH4YvnvLkKpEWtQqyYqka6d8jhl?__cft__[0]=AZVJQ2X98g1dGNUpm6xg6P8-RoofeO8UviDtp65ubFgHiYIUyfx3u5v5jdq_qfDAXf07sY0erUo2P06YnMEbgTIYWpzJ6hlc1zAgNk0Btgd3YxFHtBMT7P0Q7ulDhufwP-Zx87gzt29OOx4TYXvosIbTm5y1wXuuQIZK-Vm1m-HzpmXeBkcxteRe_00rg_ZLj_2HkMpX7BbJ2Yl-fcRxEsyK&__tn__=%2CO%2CP-R,15,0,positive,15
pfbid032mKBWyWagkNnjZNrCMkMvX6MQvj7WAnM4shnWPDejycb8NP4PzTcAL634761LTSwl,NVIDIA AI,8,30,2,0,0,0,0,0,32,2,Generating 3D models from text?Our Magic3D can create high-quality 3D textured mesh models from input text prompts.Read more: https://nvda.ws/3joBJX6,2023-02-02T00:00:00,[],https://external.fcai19-7.fna.fbcdn.net/emg1/v/t13/8547985328515229076?url=https%3A%2F%2F3dprintingindustry.com%2Fwp-content%2Fuploads%2F2023%2F01%2FImage-via-Nvidia..png&fb_obo=1&utld=3dprintingindustry.com&stp=c0.5000x0.5000f_dst-jpg_flffffff_p500x261_q75&ccb=13-1&oh=06_AbGxKLNeCyRmZqd-PicgI8dh2Zxh7ePa7TLfLa4OBClnQQ&oe=64E07457&_nc_sid=dbad39,https://www.facebook.com/NVIDIAAI/posts/pfbid032mKBWyWagkNnjZNrCMkMvX6MQvj7WAnM4shnWPDejycb8NP4PzTcAL634761LTSwl?__cft__[0]=AZXh97kcNlQPuuABiteVIpHqDTIqSpZ-4yTiymmHcUa6AE--fEp6rNyMz2BmU8lqG8unI5afyImHhyd3qX04zBi6cWJ1TAQzW42_r1Ko0cUaXha77vL3ZEHVD45G_anyTnHgjXFNvfe2WIdw3H44qUE0-XYgmqAvLkJl5eACroY5TmzScqJVY-15mzNI_V5zK9a_4n4KzXYRkokis10RwxNU&__tn__=%2CO%2CP-R,40,0,positive,40
pfbid02w2LFM3Kk62W3KxcRZ7ETdpUYjJzPsdQ9aDaPJFc4DHhHN9qH7n9wdf2Ry2EbxbLfl,NVIDIA AI,0,12,0,0,1,0,0,0,13,2,Advanced trading firms are building deep neural networks for more profitable low-latency trading and rapid backtesting.Technical walkthrough: learn how GPUs accelerate LSTM model inference in the new STAC-ML inference benchmark by NVIDIA & Supermicro. https://nvda.ws/3l44bhA,2023-02-02T00:00:00,[],https://external.fcai19-7.fna.fbcdn.net/emg1/v/t13/16076170141560869235?url=https%3A%2F%2Fdeveloper-blogs.nvidia.com%2Fwp-content%2Fuploads%2F2023%2F01%2FGPU.png&fb_obo=1&utld=nvidia.com&stp=c0.5000x0.5000f_dst-jpg_flffffff_p500x261_q75&ccb=13-1&oh=06_AbG0BdeLJpmdhNIcwoHBjrHK9uDO2UFRvRgAqvSG5YuNxg&oe=64E0A769&_nc_sid=dbad39,https://www.facebook.com/NVIDIAAI/posts/pfbid02w2LFM3Kk62W3KxcRZ7ETdpUYjJzPsdQ9aDaPJFc4DHhHN9qH7n9wdf2Ry2EbxbLfl?__cft__[0]=AZXPPr5SybrPi_7g2Yc0IOEK5WXU5FkHN5_AJtSLWOk8PLq4hGWeI1YfrrrK7vj1yz5qQlXBlrjC0bag3a4IGqxxbaKAwCQ6be8-DWHw0SVsB1UfoKl596_Tm4A6zPx88fqI3ktuGod1Arsj0UbQWp3dN-igC-WohJABxuTa6J32UW6jZVbsI0cY_WOIyDucsSA2ytnaZUSYJshKWnR2ksmq&__tn__=%2CO%2CP-R,13,0,positive,13
1127322117934056,NVIDIA AI,12,20,2,0,0,0,0,0,22,1,"Financial services firms depend on low-latency for complex algorithmic trading models. Learn how the NVIDIA A100 Tensor Core #GPU, running on Supermicro servers, delivers top throughput, latency, and cost efficiency in the new STAC-ML inference benchmark: https://nvda.ws/3l3Aayq",2023-02-02T00:00:00,[],https://scontent.fcai19-7.fna.fbcdn.net/v/t39.30808-6/328708663_649329300528799_8727430962273908589_n.jpg?stp=dst-jpg_p526x296&_nc_cat=109&ccb=1-7&_nc_sid=9267fe&_nc_ohc=2PQYMGm2r4wAX_r8_PZ&_nc_ht=scontent.fcai19-7.fna&oh=00_AfAyhW-87U2eGEfhSnKZtynfETrga86OhPZ_Vnp13AelGQ&oe=64E36D8C https://external.fcai19-7.fna.fbcdn.net/emg1/v/t13/2408627796592230610?url=https%3A%2F%2Fmedia4.giphy.com%2Fmedia%2FmJoc5piKiLT9e%2Fgiphy.gif%3Fcid%3Dcafe52e99qp9jmuh76brtejdo9nrjjj2vw8wbz4maj4h0ifi%26rid%3Dgiphy.gif%26ct%3Dg&fb_obo=1&utld=giphy.com&stp=dst-gif_q75&ccb=13-1&oh=06_AbGvZLJwNwlYPtAs9FN9muMUgQ6E-mZuDYMO2lOTt2qqbw&oe=64E02774&_nc_sid=645d17,https://www.facebook.com/NVIDIAAI/photos/a.119492422050369/1127322117934056/?__cft__[0]=AZUKNQJYayRTnOZz_O6J5XpCRAEgukrwL9UsNAEz7ondquObtuioHDAPp4A_byLtdtTRUnENX4LqMaCODj42SxpTKcF1bRoWhXMYj7vIu12HMJsIQGfWQbYGlUwxtUEZZHmd21bV_ZUpz3_Dt7UqoRSSqgAyaQRX7R3HL7bledQEt7YqEbWwd1f5dlzAFqsMZCL1mURTBqG8_7ntsWRUTR8P&__tn__=%2CO%2CP-R,34,0,positive,34
1127297464603188,NVIDIA AI,0,16,1,0,1,0,0,0,18,3,"Updated resources! See how universities around the world are tapping into NVIDIA GPU-accelerated supercomputers to better equip educators, researchers and students with the tools they need to transform the future of higher education. https://nvda.ws/3WRqqnX",2023-02-02T00:00:00,[],https://scontent.fcai19-7.fna.fbcdn.net/v/t39.30808-6/328704450_1248364332740719_6322986019686148970_n.jpg?stp=dst-jpg_p180x540&_nc_cat=110&ccb=1-7&_nc_sid=9267fe&_nc_ohc=yBaa2S1LR30AX8VI0Fa&_nc_ht=scontent.fcai19-7.fna&oh=00_AfBmKVC1LuX0oyVQRgt23ByrA3eqBWvZPRcnLkIgxuCKJA&oe=64E35DE8,https://www.facebook.com/NVIDIAAI/photos/a.119492422050369/1127297464603188/?__cft__[0]=AZWFBZUjmziSCoTNHoNxpebS6tqGbKytwL5AESmNOkL6vIc-6eevqEt7VqS2muvWmL73GD5lOG8OcjBAJ8aRr_T9rewW058NaJnF4XI8bZhaWCMslXf3sfAyWkd0n3aCBBdWTg3GtTOWYAEDReU7cvFfXUb02GJHPrRHw8Z1M7j3k6f9QgQwJfjhOTHbcWM_UA8Oy5eVSv4hPUlP1d659N9V&__tn__=%2CO%2CP-R,18,0,positive,18
1127254404607494,NVIDIA AI,0,21,3,0,0,0,0,0,24,5,"How is #AI being used in financial services? We surveyed nearly 500 industry professionals to find out. Read the blog to learn about top use cases such as #NLP and #LLMs, recommender systems, portfolio optimization, and fraud detection: https://nvda.ws/3l0bqqG",2023-02-02T00:00:00,[],https://scontent.fcai19-7.fna.fbcdn.net/v/t39.30808-6/329024343_705770704379380_212692330531166853_n.jpg?stp=dst-jpg_p526x296&_nc_cat=109&ccb=1-7&_nc_sid=9267fe&_nc_ohc=_yNld53hnAsAX8OAdHN&_nc_ht=scontent.fcai19-7.fna&oh=00_AfCJiEaEoVtf26hkTkI8sGSDtKMUQq_Z34DXI0H7RIewyg&oe=64E2F2A9,https://www.facebook.com/NVIDIAAI/photos/a.119492422050369/1127254404607494/?__cft__[0]=AZXrezHpDKqZx3mYntsge9FEthb-i17x_JBS_S3Fkm7MfGw00bdcTggkbiY5Cu5XdZQ2kW_ong08rMoqtMtev50sKsm8neLxznr9ekqNwwkCnWL3Z0irab281ctWx9GeuKirxiFZ49Hcf38ZLLYuxI_axTAXifjJ2Cg49zsvaxeo8Un8U8Wb5qmOnB4IJ0f_c2BJ3mibNa7vINB0aleBRg65&__tn__=%2CO%2CP-R,24,0,positive,24
pfbid09xptvDfJhv5zVjd1xRk4oLooS6nZU7vUwDYMBwLiS4qBqdTAnGn2wcQRD62S6Chbl,NVIDIA AI,0,7,0,0,1,0,0,0,8,0,Learn how to use Transformer-based natural language processing models for text classification tasks and more in this Deep Learning Institute workshop at #GTC23. Register now: https://nvda.ws/3Js7R6W #NLP,2023-02-01T00:00:00,[],https://external.fcai19-7.fna.fbcdn.net/emg1/v/t13/5467813748501070596?url=https%3A%2F%2Fprod2-sprcdn-assets.sprinklr.com%2F50276%2Ff36c366e-86b2-4697-b727-afebc037ee59-1125848674%2Fgtc23-spring-social-dli-worksh.png&fb_obo=1&utld=sprinklr.com&stp=c0.5000x0.5000f_dst-jpg_flffffff_p500x261_q75&ccb=13-1&oh=06_AbGBe4twSuurOK0sR_OLPzIdYbtNpF076F9Y7HNwUjYfmw&oe=64E0AEA0&_nc_sid=dbad39,https://www.facebook.com/NVIDIAAI/posts/pfbid09xptvDfJhv5zVjd1xRk4oLooS6nZU7vUwDYMBwLiS4qBqdTAnGn2wcQRD62S6Chbl?__cft__[0]=AZVxLD5GbFejHUBtfEFJymev49IfCxLjPAcFi8KtSCMONmgmjH0_sxWT7XYQXeKde0v8N01JkJy5ms7ILaHHeRqhM5ZcCjXhEgxAYET-tinTDOsyGBWxlHMV0yX0IYMvi_bbRmmsyzuc1Biq0k6jxvCXSskQ_3rVqiN3xAI_fjeLYQvDjO9YmDbl4iFwfAIRHR2H9YVxX29amB7OzThDH2Ni&__tn__=%2CO%2CP-R,8,0,positive,8
pfbid02JSALgoKC1LoLPV2rqFtJLaGMTKsTifcMNGPfzzmtwYPDbHXjh89PkwZQpM7uBM8Zl,NVIDIA AI,0,12,0,0,1,0,0,0,13,0,#SpeechAI is revolutionizing how we interact with smart devices. Learn about the latest #speechrecognition & #texttospeech technologies & how speech AI can be applied to real-world scenarios. https://nvda.ws/3JA4smm,2023-02-01T00:00:00,[],https://external.fcai19-7.fna.fbcdn.net/emg1/v/t13/13578295298820439872?url=https%3A%2F%2Fdeveloper-blogs.nvidia.com%2Fwp-content%2Fuploads%2F2022%2F12%2Fgtc-speech-ai-demystified-repurpose.png&fb_obo=1&utld=nvidia.com&stp=c0.5000x0.5000f_dst-jpg_flffffff_p500x261_q75&ccb=13-1&oh=06_AbHnJZR4wKgexr0UhZD86OerzeRGlXM8zUM_0xMTy0Fg8A&oe=64E0835F&_nc_sid=dbad39,https://www.facebook.com/NVIDIAAI/posts/pfbid02JSALgoKC1LoLPV2rqFtJLaGMTKsTifcMNGPfzzmtwYPDbHXjh89PkwZQpM7uBM8Zl?__cft__[0]=AZXK4bE020_JZTgPhDCn5ZLfo-L2T0rZwg9Pfcg1VOXBw7SnHKwKuAlnSL1i2JwjKmeARsUQ45P8fN1VytsWyBEXh2-7Li_XuJ59fygnz5G-A3tE7li-ujxHIvSci3EvG2sqjEHIaIVOfG9BKqbBJFKeALrJwvnDakhDgXkJvBBs_4LDzRc5CN3hrM83h7l6McphmhV0WT5Wb1oPSgZFlmti&__tn__=%2CO%2CP-R,13,0,positive,13
pfbid0dWa1v1nzuwS2SeKbHc2R9tAxTRKSRDqenb5QQbdL2qWP6kXVZ5J4aViRCjirFc3Rl,NVIDIA AI,0,8,0,0,1,0,0,0,9,0,"Service robots are becoming the new norm, from restaurants to hospitals. Learn how #speechAI for service robots can be customized for industry-specific jargon and languages. #speechrecognition #texttospeech https://nvda.ws/3kKbLxy",2023-02-01T00:00:00,[],https://external.fcai19-7.fna.fbcdn.net/emg1/v/t13/14042862122358480218?url=https%3A%2F%2Fdeveloper-blogs.nvidia.com%2Fwp-content%2Fuploads%2F2022%2F12%2Fsmart-retail-robot.jpg&fb_obo=1&utld=nvidia.com&stp=c0.5000x0.5000f_dst-jpg_flffffff_p500x261_q75&ccb=13-1&oh=06_AbG_GreyEwrl9V8VsZsXLqEewGHTIpDqGpKvtoBa1_jA8Q&oe=64E069AA&_nc_sid=dbad39,https://www.facebook.com/NVIDIAAI/posts/pfbid0dWa1v1nzuwS2SeKbHc2R9tAxTRKSRDqenb5QQbdL2qWP6kXVZ5J4aViRCjirFc3Rl?__cft__[0]=AZXo-5dp8Op00tdLJ3AAjiTfA6d_gcFnkCX8SBC5eLKIjHxsfarhQFrhixOqxF4PFyMj6BHBD2ebESiP2cs-lzqG2PxPIkbdz9SiKCeeUfT9jHWJmhHyUdr1WA6UtBPIfJU23d8fYonX-v70UOvy4jR6FeQSqDKXbk7k8xWXKJeHrFXSrxLESYBTY5n4L5oRRPERVYUkJRjGHrVMUzC1uYsL&__tn__=%2CO%2CP-R,9,0,positive,9
1126732491326352,NVIDIA AI,0,7,2,0,1,0,0,0,10,0,Learn how to improve your customers’ contact center experience with a speech AI-based #intelligentvirtualassistant in this webinar–now available on demand! https://nvda.ws/3X1BAra#speechAI #FinancialServices,2023-02-01T00:00:00,[],https://scontent.fcai19-7.fna.fbcdn.net/v/t39.30808-6/328906409_484256387256160_2124706669824643936_n.jpg?stp=dst-jpg_p526x296&_nc_cat=102&ccb=1-7&_nc_sid=9267fe&_nc_ohc=2oRxKQRUntAAX_KmH1K&_nc_ht=scontent.fcai19-7.fna&oh=00_AfAeJBumRcEsyh-8NUlAmLSsmWBb4evLPIeEG0EIms799g&oe=64E3A0FF,https://www.facebook.com/NVIDIAAI/photos/a.119492422050369/1126732491326352/?__cft__[0]=AZV1-bPikmMoj3mESVKjHGbBsSUI6GzD4gjwomLjgwRfhcf5ZC6KkpeLR9blCMuHwxy77flZLEmmqvYULeJfXouvHx5EBoEakIRqH7plbN63fOYTF1-1m7-EMSMnfjIDVuNSLz9FoeQrWbCCtgPn--aTQgbxBKeEmOauHqiUjdF28PRuR02xHswcCAckrCy7bx7-cVXg33NHjB2mWjlq3wMO&__tn__=%2CO%2CP-R,10,0,positive,10
pfbid06XjedX94Srdbzd4d7vgTCg3RVBccApqbshvkdKTxsrnCpanRoDGmjYL3PmKTfPbGl,NVIDIA AI,0,9,0,0,1,0,0,0,10,1,"Join NVIDIA Inception at the Machine Learning Meetup in Bangalore on Feb. 10th. Hear tech talks on #AI, #machinelearning, #data, and network with speakers and peer developers. Register now: https://nvda.ws/3HrtRMJ #NVIDIAInception",2023-02-01T00:00:00,[],,https://www.facebook.com/NVIDIAAI/posts/pfbid06XjedX94Srdbzd4d7vgTCg3RVBccApqbshvkdKTxsrnCpanRoDGmjYL3PmKTfPbGl?__cft__[0]=AZU9AZZ7yrMl_wEiv9z4UozkV3DpyFdigjm5sQr3kLnX8Kng4imXl512bsS4BT3F4nrrKV2r31ycTjAZWI3-k407jYTl0OuedvnimjyaCBZgd7xPdd-ZncyNqS6oT1l92txdPvSkWugcurypJ-N4ksCgsOAjfC18eIhU4cMoHQC6TdfDQrrgsNgjBf9rF1a6__l4dKcXkkS-KIEPWE4eNAKH&__tn__=%2CO%2CP-R,10,0,positive,10
pfbid02osszAgTw5pPE3AjUVYKLWDozGELrNFZGnfFZGGii2kQEEahzqFtRggY4vp9dn7RAl,NVIDIA AI,0,18,2,0,0,0,0,0,20,0,"“If we’re going to create a 3D internet, then you have to have the people who are participating in it creating content as well…#AI can help us.” Read more on what NVIDIA VP Rev Lebaredian said about NVIDIA Omniverse & the #metaverse in TIME: https://nvda.ws/3JCgdbY",2023-01-31T00:00:00,[],https://scontent.fcai19-7.fna.fbcdn.net/v/t39.30808-6/328246017_3359206564351771_2201392902323148457_n.jpg?stp=dst-jpg_p526x296&_nc_cat=104&ccb=1-7&_nc_sid=9267fe&_nc_ohc=Y7tpRSgjHsQAX86yHly&_nc_ht=scontent.fcai19-7.fna&oh=00_AfDIIvD7uGpELRnREblXOJS1NordWWoT0LBkbZdvmsyxBg&oe=64E45925,https://www.facebook.com/NVIDIAAI/posts/pfbid02osszAgTw5pPE3AjUVYKLWDozGELrNFZGnfFZGGii2kQEEahzqFtRggY4vp9dn7RAl?__cft__[0]=AZVBxW8ey597Nn2-Pdh970p6hWz01mnMDyQEBbQHnlW6sq8ukkmw5sq6Yqy9STAEbeh-NyqDFQ4dkwVkfd1pa9pvTQl1KCIXvhbgNef7OcdWFMzkEgJaAGK117AwEEroW_ZxDuRePUjsdC0JRaw11tmxg0LtdykhX_cNnRKiiW_ivVtvYGMcZOMzbLPVbFWkFlrCjcmdOSxw4-atVgE_gsSM4YjKYNrNeWC7XauM-iJ4MgIkEz2dkjchEukHwwq-h6MQu4jUUG9K_Lve2aQtwnS_&__tn__=%2CO%2CP-R,20,0,positive,20
pfbid02SfQjYTWJyttK7RBc6jeTShbkTCTM3hAvQQxKPLw5Qm429hAiRr8YHAT749WRwbfzl,NVIDIA AI,0,5,0,1,1,0,0,0,7,1,"Capture, Render, Win: Announcing the #InstantNeRFVR Contest  Read more about how to create an immersive scene with our new Instant NeRF VR software for a chance to win an NVIDIA GeForce RTX 3090 Ti graphics card.  https://nvda.ws/3wLCQTK",2023-01-31T00:00:00,['https://video.fcai19-7.fna.fbcdn.net/v/t42.1790-2/327799931_3450096195227679_2537192509090799607_n.mp4?_nc_cat=107&ccb=1-7&_nc_sid=985c63&efg=eyJybHIiOjQ4MCwicmxhIjo1MTIsInZlbmNvZGVfdGFnIjoic3ZlX3NkIn0%3D&_nc_ohc=QIeYRDg_jzwAX91pOWi&rl=480&vabr=267&_nc_ht=video.fcai19-7.fna&oh=00_AfBzf0ZpTXIiAnlEhUsukAawIQxdJNhjqLg3qhnAZ9Rdig&oe=64E397A4'],,https://www.facebook.com/NVIDIAAI/posts/pfbid02SfQjYTWJyttK7RBc6jeTShbkTCTM3hAvQQxKPLw5Qm429hAiRr8YHAT749WRwbfzl?__cft__[0]=AZWStivB4rLqn_VuxXDK1kBAZZ35nVM8zo7VUohAc_KBLMrnSEqLzyScR5JZFYA9ydGxI3ml5hK4E91_UzSVGoONDfAYbXVHpTFUGc_hD5SZJ-F7EuNVygeywJ2kt4wDWuPUB-eSThAY4veNc7foVnsIBQYJ9RX8v7n1fZVK6_CGdMbyXF1gorjysZyMP-v7l9fgvRd6JQSATUspiTiQk4vxYT8MQ_l-ZI0qwNywG0wXeQ&__tn__=%2CO%2CP-R,7,0,positive,7
1126148981384703,NVIDIA AI,0,13,0,0,1,0,0,0,14,0,"We are excited to announce a special event at #GTC23 - Speech AI Developer Day. This one-day event will delve into the latest advances in automatic speech recognition, multi-language translation, and text-to-speech. Join us and take your skills to the next level. Register now. https://nvda.ws/3HkvMTe #SpeechAI",2023-01-31T00:00:00,[],https://scontent.fcai19-7.fna.fbcdn.net/v/t39.30808-6/328351948_488853176549957_9005248848238490129_n.png?stp=dst-png_p526x296&_nc_cat=103&ccb=1-7&_nc_sid=9267fe&_nc_ohc=hz3KQXbq524AX8fuB22&_nc_ht=scontent.fcai19-7.fna&oh=00_AfAvJlbMZkKIosk_84NC3nEbwB3-KjQpnOLRJjL-JqpcCw&oe=64E352DE,https://www.facebook.com/NVIDIAAI/photos/a.119492422050369/1126148981384703/?__cft__[0]=AZVzzH916yzY8N8ZOl35h7faaIEtFFx5hMlImMVIs-GIKEphBQ3cn34YVniwDVkIuxMJRLHVcrYMhYQ_C-9kZdHtocClxaHwd3ni-5NyP90aee8gP1GQjY9ah_RQZVNAqkihgg7daSWrlV-5EUD8XuVMwJ-hogRyg2hTb90D5XYcnVff1opcjEy8BzMep2xedWrawQq9Abuc95wekfGeBT9y&__tn__=%2CO%2CP-R,14,0,positive,14
1126093338056934,NVIDIA AI,0,6,0,0,1,0,0,0,7,0,Did you know that 70% of financial services firms that represent about half of the total market cap deal with missing data? Learn a novel method to impute missing values and the impact for asset pricing. Join us on February 9 at 9 AM PT: https://nvda.ws/3H03OMc,2023-01-31T00:00:00,[],https://scontent.fcai19-7.fna.fbcdn.net/v/t39.30808-6/326943900_3530612160543272_100955846192976453_n.jpg?stp=dst-jpg_p526x296&_nc_cat=102&ccb=1-7&_nc_sid=9267fe&_nc_ohc=vCy1khfPADAAX-OAomG&_nc_ht=scontent.fcai19-7.fna&oh=00_AfAugP4Ew36cZ77P3Lq4SvgaaL2NpyLpmX73iKlRtFsXtw&oe=64E4A56F,https://www.facebook.com/NVIDIAAI/photos/a.119492422050369/1126093338056934/?__cft__[0]=AZXrBeLtvlH9LKocqG2yg8Qpttumjs1bLb46ar3gQpvbDP-3oMH1b7WBlNYbd9GBVbk0_--jhtKoJS3PCl8wElIR-31DgEuMyiy9Fxts1GDzJMzlVeg_9oYsikELWe4aM56SW0jvHek312iBiUvLgMNW1cqG0IlrjbjBs3sEfYf1G4qUsS3iO8MYKpXregDprnmhOu82WxM8CQuYmD0k9zt1&__tn__=%2CO%2CP-R,7,0,positive,7
1125549704777964,NVIDIA AI,0,17,1,0,1,0,0,0,19,4,"Build a world-class accurate audio #transcription service with free access to NVIDIA's hardware and software stacks, guided step-by-step labs, and support from NVIDIA experts. https://nvda.ws/3J1BWde #SpeechAI",2023-01-30T00:00:00,[],https://scontent.fcai19-7.fna.fbcdn.net/v/t39.30808-6/323868597_500462342237388_8699207928148892825_n.jpg?stp=dst-jpg_p526x296&_nc_cat=101&ccb=1-7&_nc_sid=9267fe&_nc_ohc=Q6Vrd-TQWYEAX9hMxFE&_nc_ht=scontent.fcai19-7.fna&oh=00_AfDK34wlLdZUbVmPlH6K4DcECAZsiSIcgnSjA-zCdEDcjA&oe=64E37D90,https://www.facebook.com/NVIDIAAI/photos/a.119492422050369/1125549704777964/?__cft__[0]=AZUW--QM6eFpxZ4lCVnfO-J1r3Ixg9J4zDikSaLsFBwqLMNy73PwluHDAvTgdMIM3ndgVZ-qMu96AoOhipDhK7JCFFjTxehQ_CGNh3Kw4m9gehtlVL4FElbM-nYSazqIPFzgLYL3wI53ywnomBCTRdH5XqLCGQvxpEZsLEXhBkxiD7zOfbEPwmV48S_qLtrNxfa1lMcKmfOioVPULx5gGTgt&__tn__=%2CO%2CP-R,19,0,positive,19
pfbid0z6nNKRTeUPP5JXFMUfM3ZLHixJHzHr13terfSWWSMAToikUmqQ4UMQdtJum4Cnxrl,NVIDIA AI,0,7,1,0,1,0,0,0,9,2,"Have you explored our new #InstantNeRF #AIArt gallery with 3D renders from Italy, France, New York, Montreal, and Singapore by NeRF artists Jonathan Stephens, Franc Lucent, Hugues Bruyere, Karen X. Cheng and James Perlman?   https://nvda.ws/3DlcFqC",2023-01-28T00:00:00,['https://video.fcai19-7.fna.fbcdn.net/v/t42.1790-2/327226751_591465079486226_7178778503222206562_n.mp4?_nc_cat=101&ccb=1-7&_nc_sid=985c63&efg=eyJybHIiOjUzMiwicmxhIjo1MTIsInZlbmNvZGVfdGFnIjoic3ZlX3NkIn0%3D&_nc_ohc=oR3EOJur-IkAX-yaAm9&rl=532&vabr=296&_nc_ht=video.fcai19-7.fna&oh=00_AfAfPNSax3qGs4PnIsSX8Zr8Y2_m4NEzW-3mcYRFgOF_Fw&oe=64E34A16'],https://scontent.fcai19-7.fna.fbcdn.net/v/t15.5256-10/327891201_1160095998036897_6387724676910833978_n.jpg?stp=dst-jpg_p960x960&_nc_cat=103&ccb=1-7&_nc_sid=ad6a45&_nc_ohc=HIadOHFo-B4AX-Bfful&_nc_ht=scontent.fcai19-7.fna&oh=00_AfCn5rTvdrmvZBALGXhFMeuItXeHbh78DQO_lw9HvsjVkw&oe=64E4A4A3,https://www.facebook.com/NVIDIAAI/posts/pfbid0z6nNKRTeUPP5JXFMUfM3ZLHixJHzHr13terfSWWSMAToikUmqQ4UMQdtJum4Cnxrl?__cft__[0]=AZWJMK5b15eZimCAuNB-4i5YWztKGOZgblwhTlaqNTzhM_Dcq14iF7JLh2RFNiQTk5pbL_INuKvLEplYSXEjwMziclDnpDtvo_HSif_9WZyixwTEgkB1Xckp5-DrH2e7dVXAisTLuoPFJvt4HrJPMXPRliZnzptDXZ4QVmUOKEImB-ZYjF3y4pvihm__dhIGe8T-T3HwTqviGz_NOePhfvfknFMCb-9bOaIzmn6VQ8U2DA&__tn__=%2CO%2CP-R,9,0,positive,9
pfbid02PcP21w5e6bLoTxpVqQBgZhLBWLpS3fSSDnXZyqD3vSEf2UcUFt5wz4fw1wun51mQl,NVIDIA AI,0,13,0,0,1,0,0,0,14,1,80% of all web application breaches involve credential abuse.Find out how #AI-powered #security helps prevent attacks. https://nvda.ws/3Hf4rBw,2023-01-28T00:00:00,[],https://external.fcai19-7.fna.fbcdn.net/emg1/v/t13/14018794306671458214?url=https%3A%2F%2Fblogs.nvidia.com%2Fwp-content%2Fuploads%2F2022%2F12%2FAI-security-pixbay-x1280.jpg&fb_obo=1&utld=nvidia.com&stp=c0.5000x0.5000f_dst-jpg_flffffff_p500x261_q75&ccb=13-1&oh=06_AbFw--UyHA_RnfbghG2S73uhTiXlVoJnRfXrDmN1byCL3A&oe=64E07A90&_nc_sid=dbad39,https://www.facebook.com/NVIDIAAI/posts/pfbid02PcP21w5e6bLoTxpVqQBgZhLBWLpS3fSSDnXZyqD3vSEf2UcUFt5wz4fw1wun51mQl?__cft__[0]=AZWeLzepGqJtjSbggsF09vyAhQek8pYA98u6oIJmLIAJZ7JpOgJ0b14PXzYUO6ZzWo3ieQXFIcj_yVHqHymGuftnZz_YacVBP7nJw2Hh51v3oU33F5fF7BkX_EMRYNuAB7CHzorTFTTZLjL5mRnVetlqUw1bTtIYAXCUJIUL0uK31p0Ue3aZ1O6SR1hbMWD4WnxfquJvgifBKPGZB7PDDmtK&__tn__=%2CO%2CP-R,14,0,positive,14
1123881538278114,NVIDIA AI,0,38,4,0,0,0,0,0,42,2,"Join top researchers, engineers, and developers as they share the latest breakthroughs in #AI including diffusion models, LLMs, and more. Schedule #GTC23 sessions that help you do your life's work: https://nvda.ws/40bH04Q",2023-01-27T00:00:00,[],https://scontent.fcai19-7.fna.fbcdn.net/v/t39.30808-6/325771496_1012880086340046_1912307343922420385_n.jpg?stp=dst-jpg_s640x640&_nc_cat=107&ccb=1-7&_nc_sid=9267fe&_nc_ohc=5Y-vtZt4l8MAX9kv8MW&_nc_ht=scontent.fcai19-7.fna&oh=00_AfC2JQuvcoVtQL9PaQiYVV8kz2JCZWpEZplJXzn1ozXpPw&oe=64E48811,https://www.facebook.com/NVIDIAAI/photos/a.119492422050369/1123881538278114/?__cft__[0]=AZWWH6VFK51sIre4qc0Qngg0br7X_4Fg8BpKUGO5twN9WaynbBYKg1wuSrBUfZqAvTucNyfpb1VgWRfQoP4uIm3nysBd5bIgeSXE6jbPnukZ64uS1M-ni1iQVIj6uTLov_s6mulpp8-uk5uWkc6QzTnyH2g_zPpytl-uTD95ZltSz_aWWAxSzPjBrlHd3OUo8HdnFbERdjlCBTDXO8qePO13&__tn__=%2CO%2CP-R,42,0,positive,42
1123809328285335,NVIDIA AI,0,8,1,0,1,0,0,0,10,2,Did you miss our webinar on how to build a #speechAI based #intelligentvirtualassistant for contact centers? Catch it on-demand to learn how you can improve your customer satisfaction scores and provide effective customer self-service with digital agents. Register now! https://nvda.ws/3XWmqnh,2023-01-27T00:00:00,[],https://scontent.fcai19-7.fna.fbcdn.net/v/t39.30808-6/327794362_913028086560623_3031823847863060354_n.jpg?stp=dst-jpg_p526x296&_nc_cat=104&ccb=1-7&_nc_sid=9267fe&_nc_ohc=F3VF_cIIgIYAX9HNi-f&_nc_ht=scontent.fcai19-7.fna&oh=00_AfBtBQXJ8PIeQy2IIIr_JSRwddiDID-3s1hHC56P3GCbDQ&oe=64E2FF86,https://www.facebook.com/NVIDIAAI/photos/a.119492422050369/1123809328285335/?__cft__[0]=AZU5yM0fd1YlPPmKpfrm16YfQwImAqto6vkwDjqeGKrjKC2fpsFZSQIMlLtBUj-mIhPrgqeD2d4HdoCSksiq4W-T2AKoZGKCDvAYXhNV3-IY4P54nD3kHjgZZpT-N3p1n9svpBshhBfhruzssBgbdQx1uTuY4VfnN_j0gMKInXwVsPzLb-K2Xk3k6Z6_gc74mujKeiljgADubDTtBSNCHcow&__tn__=%2CO%2CP-R,10,0,positive,10
pfbid02Ed1b5ALUDmoYgKWnrwrUKiSXEJztF9Wk6jK5xiU2Fdb1wxGH2kXtB6EpBnhfpYVhl,NVIDIA AI,0,8,0,0,1,0,0,0,9,0,"Learn about the Berzelius #AI supercomputer at Linköping University that is inspiring the next generation! This innovation engine is gearing up for a major upgrade to drive advances in machine learning, healthcare, and more. https://nvda.ws/406KDZX",2023-01-27T00:00:00,[],https://external.fcai19-7.fna.fbcdn.net/emg1/v/t13/8643869877368859463?url=https%3A%2F%2Fblogs.nvidia.com%2Fwp-content%2Fuploads%2F2023%2F01%2FAnders-Ynnerman-YT2-scaled.jpg&fb_obo=1&utld=nvidia.com&stp=c0.5000x0.5000f_dst-jpg_flffffff_p500x261_q75&ccb=13-1&oh=06_AbE56DcqDZTbdiRz4XAox4TOVKlMWOP8JXjw50yHSXB6Fw&oe=64E08097&_nc_sid=dbad39,https://www.facebook.com/NVIDIAAI/posts/pfbid02Ed1b5ALUDmoYgKWnrwrUKiSXEJztF9Wk6jK5xiU2Fdb1wxGH2kXtB6EpBnhfpYVhl?__cft__[0]=AZWLHafRLXAHfbcLRfvM2AWaH3yJAbDQquIaou_xoU8BwSV22c7G3Vdh8t7xjjhgBa9H1a2jOaBvfOuWRFxCFUcIbDKSF1vBQGRiLxSHxNwOOFFnMMTRQEOtGFO00SzpnPP6IsbqX5ET7GX7ITh8jU5LdRvDL5dvHE-Go7Em88-392Sttu6V9i5eGBFTwECRavTiW5QAQdUC_1FnhpioPJAH&__tn__=%2CO%2CP-R,9,0,positive,9
1123752318291036,NVIDIA AI,0,18,0,0,1,0,0,0,19,3,At #GTC23 the Kaggle Grandmasters of NVIDIA showcase how to develop and evaluate new machine learning models in a short time frame without burning out in the process. Register now! https://nvda.ws/3kNu1X1  #datascience #ML,2023-01-27T00:00:00,[],https://scontent.fcai19-7.fna.fbcdn.net/v/t39.30808-6/327548421_1163716504281944_8338927978876314081_n.jpg?stp=dst-jpg_p526x296&_nc_cat=109&ccb=1-7&_nc_sid=9267fe&_nc_ohc=e8ij-2T_wbUAX9OpUGy&_nc_ht=scontent.fcai19-7.fna&oh=00_AfD91t3pgdMF-ufnPZKRb1MRCqEInXIuwjMPOq4bo_mnsA&oe=64E303AE,https://www.facebook.com/NVIDIAAI/photos/a.119492422050369/1123752318291036/?__cft__[0]=AZXpE-2EZyTEt8hKiWdwHcpjXZ5kVWG1VwFrAS73I_5Xm-mh9DGYXWsCKXHuICBvftwbm6Qh-EYMMeVB5UEOznsU1Dc2fw6NmcAPJr_q8OyfVLIjjqdB-DYQA9_k1BIgb7h-TVh2FU7iaRI-YPCSqmhkBPxvHBW6xPutPsQGHc1Kcwgvwff4tlIiAQUCwDu5eKGyjBxWhi7mnofzF-hWuvbe&__tn__=%2CO%2CP-R,19,0,positive,19
1123351064997828,NVIDIA AI,0,11,0,0,1,0,0,0,12,1,Join us at #Manifest2023—2/1 at 2:55 p.m. PST— to hear from industry experts how #simulation and the implementation of automation inside warehouses are being deployed to address the shift towards e-commerce. https://manife.st/?ncid=so-face-190174-vt23...,2023-01-27T00:00:00,[],https://scontent.fcai19-7.fna.fbcdn.net/v/t39.30808-6/327435456_577003440630194_577494359206623414_n.jpg?stp=dst-jpg_p180x540&_nc_cat=106&ccb=1-7&_nc_sid=9267fe&_nc_ohc=2qDjSC3huZcAX9etyXx&_nc_ht=scontent.fcai19-7.fna&oh=00_AfCb06KO63_TTahAEq4pVvgEJ3vfmMD_oFeMCgc1M8HPOw&oe=64E34CA0,https://www.facebook.com/NVIDIAAI/photos/a.119492422050369/1123351064997828/?__cft__[0]=AZWaTCfDcxa0SkNyUXgknn2x-Dcgr5hlDlQyl-tLGkYhJPrO_ofziZzrL_QHlbCcpMAnbmIxh3p55sW92HIYe7ubwFZYVvOBAd_rzkfC8sgVy7LzCyr8lhKBxIUGGFX5lLt1xVDNVIQIaY1QGod-wJP0Xhs7DSnDfGP6nwqPsN8eRFtbyBKXqpieLr6eMt4VbxspcST9sGJ7NPaz8FZfu-33&__tn__=%2CO%2CP-R,12,0,positive,12
pfbid03dt2hFkZPCNF2xn2rVnFnaZ8YVY9frm4ECsdQSn5qzT15pJGPsS5MXEpjPMWuvcpl,NVIDIA AI,0,9,0,0,1,0,0,0,10,1,Discover how deep learning works through hands-on exercises in computer vision and natural language processing in this DLI workshop at #GTC23. Register now: https://nvda.ws/3wz3xLy,2023-01-27T00:00:00,[],https://external.fcai19-7.fna.fbcdn.net/emg1/v/t13/13998055435110554874?url=https%3A%2F%2Fprod2-sprcdn-assets.sprinklr.com%2F50276%2Ffeb6c547-d2f1-42a5-ae31-6e8b4309d987-381703135%2Fgtc23-spring-social-dli-worksh.png&fb_obo=1&utld=sprinklr.com&stp=c0.5000x0.5000f_dst-jpg_flffffff_p500x261_q75&ccb=13-1&oh=06_AbFdPmyGGVakEwts1MCcJk2Z6VRtILapqaezoltaBexw0w&oe=64E07F00&_nc_sid=dbad39,https://www.facebook.com/NVIDIAAI/posts/pfbid03dt2hFkZPCNF2xn2rVnFnaZ8YVY9frm4ECsdQSn5qzT15pJGPsS5MXEpjPMWuvcpl?__cft__[0]=AZV1jNuvTFda1yyBD9Lrf4KxuFaztBX8-_ZGbVLpe10JO_JNKKACVU8RSMr1cxfkCg2wDDy02JXBipGNQzV8RoB4m5BbW6Pc0xu3PatO6q280N6Kq06EOOY4AFv-4kANzamX5-uNLp9uuHhv-d_IpFNCXBHH7bs3Av_tFnIJkv0w3h1AxftsklixEPLpZFwDWygHuC19Flx78tybPjGqPnvT&__tn__=%2CO%2CP-R,10,0,positive,10
pfbid0Nxp6NCiEL6UY2BaD2gVvDvgdihvr4qLwDexvuTYJ9oDXks6ncBFTiCnHG1R81ZgJl,NVIDIA AI,0,17,0,0,1,0,0,0,18,3,Experience more control at the edge.Meet the unique demands of your edge AI deployment with NVIDIA Fleet Command. https://nvda.ws/3j5WIOp,2023-01-27T00:00:00,[],https://external.fcai19-7.fna.fbcdn.net/emg1/v/t13/4611503563907695452?url=https%3A%2F%2Fdeveloper-blogs.nvidia.com%2Fwp-content%2Fuploads%2F2023%2F01%2Ffleet-command-2.jpg&fb_obo=1&utld=nvidia.com&stp=c0.5000x0.5000f_dst-jpg_flffffff_p500x261_q75&ccb=13-1&oh=06_AbEdRjY4healkVIjG4rcVsdkAuDM3T4QSXRykKU5N6aFsw&oe=64E021FB&_nc_sid=dbad39,https://www.facebook.com/NVIDIAAI/posts/pfbid0Nxp6NCiEL6UY2BaD2gVvDvgdihvr4qLwDexvuTYJ9oDXks6ncBFTiCnHG1R81ZgJl?__cft__[0]=AZXkirLu52vQiMQeNVfQ_GOxXOkMaNUZ-COtwfCdmhOE7Xg3X535pm-BEl0lMRiESCgNz2TzlBztEBP4zmvZiRx0xqja9BpC34bXbC9kLdWgzmkJANuZzfqk070vLjDiDdwZF0eHZKEsUHtHFSigyHOPmuSKpakdIT95P_ML90NLfSrLi0vnsuRJKc0Y6iHJiZX8hLzPhi0McAVU6ZrroRWo&__tn__=%2CO%2CP-R,18,0,positive,18
pfbid02HpfjGw2SHcw2stnPFw6AjjctNzmkL2vpG7qBcxgKykmLKwYv8Hd3YodyPJ9odQr6l,NVIDIA AI,0,10,0,0,1,0,0,0,11,0,"Large language models recognize, summarize, translate, predict and generate text and other content. Check out this explainer blog to learn how LLMs work and what they are used for: https://blogs.nvidia.com/.../what-are-large-language.../...",2023-01-26T00:00:00,[],https://external.fcai19-7.fna.fbcdn.net/emg1/v/t13/4925774093103698202?url=https%3A%2F%2Fblogs.nvidia.com%2Fwp-content%2Fuploads%2F2023%2F01%2Fllm-explainer.jpg&fb_obo=1&utld=nvidia.com&stp=c0.5000x0.5000f_dst-jpg_flffffff_p500x261_q75&ccb=13-1&oh=06_AbHmX58Zms_sKioTyF6oTAc8VXt_BbUH2P3pLu04hpq98g&oe=64E062B0&_nc_sid=dbad39,https://www.facebook.com/NVIDIAAI/posts/pfbid02HpfjGw2SHcw2stnPFw6AjjctNzmkL2vpG7qBcxgKykmLKwYv8Hd3YodyPJ9odQr6l?__cft__[0]=AZXbHwLOFnEVul_xNWSV9B5sDHLwiKdN3jlJKgsDuAC5jLHsO92bvCLH61vH9a6iHxd1LHrMi_cbuMOgFBu9RjnojMUHfc2CfHgLQ0ZEIPb6wS6JEl5mZyZZsI9CJIhl8ujG1FYyYj9H3DoxDjb3ZN4-XrsUGDlpe113kl3SbJrpphMwftKVGuDnG0HIvtC1zukYj-LV5dRx-WfSGww68Que&__tn__=%2CO%2CP-R,11,0,positive,11
pfbid038JHL9P37Kj8YVc7v7iucUj3nv9sZUkpZsTXa5E3WkbHDfz7STxNq487pw9tH9qTol,NVIDIA AI,0,13,0,0,1,0,0,0,14,5,Building an #AI Solution? Don't let poor storage planning wreck training and inferencing: https://nvda.ws/3XF6W7h,2023-01-26T00:00:00,[],https://external.fcai19-7.fna.fbcdn.net/emg1/v/t13/2469429959244636971?url=https%3A%2F%2Fdeveloper-blogs.nvidia.com%2Fwp-content%2Fuploads%2F2023%2F01%2FSacling-Storage-AI.png&fb_obo=1&utld=nvidia.com&stp=c0.5000x0.5000f_dst-jpg_flffffff_p500x261_q75&ccb=13-1&oh=06_AbFEPfljHxpCVLw6JD8YihzQlz4Qs4qPUqvaQZ0wc3w2dA&oe=64E0851B&_nc_sid=dbad39,https://www.facebook.com/NVIDIAAI/posts/pfbid038JHL9P37Kj8YVc7v7iucUj3nv9sZUkpZsTXa5E3WkbHDfz7STxNq487pw9tH9qTol?__cft__[0]=AZUdVVFzO89Fg9tD6FCyxGJ42hW2rUiOYHamw9yN_uk30pYxyTjCeBTMEtMST4hmh1G7G1f0N8B8YOMpn0CPS02FE2MhsG1P_QsVilJmuR74eMiL2UEdMItXgq-flgzphaFc9KwOl2LGcJmgmRNLervbfbpNprmA9tA0CbUr5R-wBxkKL9LSt0OpvZts8nlCXnhcYM9A2WjZK0UrXZHR4h5Y&__tn__=%2CO%2CP-R,14,0,positive,14
pfbid046raFKAtgwbHKVKZhAFKjvuanxrrd18KEBPwwMfgv89JCjdvAVPnmwy1nMEfoS6Rl,NVIDIA AI,0,9,0,0,1,0,0,0,10,0,"On latest NVIDIA #AI podcast, Sonya Huang and Pat Grady @sequoia delve into the future of generative AI: opportunities, challenges, and ethical consideration. Listen now! https://nvda.ws/3Xvikmd",2023-01-26T00:00:00,[],https://external.fcai19-7.fna.fbcdn.net/emg1/v/t13/2622267814991343558?url=https%3A%2F%2Fi1.sndcdn.com%2Favatars-000709444132-h3sd13-t500x500.jpg&fb_obo=1&utld=sndcdn.com&stp=c0.5000x0.5000f_dst-jpg_flffffff_p500x261_q75&ccb=13-1&oh=06_AbFkcw-qb3vvOm0GIBt0RwpCRr69n5Om6cyGDY7JOMUq2Q&oe=64E03C98&_nc_sid=dbad39,https://www.facebook.com/NVIDIAAI/posts/pfbid046raFKAtgwbHKVKZhAFKjvuanxrrd18KEBPwwMfgv89JCjdvAVPnmwy1nMEfoS6Rl?__cft__[0]=AZW-mMvSEWoHlQYCZYPNALfz9KBhL27zLL7TEJvYoS2kroNtoMQhX4ZMrxwovjzIkdSBEl1JifkTkYCL5B72okMqL7Z-TlkjRt_fan9v71iLBqdRTtlRCPe9hBB8OxH47H4l-IcHS9wYWA2ixMcUaBJt-tTd-CTWCt2b9C5cnUnBnEx_6J8CmgZ_9_fb7ZfK9SNk73SCJCpGrti7q0ooMqGj&__tn__=%2CO%2CP-R,10,0,positive,10
1123188771680724,NVIDIA AI,0,17,0,0,1,0,0,0,18,0,Build an engaging intelligent virtual assistant using NVIDIA’s #AI workflow in this new free hands-on lab. https://nvda.ws/3D5nZY6 #intelligentvirtualassistant,2023-01-26T00:00:00,[],https://scontent.fcai19-7.fna.fbcdn.net/v/t39.30808-6/327721694_692052249373279_8006175538997367641_n.jpg?stp=dst-jpg_p526x296&_nc_cat=111&ccb=1-7&_nc_sid=9267fe&_nc_ohc=BTeFoM0iy7UAX881h44&_nc_ht=scontent.fcai19-7.fna&oh=00_AfDIMx_WFvAQZk1qdKTLl7K_W6E1k-G2vodFcNj5jrOEGw&oe=64E39C10,https://www.facebook.com/NVIDIAAI/photos/a.119492422050369/1123188771680724/?__cft__[0]=AZVV3v5wuo7kf801bL7vxGVoTPraw-ZzXKfacYRSs6gfdLvEYvL7QVwv3IPjd78hirL2sq-yLV-xnu2n9aAsO66nLHFN9XprOmeTupxnaFKtR0UDfH-nJM0RzNTqvFfSnBLBNy0kuJ0pCzLGg6KgFxbJNkwXaHnCKhoL96pi89Q7fb9c27baqZ4LxZWiOyFw1zvQcegbygvp-kEyjyfS1Kk3&__tn__=%2CO%2CP-R,18,0,positive,18
pfbid02EdPtUEEgFBtbpDmDHL1kZkob8ZLnmynbHsDRyWUhDJ4i7aXNhNe5ZvDaxFobLeAl,NVIDIA AI,0,7,0,0,1,0,0,0,8,0,Data overload increases the potential to miss threats.Find out how #AI-based #cybersecurity outperforms conventional methods. https://nvda.ws/3wsfiDx,2023-01-25T00:00:00,[],https://external.fcai19-7.fna.fbcdn.net/emg1/v/t13/15019622113496475189?url=https%3A%2F%2F1382778335.rsc.cdn77.org%2Fwp-content%2Fuploads%2F2023%2F01%2Fcue-card-Artem-Kroupenev.jpg&fb_obo=1&utld=cdn77.org&stp=c0.5000x0.5000f_dst-jpg_flffffff_p500x261_q75&ccb=13-1&oh=06_AbG-RgN786BaO1Wqr3V7LiulFYdZCHp0Inx2sxL3veXUNA&oe=64E0A7F0&_nc_sid=dbad39,https://www.facebook.com/NVIDIAAI/posts/pfbid02EdPtUEEgFBtbpDmDHL1kZkob8ZLnmynbHsDRyWUhDJ4i7aXNhNe5ZvDaxFobLeAl?__cft__[0]=AZWAE8gebLP_9Ir0wrQRjr3WdTEdwwckJgnnMMxsRIXt2sKGsoQs3dSmD2VvV0HI3i2S9phyVt_GkS33KY84sodydukOmjiOAAcSufjfSBwDNkR2Yi3V2LgWvJUHR0nChc3kFfCkD055GvzbkxSEOV3nlGddnyRA0l6IW1PGuBkH33dM62nPvtGcZF1V3U4g1YjoMSt6UCdSarii0G_lY8da&__tn__=%2CO%2CP-R,8,0,positive,8
pfbid0QWFntBqefYz5Nm3fDnGY8jh74DiMSY6itQAoKtMDxwLeNoB1MUg8U9CWFkCi8QCsl,NVIDIA AI,0,22,0,0,0,0,0,0,22,2,"Orbital Sidekick, a San Francisco-based startup and #NVIDIAInception member, is creating technology to spot gas pipeline leaks using satellites to collect hyperspectral imagery from space. OSK uses the #NVIDIA Jetson edge AI platform to process and analyze data in real-time, pinpointing the leak, size, and urgency. Read more: https://nvda.ws/3WIxHqo",2023-01-25T00:00:00,[],https://scontent.fcai19-7.fna.fbcdn.net/v/t39.30808-6/327722322_6006132752780316_8522989686392477296_n.jpg?stp=dst-jpg_p526x296&_nc_cat=107&ccb=1-7&_nc_sid=9267fe&_nc_ohc=NrDPLJrYt10AX9-dzup&_nc_ht=scontent.fcai19-7.fna&oh=00_AfBkaZZWkrAUuprquuGx_m0bzqGD0oOLQd4Ag9Q0Tq1ARg&oe=64E38DF9,https://www.facebook.com/NVIDIAAI/posts/pfbid0QWFntBqefYz5Nm3fDnGY8jh74DiMSY6itQAoKtMDxwLeNoB1MUg8U9CWFkCi8QCsl?__cft__[0]=AZUcBxjZH6PbonpGcphWUeGGNsq-vozy8Xhz7-63TQZLKSk65S2a5X57SQlmGVkDK7X9uV_kRzUeF1FikQXdyFwT-FJb5KDjKOyjSrqWPBMTaqX9xXpjkQ_DNBYeuFO4u5p3CbjFEnHPDAT4UEIn7k2qvJ8v4xAhS_yqO1d_hozGyTqQj9-JnuoXLex2BQXDq44ZUWaeC_4aaKlxZWySve_S2GGP4julaTexk_UN2GPIR6KJxu1uObq8KnJ5vuX0XQnvFE6-p5co21d1ATnSIyJ_&__tn__=%2CO%2CP-R,22,0,positive,22
1122502488416019,NVIDIA AI,0,6,0,0,1,0,0,0,7,2,"Learn how to train text-to-speech (TTS) models and tailor voice pitch, rate, and pronunciation for natural sounding speech with this new free hands-on lab. https://nvda.ws/3GSOHnH #speechai #texttospeech",2023-01-25T00:00:00,[],https://scontent.fcai19-7.fna.fbcdn.net/v/t39.30808-6/327410630_696674785532511_4759425417929398318_n.jpg?stp=dst-jpg_p180x540&_nc_cat=109&ccb=1-7&_nc_sid=9267fe&_nc_ohc=EajaouRVaPoAX_CG1Ci&_nc_ht=scontent.fcai19-7.fna&oh=00_AfD5Z3Z5-sHGONzcrxEa305XqIA-ZOF8chvAt4GLU-BB3g&oe=64E43170,https://www.facebook.com/NVIDIAAI/photos/a.119492422050369/1122502488416019/?__cft__[0]=AZV4Hl5ePpOle7clpkBGY4SiAx2XxLA-IyAx3aZmdTtX8vdIQCfMrlWj-qAs5Tej5Jj10YouqOUKPw71PbpEVmcdcJK8HkB8ZQ1nGwaTcnIwiYMN5yKv0P8NQTyosEclLvlzuMzXEvbG73dmGrTYi-pdPKQlo_nyjOHr7ke4tvgeCqAdte63qOzlVqi41eDvthEuAFniFqFGWnwESiI4a7dg&__tn__=%2CO%2CP-R,7,0,positive,7
pfbid027utuaHraH8yxL6FhNJnsEe6DLynBEwcPLjALvrXQZBYLNER1XJTK7MZyTuJtNrdtl,NVIDIA AI,0,12,1,0,1,0,0,0,14,4,"Are diffusion models the best at text-to-image generation? StyleGAN-T shows that GANs are still in the game, with faster image generation and potentially more control over outputs. Check out the results in our newest paper: https://nvda.ws/3Jc284S",2023-01-25T00:00:00,['blob:https://www.facebook.com/505445aa-8810-4bfd-86e1-6f48dbf05cd2'],https://scontent.fcai19-7.fna.fbcdn.net/v/t15.5256-10/325655971_511259611049972_7475677047598908905_n.jpg?_nc_cat=108&ccb=1-7&_nc_sid=ad6a45&_nc_ohc=qYi0BAZZK_wAX_xf05l&_nc_ht=scontent.fcai19-7.fna&oh=00_AfDrjp164fF6so33HEEJSVnguoUdhiM2WjfUvLbW53M1UQ&oe=64E3E2C0,https://www.facebook.com/NVIDIAAI/posts/pfbid027utuaHraH8yxL6FhNJnsEe6DLynBEwcPLjALvrXQZBYLNER1XJTK7MZyTuJtNrdtl?__cft__[0]=AZXqjX13fIS1qg0Kb0aYIwQA2Qbx2VQrxOJIOX49gKa0zyDY5XYSRGoCFQvd6c5WmMv7JWItL4aQ5fydqU2vMdPs4-QuYslZtLDjuNSLy9uv9l8pOAudXMu0PEopHtBRCsJl9kSZa602L9uJM5V8xaEbb8-nZHjuEgPeSNrYkviCWSgYyTVC2V9ImcfNG4PwqHAkIaPVYgBfGHzaLQp_VUkruL0TUzk1o8WuHDmjnyeqBQ&__tn__=%2CO%2CP-R,14,0,positive,14
1122041051795496,NVIDIA AI,0,7,0,0,1,0,0,0,8,0,"Missing financial data is a prevalent, yet often ignored, feature of company fundamentals. On February 9, hear from Stanford University on a novel method to impute missing values, and the impact for investment and asset pricing.Register now: https://nvda.ws/3GYA02B",2023-01-25T00:00:00,[],https://scontent.fcai19-7.fna.fbcdn.net/v/t39.30808-6/327292611_482690207175364_8489388697177391927_n.jpg?stp=dst-jpg_p526x296&_nc_cat=108&ccb=1-7&_nc_sid=9267fe&_nc_ohc=wd5SUN3GT7EAX-EgL1s&_nc_ht=scontent.fcai19-7.fna&oh=00_AfCp-QPDT_NDKUNyhOKGbIeIUEwz1BHn7wQYoWuaHWJPaQ&oe=64E2F3FD,https://www.facebook.com/NVIDIAAI/photos/a.119492422050369/1122041051795496/?__cft__[0]=AZUp4mmKSlLszw-WgO2bwHPSQi-_EwdtltF-sBQO8v3s6tdavXhyLQ9AraDyIifa-njesGsieu96cZJYJNi-i8_8gyLBQNrPo_h_HKwQIlfGh2YrRpA2xdOXlpAnIVLswNJisjhQsM90vTWaCoxirPJLUYjBiAWcF3fMN-ZpKwnf582UiljaUJy0GLv2xOpMzLQIYP8kSVSmQ81MYJgV10W5&__tn__=%2CO%2CP-R,8,0,positive,8
pfbid024fHk33nh9Qj6QEGUfQDHFkPYJHWHJt41sHXyGj7LK1zzV23NzuJoYrzRETp1uZqAl,NVIDIA AI,0,11,0,0,1,0,0,0,12,1,"Modern-day #inference is complex. Learn how ClearML and NVIDIA Triton can be used to deploy high-performance inference, with ease, using a Hugging Face model example. https://nvda.ws/3XwroY2",2023-01-24T00:00:00,[],https://external.fcai19-7.fna.fbcdn.net/emg1/v/t13/6469238893560839285?url=https%3A%2F%2Fclear.ml%2Fwp-content%2Fuploads%2F2023%2F01%2FServing-Performance-NVIDIA-RTX-2070-SUPER-AMD-Ryzen-9-3900X-edit.jpg&fb_obo=1&utld=clear.ml&stp=c0.5000x0.5000f_dst-jpg_flffffff_p500x261_q75&ccb=13-1&oh=06_AbEQgF9Mm_MulhjK51jraJLPG4OBhHIqGpKV-UnyJAPNjg&oe=64E01AEF&_nc_sid=dbad39,https://www.facebook.com/NVIDIAAI/posts/pfbid024fHk33nh9Qj6QEGUfQDHFkPYJHWHJt41sHXyGj7LK1zzV23NzuJoYrzRETp1uZqAl?__cft__[0]=AZX4EcdD5eT7W3ev9fAXx0Nc-fZ6gkOJl3zngFVLyfPxJWjB4M_Fyq6_Ic3hSJIvzs-AaM1a45slR_OT_dhpadLJpQrLY0x_Jj6H3avHBzUDq_kqZ0LvyTJqNaPnjPqiGv0__hcx778o8UNHIdzbg5u1aV4V8_R4elNS1xEkKWt0UqurqULu7LN02SCZ7HbhaqDSjFHLMlU_dOYAJyG9iYBU&__tn__=%2CO%2CP-R,12,0,positive,12
pfbid037jr5TBt3biiEr6hodKQKnRuiGA4JD11oEQ7ekSxqWnjuDKjL7migAdZxRyJYjvG4l,NVIDIA AI,0,6,1,0,1,0,0,0,8,0,"Register now for hands-on training workshops with Deep Learning Institute at #GTC23. Topics include AI, accelerated computing, data science, graphics, simulation, and more for $149. https://nvda.ws/3k8CzHH",2023-01-24T00:00:00,[],https://external.fcai19-7.fna.fbcdn.net/emg1/v/t13/3501357008868622569?url=https%3A%2F%2Fprod2-sprcdn-assets.sprinklr.com%2F50276%2F7c42f809-d88a-4106-aa7e-371ea438638f-1879607931%2Fgtc23-spring-dli-x4-drive-reg-.png&fb_obo=1&utld=sprinklr.com&stp=c0.5000x0.5000f_dst-jpg_flffffff_p500x261_q75&ccb=13-1&oh=06_AbEt9JrzAC-h4X9_Lw2dzW_kARbGZgqq3yG9EgqH0Kzhsw&oe=64E0AB85&_nc_sid=dbad39,https://www.facebook.com/NVIDIAAI/posts/pfbid037jr5TBt3biiEr6hodKQKnRuiGA4JD11oEQ7ekSxqWnjuDKjL7migAdZxRyJYjvG4l?__cft__[0]=AZVlVjszHXeTGdQelh-85a50MFjkOAiMwCCIAFrYK4RWk8TCDLcFMBbue0M9tNVISCeErhWMH07siAvaUR6YYGO5ESBUf5QYtrvU5-DBaOQd9k8cZvvoRA-uhohuRU0u0Yyuv3WHWfslt-sTR04NqD96IH7JrrCqSI2XgNvjWMsGivqOM4toPqCL8n1NEFzy8wpuv_m5rPymmkFc9hJGrYSv&__tn__=%2CO%2CP-R,8,0,positive,8
1121922885140646,NVIDIA AI,0,4,0,0,1,0,0,0,5,0,"Don’t forget to register for our free live webinar, tomorrow January 25 at 10 am PT! You’ll learn how to build and deploy #intelligentvirtualassistants in the form of voice-enabled digital agents that improves customer satisfaction in contact centers: https://nvda.ws/3IVzZ27#SpeechAI #FinancialServices",2023-01-24T00:00:00,[],https://scontent.fcai19-7.fna.fbcdn.net/v/t39.30808-6/324095729_6078163088901613_5493726417278681136_n.jpg?stp=dst-jpg_p526x296&_nc_cat=108&ccb=1-7&_nc_sid=9267fe&_nc_ohc=OWgQNr95xn8AX__k-37&_nc_ht=scontent.fcai19-7.fna&oh=00_AfCt2svTG7l1pRI4J7BG6fLpDxwSEuRybLWoEJASIyUIAg&oe=64E3F928,https://www.facebook.com/NVIDIAAI/photos/a.119492422050369/1121922885140646/?__cft__[0]=AZUDPvgB0-r64axf9oT0cuO9Ykawv_zZkHWkb7UQscX01Zl7Mt1dKlX1Tj2IXkdchh_oHUpghEy5gsfSxm-wi4BKuE5FigenrbX4y2BmuoBtIW4AeZiQhdq7w5Bqhq5i2KYROnIuDV96vvPUWPkAEa6ey4nLxtFXu3hN_jiTlTjKYmqgQXSOuJwqzt9uDspKtjQjKqb_Mrr06OIi54iPrtyW&__tn__=%2CO%2CP-R,5,0,positive,5
pfbid0HbnL91E6LMnrFVyPHmkV8Dyxra9doaXcwH93c78RYgB92emFtewsDUZBS4sZMet5l,NVIDIA AI,0,11,0,0,1,0,0,0,12,0,Stay ahead of managing security in the age of #AI.Join NVIDIA CSO on CXOTalk on Friday for a live discussion on #security strategy in 2023. https://nvda.ws/3kB9rsS,2023-01-24T00:00:00,[],https://external.fcai19-7.fna.fbcdn.net/emg1/v/t13/13625644271287334891?url=https%3A%2F%2Fwww.cxotalk.com%2Fsites%2Fdefault%2Ffiles%2F%2523775%2520David-Reber%2520social%2520sharing%2520with%2520photo.png&fb_obo=1&utld=cxotalk.com&stp=c0.5000x0.5000f_dst-jpg_flffffff_p500x261_q75&ccb=13-1&oh=06_AbERwAfd8Yw7I4USoBl9cD-cBWu4MhXdfCvWYy9CTK8U4w&oe=64E07112&_nc_sid=dbad39,https://www.facebook.com/NVIDIAAI/posts/pfbid0HbnL91E6LMnrFVyPHmkV8Dyxra9doaXcwH93c78RYgB92emFtewsDUZBS4sZMet5l?__cft__[0]=AZUqxxQ6dvuMiUqqf7KdyTMadGwEWwZgYQugVZLFEqgt65ctQXrY92Jd0GEKY6sZxZoCzHGegXGRpMT-jRuf-vpYFggrEZsg2t5HDghy6qsEabdfFfUB-oHAkbZHfDL3ImXL890VVX1WAC3wT1PhwHt8tlN24CkMu1LtTDRdXlrf65mxf3y4tPPTmanHOPpq_mu2i_PxlM1usS2lJ_oJSf7U&__tn__=%2CO%2CP-R,12,0,positive,12
pfbid0pDRsABTkhBMSphvZLjy24pZGLcGrJYimxFoenB22dZMbH51FQncAUUWwALBd8kyGl,NVIDIA AI,0,12,0,0,1,0,0,0,13,0,What specific metrics need to be monitored? What tools are most effective? Get the answers to these critical questions for #ML practitioners.https://nvda.ws/3Xt4D7f,2023-01-23T00:00:00,[],https://external.fcai19-7.fna.fbcdn.net/emg1/v/t13/16506831122920986517?url=https%3A%2F%2Fdeveloper-blogs.nvidia.com%2Fwp-content%2Fuploads%2F2023%2F01%2Fmonitor-machine-learning-models.png&fb_obo=1&utld=nvidia.com&stp=c0.5000x0.5000f_dst-jpg_flffffff_p500x261_q75&ccb=13-1&oh=06_AbHRUjWu6lwhibszQa03_8zhS9xQHMUCVzJ5F8tvcxy_5A&oe=64E070A3&_nc_sid=dbad39,https://www.facebook.com/NVIDIAAI/posts/pfbid0pDRsABTkhBMSphvZLjy24pZGLcGrJYimxFoenB22dZMbH51FQncAUUWwALBd8kyGl?__cft__[0]=AZVASO8OVvjeKEzhigbe8PwiZuWY-rjG0uEUy0AA94TYSwVm2yUmnlbbuXE7rPKn6Qu5ChwnXCa-DJZuUJhWGYWCvyNuTO_rLw2GGZDE01GKdZ28h4Hm64WvrJHR-L7iaFbwHfPuDo4ixAxDZdHt1O5hQxUW73UR6vJ19YVEP8979B3TOl-SNIuGSCj6C1QHNPVNfBOuE-dTvNV5qw7pGkE9&__tn__=%2CO%2CP-R,13,0,positive,13
pfbid024cEPKNf19hcXM1CNdC2F9rNsfjby25ARvGKwrJPGonwUcHjiFTStEtLjFU441uqEl,NVIDIA AI,0,16,0,0,1,0,0,0,17,0,Protect mission-critical AI workloads at the edge.Find out how NVIDIA Fleet Command is giving IT administrators more control over their #edge deployments. https://nvda.ws/3XMvICN,2023-01-23T00:00:00,[],https://external.fcai19-7.fna.fbcdn.net/emg1/v/t13/4611503563907695452?url=https%3A%2F%2Fdeveloper-blogs.nvidia.com%2Fwp-content%2Fuploads%2F2023%2F01%2Ffleet-command-2.jpg&fb_obo=1&utld=nvidia.com&stp=c0.5000x0.5000f_dst-jpg_flffffff_p500x261_q75&ccb=13-1&oh=06_AbEdRjY4healkVIjG4rcVsdkAuDM3T4QSXRykKU5N6aFsw&oe=64E021FB&_nc_sid=dbad39,https://www.facebook.com/NVIDIAAI/posts/pfbid024cEPKNf19hcXM1CNdC2F9rNsfjby25ARvGKwrJPGonwUcHjiFTStEtLjFU441uqEl?__cft__[0]=AZUYJKZj-HWIdf-_4S8pZCGkX59SjUm2f_iPgAH0LmEmBzphybWtKYrusjPwOGL8dl8IBiXmIXNOVjNYdxQ49idcZ4beg8Uae08cunZcx1kbtjymQFNdpzdhEQKhND74P_MhnQSblonnEpebUjnintUj7JINVGD6rqIlNIrdgZbkjpB7FunN8PDI6TFA19_sz05Zuy8ThzIqKFQ4VMdoqsd1&__tn__=%2CO%2CP-R,17,0,positive,17
1121378301861771,NVIDIA AI,0,14,0,0,1,0,0,0,15,3,Processing hundreds of thousands of terabytes in data? Migrate your Spark workloads in Google Cloud’s Dataproc for up to 5x faster data processing with GPUs. Grasp CPU-to-GPU migration pain points and get tips on how to mitigate them: https://nvda.ws/3iTdNem,2023-01-23T00:00:00,[],https://scontent.fcai19-7.fna.fbcdn.net/v/t39.30808-6/323886265_721019883072486_1568695790645051819_n.jpg?stp=dst-jpg_p180x540&_nc_cat=107&ccb=1-7&_nc_sid=9267fe&_nc_ohc=fWkDLAdAolcAX-ivx1Q&_nc_ht=scontent.fcai19-7.fna&oh=00_AfBo14Kmb6Mm-m3ZB7I_CRaFLNyT1xs0NU1G53VuAxs63g&oe=64E2F9B9,https://www.facebook.com/NVIDIAAI/photos/a.119492422050369/1121378301861771/?__cft__[0]=AZV_509DsXWluUQ8VBdPMqN2THWIAz7PXkdlgmHdU25_SMdfoxnj-Nr28QL9hv29bIT5rOEyKuzPmPAzV9jdBxLVxl0jEncesb-1asJx9IR0f9Tr-79A1iCWCX51bl-moi7itYgIeDBOVgjpE_DHcRSMmXoXkMtv6sICRcRQYrjpMm-9Av0xssroBhoxCik6dLykDrdWqCxkcNm_aBKA-Zf-&__tn__=%2CO%2CP-R,15,0,positive,15
1121353685197566,NVIDIA AI,0,10,0,0,1,0,0,0,11,0,"Build a session-based recommender system with free access to NVIDIA’s hardware and software stacks, a step-by-step hands-on lab and support from NVIDIA experts.https://nvda.ws/3Hh6nLg #recsys",2023-01-23T00:00:00,[],https://scontent.fcai19-7.fna.fbcdn.net/v/t39.30808-6/327126770_912587879739261_5389635785202140812_n.jpg?stp=dst-jpg_p180x540&_nc_cat=100&ccb=1-7&_nc_sid=9267fe&_nc_ohc=ih0wINKEWkQAX8pTgCd&_nc_ht=scontent.fcai19-7.fna&oh=00_AfA1pVpi0_Y5mUcaDazTskj9dqyl6CZrSyRsTKbXXsiYnQ&oe=64E3552C,https://www.facebook.com/NVIDIAAI/photos/a.119492422050369/1121353685197566/?__cft__[0]=AZWQW4fWqhv9Ghb-OQCoB2oxUdevGT0nim_gCadn2R3Opxk2SJkZ4ssfWzCjJs6ZH9N07weYBjqwKLdHP7buhBC7TXyhbarPG6Z4q9LRAqmlNmJu9QqLea3rrfp-LrcpY0aEhn_0IGMh7ZL4Z6GnUlGqWdyhXS89utmbtPKC5FTRNUmaToFNSYXR6tIZpSFiC8nq9zHX_GBJZtIpg57ZCi48&__tn__=%2CO%2CP-R,11,0,positive,11
1120836978582570,NVIDIA AI,0,8,0,0,1,0,0,0,9,1,Congrats to Riskfuel for winning the HPCwire 2022 Readers’ and Editors’ Choice Awards for Best Use of HPC in Financial Services!  Read on to learn how AI technology accelerates workloads across organizations: https://nvda.ws/3XMAwri#MakeAIYourReality #AzureHPCAI #NVIDIAonAzure,2023-01-22T00:00:00,[],https://scontent.fcai19-7.fna.fbcdn.net/v/t39.30808-6/327058144_498598002387252_7689518729697963361_n.jpg?stp=dst-jpg_p180x540&_nc_cat=109&ccb=1-7&_nc_sid=9267fe&_nc_ohc=pwjLzsR6nYoAX-9gCxn&_nc_ht=scontent.fcai19-7.fna&oh=00_AfCfNQXyfjhzi2jD2341OxlZo7v-9TSYBTxPlsLCWc6JcA&oe=64E4A5F7,https://www.facebook.com/NVIDIAAI/photos/a.119492422050369/1120836978582570/?__cft__[0]=AZWR6u6PGiklGyLk5DkHyjXHA5kDS2TQ4KjOff6ZJM1ecGFJN_PQ2bTx-8hwYaARdGPVXRak3ZVBudxWSfbxOi4JXaideW0kvv1xQrjoFgnEFqztlZvRoDOWteZth8_X1f3Qr89oRP3rESjrjgmVZsijd65L4tLmXfUX9GIrf4dwmrtyFYoGbJvKE-bpoXFkHdLJemuzBK3eeOqscOjxpbIm&__tn__=%2CO%2CP-R,9,0,positive,9
1120281058638162,NVIDIA AI,0,12,0,0,1,0,0,0,13,2,See how Everseen uses #AI technology to help retailers create a seamless  shopping experience while benefiting the bottom line. Learn how they did it in this story: https://nvda.ws/3Xt245h#MakeAIYourReality #AzureHPCAI #NVIDIAonAzure,2023-01-21T00:00:00,[],https://scontent.fcai19-7.fna.fbcdn.net/v/t39.30808-6/326500800_1137551856963960_1610454085541589097_n.jpg?stp=dst-jpg_p180x540&_nc_cat=109&ccb=1-7&_nc_sid=9267fe&_nc_ohc=Lbma9CVBsJsAX_v9dyn&_nc_ht=scontent.fcai19-7.fna&oh=00_AfB1Ai9pNVOyGswnStjx-CZsr_QdFj7LU_900oNLz-rq7w&oe=64E46798,https://www.facebook.com/NVIDIAAI/photos/a.119492422050369/1120281058638162/?__cft__[0]=AZUY7Oi93-dtSiwrokiipLTWMw3SZf5ylE5pJeC88CRCO-NWBDWzKnphvpXzwbagaJQDUL2cOH-R3uKbfUSlyIy0oQHjHGkS4K0toirTfKml3GP2xXBRmNMI1KGo_sOzRinnOZK3u7trkCVjLw3acUPo7DWZqjL_tEfYfvACWpx2rGpaO0KGWPt9XgM6Y1uxZB0d6er3pphC09AOoV3POCyL&__tn__=%2CO%2CP-R,13,0,positive,13
pfbid09NrxsBwPywZW4cG5Hse2AHtyD6LYJ5ptCmrLYbgR3tZiKStCdjL97Pqj6toaV4Kol,NVIDIA AI,0,5,0,0,1,0,0,0,6,1,"Have you seen our  #AIArt Gallery, featuring #InstantNeRF artists Karen X. Cheng, James Perlman, Jonathan Stephens, Hugues Bruyere, and Franc Lucent? Take some time this weekend to explore: https://nvda.ws/3Id3KuT",2023-01-21T00:00:00,['https://video.fcai19-7.fna.fbcdn.net/v/t42.1790-2/325814491_864770021435261_825224963211512262_n.mp4?_nc_cat=101&ccb=1-7&_nc_sid=985c63&efg=eyJybHIiOjU3MCwicmxhIjo1MTIsInZlbmNvZGVfdGFnIjoic3ZlX3NkIn0%3D&_nc_ohc=oOFj3DusjmQAX-hjo3A&rl=570&vabr=317&_nc_ht=video.fcai19-7.fna&oh=00_AfDCkO176XnkPfkBCFwwmS_PYq_NjuxG3uHDX_c7RZ7aeg&oe=64E2B701'],https://scontent.fcai19-7.fna.fbcdn.net/v/t15.5256-10/325108063_883326832941315_4557466722938674899_n.jpg?stp=dst-jpg_p960x960&_nc_cat=101&ccb=1-7&_nc_sid=ad6a45&_nc_ohc=jWj9kTygedkAX-JH1Zk&_nc_ht=scontent.fcai19-7.fna&oh=00_AfD1UteJQbVGhgqkLAwTI89RLopFMW76tUWjri80zLMRWg&oe=64E37913,https://www.facebook.com/NVIDIAAI/posts/pfbid09NrxsBwPywZW4cG5Hse2AHtyD6LYJ5ptCmrLYbgR3tZiKStCdjL97Pqj6toaV4Kol?__cft__[0]=AZV_4LvUrZzMa-GvOR2cu7aWY1ArgCQhHT2hVbH0JNlvHmWIaSwBRysqTrBMRpQT2f64_kLuo3OTI-mwJPHhhMF-EgL_HaBBZLUrClyUYfnisYIqdh9dxvlgo3ySAfAy9GfXFRJtM0qQXR4dzZH5mCgQqmjQXCPzwr-pzDNXTgey3bK7ZZT09tebn0U-oeHjRuDjPF11sIusQ87gkL6B4MyGEzLvJMgnNYMxEkzjohzCJA&__tn__=%2CO%2CP-R,6,0,positive,6
pfbid024U3M3Qh1MtLLHBAEWk9ZBz3T1N1iZzebTXcFsLk1R7jNWr3VD94TucSF7DqwNGgDl,NVIDIA AI,8,38,5,0,0,0,0,0,43,1,"Enhance video conferencing with NVIDIA Maxine Eye Contact. Using #AI to apply a filter to the user’s webcam feed in real-time, Maxine redirects their eye gaze toward the camera to improve face-to-face conversations.",2023-01-21T00:00:00,[],https://external.fcai19-7.fna.fbcdn.net/emg1/v/t13/3579648412553201225?url=https%3A%2F%2Fdeveloper-blogs.nvidia.com%2Fwp-content%2Fuploads%2F2023%2F01%2FVideo-Conferencing-Maxine-Eye-Contact-2.png&fb_obo=1&utld=nvidia.com&stp=c0.5000x0.5000f_dst-jpg_flffffff_p500x261_q75&ccb=13-1&oh=06_AbG6DxjJhEJby-8pO30RnPJIg1Q6GYpmHTlUuJiwE4U53g&oe=64E051C3&_nc_sid=dbad39,https://www.facebook.com/NVIDIAAI/posts/pfbid024U3M3Qh1MtLLHBAEWk9ZBz3T1N1iZzebTXcFsLk1R7jNWr3VD94TucSF7DqwNGgDl?__cft__[0]=AZXm7jajxau_s60z77qa7ug-KMMKevvYej1yM7t5LCFW8E8tZG0ge25gYcj5NwplNj5Bi_XzCUx4j2jn4w9C0BV4g7sl7dYb9Xg0C1Ku2L8I5tnSSnoAwZgpBAMAKxS9R7n8uuCZY23ctamVWyTkWRfShR3bYonGf989eJBC1bZdmImNGJZUwjMbAaZsU5ZV8izmXDcJjr-nLD6yZTnv_kIt&__tn__=%2CO%2CP-R,51,0,positive,51
1119577618708506,NVIDIA AI,0,13,0,0,2,0,0,0,15,3,"In an industry where time is critical, Nuance Communications and Mass Gen Brigham bring  medical-imaging AI models and diagnostic tools into clinical settings to improve and expedite patient care. See how they achieved this: https://nvda.ws/3GzGmVV#MakeAIYourReality #AzureHPCAI #NVIDIAonAzure",2023-01-20T00:00:00,[],https://scontent.fcai19-7.fna.fbcdn.net/v/t39.30808-6/322961945_918878889273113_8306315037848158234_n.jpg?stp=dst-jpg_p180x540&_nc_cat=106&ccb=1-7&_nc_sid=9267fe&_nc_ohc=rHqfpOGSBfcAX91ykr1&_nc_ht=scontent.fcai19-7.fna&oh=00_AfDoogINntO776zxXTVxxRi1LTkHJLL29xWVERo7YK3tkA&oe=64E2E5CC,https://www.facebook.com/NVIDIAAI/photos/a.119492422050369/1119577618708506/?__cft__[0]=AZXDHcN4E77TLTe07UHdcuq_guR6jtSCuvfj0_pJF6rZOq1TVEtPwLbVf3vxgz2Tv9gA-UDYPcC6EFVg5ItUiw8UdhXIzoLh8SN5qgFsNQRA0KEzF-3yVE_-V_LGZcX6P9ZiXjy_0aqQuyaVr7fDc2mOxOEGYfUJbkEF7BPmTL5N8bdlTDPPymjoMJQ6vwMo0aZdEQyYcgi-VCnGLjFlGnei&__tn__=%2CO%2CP-R,15,0,positive,15
1119150645417870,NVIDIA AI,0,9,1,0,1,0,0,0,11,0,"To solve the plastic waste crisis, Encina developed advanced #recycling technologies using virtual reactors to model trillions of fluid particles over 500x faster than previous solutions. Join the webinar on January 25 at 8 AM PT to learn how they worked with CPFD, Microsoft Azure and NVIDIA: https://nvda.ws/3ZX8n2G",2023-01-20T00:00:00,[],https://scontent.fcai19-7.fna.fbcdn.net/v/t39.30808-6/326207963_488892440092565_652516244724552027_n.jpg?stp=dst-jpg_p526x296&_nc_cat=109&ccb=1-7&_nc_sid=9267fe&_nc_ohc=iADes4w_iUAAX9iYJkn&_nc_ht=scontent.fcai19-7.fna&oh=00_AfACrqir28sDWYUYFv3HkZoqPHOxCR-DF2nNEJy-KZmeTQ&oe=64E35AD4,https://www.facebook.com/NVIDIAAI/photos/a.119492422050369/1119150645417870/?__cft__[0]=AZXqMlak1TnWv4nZOnYIGJl1MbwI9DLTvpu2jiW4ukuC4dX7Zl05d7XixDH1-JOrz6I7FqwEcLfI3mPlq4Di3qp2vIfmFGAKUn40M_-tnzJMOnYb8T2XFB6yYtig6ZSe42_qXGORO-Hm0XWqJSbp4SOrw_1qUtST5xDRzUOL-MQpoRo2GWx6ToVBcFkjxaDj6vFR9_EB_1MXjCtpbNeXUgKl&__tn__=%2CO%2CP-R,11,0,positive,11
pfbid02uoEfhsMMsqPbeH7J5pbtQmw9xNFRRv8RBfTnNbREBpfdSTZnboFv7bpSNMswQ4R7l,NVIDIA AI,0,9,1,0,1,0,0,0,11,0,How accurate are your #speechrecognition model's predictions? Get a rundown of how to conduct word-level ASR confidence estimation using entropy-based methods from a research perspective.https://nvda.ws/3IVKQsN,2023-01-19T00:00:00,[],https://external.fcai19-7.fna.fbcdn.net/emg1/v/t13/6506992829863224846?url=https%3A%2F%2Fdeveloper-blogs.nvidia.com%2Fwp-content%2Fuploads%2F2023%2F01%2Fperson-standing-by-waterfall.jpg&fb_obo=1&utld=nvidia.com&stp=c0.5000x0.5000f_dst-jpg_flffffff_p500x261_q75&ccb=13-1&oh=06_AbEBMkAaTt-RSiXK5PHQkjsVwXrv0WLjI85xzcmXzjqahA&oe=64E04293&_nc_sid=dbad39,https://www.facebook.com/NVIDIAAI/posts/pfbid02uoEfhsMMsqPbeH7J5pbtQmw9xNFRRv8RBfTnNbREBpfdSTZnboFv7bpSNMswQ4R7l?__cft__[0]=AZUh9XWPMQX4ZsTnJcUe73vBcdqyQNxjtQe687A8WO8Axlg9OuYZxOsX_foUUlnf0_a0v4--jWY0Ql2jOZgrshFdDT3EPX-IeeXG4B4GxHUr0inHkEIlBSgVvbdBqq3a-Kvbt5kS19yB0Jeog_hPtQ_jwkbEmkmPeTlJAUgCZC_HnmbuiDIzZ-bFP-hqJfCH5Uyb06c3SeNyqAB6Ba6Dz0Kz&__tn__=%2CO%2CP-R,11,0,positive,11
pfbid02iXwZmWXYNVxBN411pVksxdvZqVtqjPdgYMdeCB99mGSTzcMjXifDwn4SaA7q5iUgl,NVIDIA AI,0,13,2,0,1,0,0,0,16,7,"Learn the concepts, implementations, and applications of #graphneuralnetworks in this new #NVIDIADLI self-paced course. The course will cover both fundamental knowledge with hands-on interactive activities using GNN as a graph analysis tool. Enroll now: https://nvda.ws/3HfcNKG",2023-01-19T00:00:00,[],https://external.fcai19-7.fna.fbcdn.net/emg1/v/t13/4019875706415980800?url=https%3A%2F%2Fprod2-sprcdn-assets.sprinklr.com%2F50276%2F81bf9759-8db8-4357-9de6-3f3fac1129aa-1517028888%2Fdli-gnn-course-social-fb-insta.jpg&fb_obo=1&utld=sprinklr.com&stp=c0.5000x0.5000f_dst-jpg_flffffff_p500x261_q75&ccb=13-1&oh=06_AbHkaCAGT3CORVrPJkn2mXeb43OV0I3aV-yiN0fn1DZ-VQ&oe=64E06E44&_nc_sid=dbad39,https://www.facebook.com/NVIDIAAI/posts/pfbid02iXwZmWXYNVxBN411pVksxdvZqVtqjPdgYMdeCB99mGSTzcMjXifDwn4SaA7q5iUgl?__cft__[0]=AZXYBxavxb3xxiRgLM7ol3o06g7jhIk3HuhPRlhUtZtRIB3dIDf2TozfqRIzxgHTExIBSwMsXej5wZ7iVHpo_lhlQzEz8HposOOuUE_hiWk71chdVSBpE5Uhw7aK1QWtqTlOOOMD6hlcsd_R4suQRpqSVgIyswYmOyc_zRXfshQsdhYe4WoKsxmgzaDUMz2SaW8d7pJofBJIgj1dgeQbROvG&__tn__=%2CO%2CP-R,16,0,positive,16
1119037258762542,NVIDIA AI,0,11,0,0,1,0,0,0,12,1,"Learn how #finance and #insurance-focused data science innovators including JPMorgan Chase, BNY Mellon, Northwestern Mutual, Allstate, and New York Life are considering the role of #NLP and #quantumcomputing in financial services. Download the ebook from Domino Data Lab: https://nvda.ws/3QRg7z9",2023-01-19T00:00:00,[],https://scontent.fcai19-7.fna.fbcdn.net/v/t39.30808-6/322742119_1238320250436117_6790475216966210102_n.jpg?stp=dst-jpg_s960x960&_nc_cat=111&ccb=1-7&_nc_sid=9267fe&_nc_ohc=7tVVF_0P6pEAX_VAXt4&_nc_ht=scontent.fcai19-7.fna&oh=00_AfAM26uzNoWLhzaQH4KmvpoCYDbaaXAjxNC6FGVpqD16HA&oe=64E355A8,https://www.facebook.com/NVIDIAAI/photos/a.119492422050369/1119037258762542/?__cft__[0]=AZVAnsvQtWmt21IGTdQq85-J6DYDLK8eIDpO9R7pGcpgYFIub8Jm8nT5V6ZEG2wkFk9YJeHB_vLNEbdQ3WdiHbCI6LiwvmnCx1Rp9LU5NvDiMpyWFkp8ypmaHI-W8WM6pbFd7C5lJw6z8Y9V2K5RT30zD4KVG8HaYsuJ10cM7BAhGE_wNwmsxlYYzPhmovpAVzIIeJRFpGVe4h4xWk3v0_NQ&__tn__=%2CO%2CP-R,12,0,positive,12
pfbid02cDYPto2mXpVxUs8gTZ9wQxpEza7ouRBgmzBSqBH1Ag54YQLWVkdeJKpedu1XJ8Wal,NVIDIA AI,0,8,0,0,1,0,0,0,9,0,"Immerse yourself in next-gen NVIDIA technology and tools at #GTC23 with a full-day, hands-on technical workshop led by technical experts. Register now at a special GTC price of $149: https://nvda.ws/3k8CzHH",2023-01-18T00:00:00,[],https://external.fcai19-7.fna.fbcdn.net/emg1/v/t13/8463780468286096667?url=https%3A%2F%2Fprod2-sprcdn-assets.sprinklr.com%2F50276%2Fdba4b3d5-35d5-47ac-bb04-ed1f849856d3-1879607931%2Fgtc23-spring-dli-x4-drive-reg-.png&fb_obo=1&utld=sprinklr.com&stp=c0.5000x0.5000f_dst-jpg_flffffff_p500x261_q75&ccb=13-1&oh=06_AbG8XJBV4ilYXAdEZ-ve6Si6x6SAxIngnyhOYX14CjfuHA&oe=64E06A4B&_nc_sid=dbad39,https://www.facebook.com/NVIDIAAI/posts/pfbid02cDYPto2mXpVxUs8gTZ9wQxpEza7ouRBgmzBSqBH1Ag54YQLWVkdeJKpedu1XJ8Wal?__cft__[0]=AZXmq3Iqit9YfYx2LuglYJyEdiuD6RmOxKlw3mRV1Z30osf0GBHDWWPaCKqWbIoLWUVUS6HDSMUYTvqfbrM2hD-0VbKeuJK9Ur97VL2D-3LV17bUMRe9Xv4K5Tzb0moW2EzaoZ2WFa7qM4yyfEswEUGXzTIeuy1pi3AP_L7jVqwFCljwMktqPfA8CZKdFlea8btJQTT-jmd2qxICFORpl_Lk&__tn__=%2CO%2CP-R,9,0,positive,9
1118498085483126,NVIDIA AI,0,9,1,0,1,0,0,0,11,0,"Join our live webinar next week to learn how to build speech AI-based #intelligentvirtualassistants with state-of-the-art #speechrecognition that learns from conversations with customers, detects customer preferences, makes personalized recommendations, and engages with customers in real time. Register today. https://nvda.ws/3iG7E5e",2023-01-18T00:00:00,[],https://scontent.fcai19-7.fna.fbcdn.net/v/t39.30808-6/326247532_1266100050788217_4955924653841955624_n.jpg?stp=dst-jpg_p526x296&_nc_cat=110&ccb=1-7&_nc_sid=9267fe&_nc_ohc=oVY7kh6pnHAAX9WDNz0&_nc_ht=scontent.fcai19-7.fna&oh=00_AfBGu8sAz9B15KIcnzV6u3CXSqM2nDvjfbuOScIn8ukH8Q&oe=64E2BE30,https://www.facebook.com/NVIDIAAI/photos/a.119492422050369/1118498085483126/?__cft__[0]=AZX0GBHyR74jYrcfjrMYOyME9QEMgyKxDkmCyzwQMlm4ffYSTsw-8u9s7Ik3tHklh7pfHgoTLh6jeyBtlpeciZf21Wlwh7qy6_41aC_1Fi4789mKTKD9WFYV5DRLrV5LcVOxRCMXxs5574hUj9TouQ1G3N_CTlrDcvH0uc2TTzHB9PNvpZrPBP8ICTAioEzpsAnpZKP1n6bpzYAkkds-m6-D&__tn__=%2CO%2CP-R,11,0,positive,11
pfbid0FcM7x27QtGw6CY5ssa8bU6Ucsfkz4pnS77esHtXTAnGNLhCBY2c6GNKjPkeV1fjil,NVIDIA AI,0,11,0,0,1,0,0,0,12,1,"From @NVIDIA A100 GPUs to now reserve capacity on NVIDIA H100 GPUs, @CoreWeave Cloud continues to scale their infrastructure enabling them to deliver a massive capacity of #NVIDIA GPU-accelerated compute to Advance the New Era of #AI & #ML. https://nvda.ws/3iPaUv0",2023-01-18T00:00:00,[],https://external.fcai19-7.fna.fbcdn.net/emg1/v/t13/8144483541948919133?url=https%3A%2F%2Fassets.website-files.com%2F62bc66d283fd9c34ffec780a%2F63a0e52ac83bbd3aca0829d6_Untitled%2520design%2520%281%29.png&fb_obo=1&utld=website-files.com&stp=c0.5000x0.5000f_dst-jpg_flffffff_p500x261_q75&ccb=13-1&oh=06_AbFhw4aKseLq8N-u0cj1V29kntD6u4Wx5cpWfkB1YwgHRA&oe=64E08546&_nc_sid=dbad39,https://www.facebook.com/NVIDIAAI/posts/pfbid0FcM7x27QtGw6CY5ssa8bU6Ucsfkz4pnS77esHtXTAnGNLhCBY2c6GNKjPkeV1fjil?__cft__[0]=AZUATUFAn1Ku1WpBXJDeWL5oI5UnuLk7zfg4JOsIjQCHFjMu2XEmtdglOLfwyQOf_Dn2VTYz5rJp-N9YM1JzdDRURgMXnNGy5FaJwhx8dnVisvASYXo1xZbB1X4I3v-Dh9O83hO-o8pL_EMe509B1rqVDjb1Z-rIDwMs5G_JSY6Gr_PLjtmHQ8dWsUpo695ATeLRfOODkwwoIpBMZy3o403R&__tn__=%2CO%2CP-R,12,0,positive,12
pfbid02tSVk8ypxN4UguZKdycE5dvLN4u62EdDFa6ex9AkgroRv4kV3fdQcGpB3BH6xVA9xl,NVIDIA AI,3,24,0,0,0,0,0,0,24,1,"GTC registration is now open! Discover our top speakers and explore breakthroughs in AI, accelerated computing, and beyond. Join us online March 20-23 and register for free today. #GTC23 https://nvda.ws/3QnZKd7",2023-01-18T00:00:00,[],https://scontent.fcai19-7.fna.fbcdn.net/v/t39.30808-6/324872661_1343456426410372_1473872140963522490_n.jpg?stp=dst-jpg_p526x296&_nc_cat=103&ccb=1-7&_nc_sid=9267fe&_nc_ohc=fR71vBla5qQAX_SqetY&_nc_ht=scontent.fcai19-7.fna&oh=00_AfBiuHhMLRqtB33St1KB5AftzpyCuzLXumpdhXLwt1VU5g&oe=64E39633,https://www.facebook.com/NVIDIAAI/posts/pfbid02tSVk8ypxN4UguZKdycE5dvLN4u62EdDFa6ex9AkgroRv4kV3fdQcGpB3BH6xVA9xl?__cft__[0]=AZXxiITZktUVcUp8kcfuUD0X3vTpv8PWVZxJ0ykDAXy4nFV3npD7Yf3dzmapVgS-D8EdTxhRDXCZXoUgkqtSDx2vrVaZSAzfF6erBwpEPj6bNgzdKMLQnI3wRhnyzHSkBHOf60LC6wShnoy4PlFsRjLk_GQPS7d6M69Ycg__OgNZlzNQMahjSEzSueCd8oblvyz5jM2T9lloU6zY4ClDubxkfBpIzQpSsO5a2TgTjlQJiMaT2MLHt7OvOd8wqNqEv4eLinDpmA344VGYJMUt_e6O&__tn__=%2CO%2CP-R,27,0,positive,27
1118418825491052,NVIDIA AI,0,12,0,0,1,0,0,0,13,2,"We’re entering a new frontier that demands an AI-first infrastructure. Learn how to overcome common challenges, including building and operationalizing AI, Machine Learning, and Deep Learning models. See how your organization can benefit: https://nvda.ws/3ZxAmpe #MakeAIYourReality #AzureHPCAI #NVIDIAonAzure",2023-01-18T00:00:00,[],https://scontent.fcai19-7.fna.fbcdn.net/v/t39.30808-6/322128836_674702141100805_3195018712345795955_n.jpg?stp=dst-jpg_p180x540&_nc_cat=108&ccb=1-7&_nc_sid=9267fe&_nc_ohc=64QD9FHHP_AAX-WM_UB&_nc_ht=scontent.fcai19-7.fna&oh=00_AfCMSfomgcdwGBT3V5OJKmnObNuOcoqXFALWGB-trSmjVA&oe=64E2EA18,https://www.facebook.com/NVIDIAAI/photos/a.119492422050369/1118418825491052/?__cft__[0]=AZXnzC86fzP8La_-w5f4W3dSuyE28gk6jX1OSVrzs-5OVS-2v17tIcgZJdUV-n2OSw2DQ09mXwyzdNpSe-NdfC2uGgijYMAOdBTSTpHRIbQODubLV3tg_1TaKeIFcEEH6yVvuxs7JJgXiE1uPvW_KIU3VZ_4YmFAO1xPSYzX0MNRhwFOusupdoYkIo2dIHf3OOPzVtwCdU81at2WDHtHNK6_&__tn__=%2CO%2CP-R,13,0,positive,13
pfbid06NZbujP6Jg4uBex7FP2aHeEhQraXzarmUKBXpxSPLYzuUji39ym3uxKQy7j91JsEl,NVIDIA AI,0,15,0,0,1,0,0,0,16,3,Looking to deploy your real-time speech AI application to production? Get the code in this tutorial to autoscale NVIDIA Riva deployment in a Kubernetes environment.https://nvda.ws/3wgKO73,2023-01-17T00:00:00,[],https://external.fcai19-7.fna.fbcdn.net/emg1/v/t13/6386310031067164164?url=https%3A%2F%2Fdeveloper-blogs.nvidia.com%2Fwp-content%2Fuploads%2F2023%2F01%2Fcomputer-cloud-gpu-graphic.png&fb_obo=1&utld=nvidia.com&stp=c0.5000x0.5000f_dst-jpg_flffffff_p500x261_q75&ccb=13-1&oh=06_AbG2aARUE5CYOr4zTSCqfVheqrJRhQVSOjCplUzXqZSLgg&oe=64E028ED&_nc_sid=dbad39,https://www.facebook.com/NVIDIAAI/posts/pfbid06NZbujP6Jg4uBex7FP2aHeEhQraXzarmUKBXpxSPLYzuUji39ym3uxKQy7j91JsEl?__cft__[0]=AZW2gjcNcXRkbhHC3MXnQxRNeF_wIsdq3WiidvBtyb1EYbkKDofyD14auc7IeiDhbkqMJurcL47ZB3ZQ5cnvm3600nICDMG5WEwiZyFL_flaZ7PSQihlXC_uapDVM76PErrAV9tj4nfoMEY5qbjf6Qtssyezz7zUevjUK2cEwuLn3EMkZfnaAcY9lh3AfmkjbxnsvHauBRPSe6EQQS_PKVMI&__tn__=%2CO%2CP-R,16,0,positive,16
1117899888876279,NVIDIA AI,0,19,0,0,1,0,0,0,20,1,"Kroger, the largest grocery chain in the United States, is reimagining the store shopping experience with #simulation and #digitaltwins to determine the best customer shopping experience and provide fast and easy checkout. Watch video: https://nvda.ws/3w9M245#NVIDIAOmniverse #NRF2023",2023-01-17T00:00:00,[],https://scontent.fcai19-7.fna.fbcdn.net/v/t39.30808-6/323633337_4135923123300204_5010079277918203142_n.jpg?stp=dst-jpg_p526x296&_nc_cat=109&ccb=1-7&_nc_sid=9267fe&_nc_ohc=EmfUsh7ZQUIAX9n24iY&_nc_ht=scontent.fcai19-7.fna&oh=00_AfD8CiPhNDhQEeknMGB5KIRSqUx57lZ0bdZa_8FvaCck2Q&oe=64E40FB0,https://www.facebook.com/NVIDIAAI/photos/a.119492422050369/1117899888876279/?__cft__[0]=AZXqPfdJtKlmjP8uH3lT46g4keuz5ndj7XC1Cv8kGckUZ8mOC7uF_caQLepcTc8gP8Fe2ojVhtmF89YjJYu9KjRZzz3Fdvg_7vbs4Vt2f9MBtVKxhwXZexVYxiOLyoNIRSBqXAtTivQ82wxfbHtL7ktJKgHUXLhEauvfjt9agU-3pHISDWmEcHaOk12L-ncFF_PHlAHnNygxym8G4II32Tba&__tn__=%2CO%2CP-R,20,0,positive,20
1117812408885027,NVIDIA AI,4,13,1,0,1,0,0,0,15,1,Reminder to tune-in today: Join Jensen Huang and Michael Dell for a fireside chat at the Dell Technologies PowerEdge .Next event as they discuss accelerated computing breakthroughs. https://nvda.ws/3GCSUfl,2023-01-17T00:00:00,['https://video.fcai19-7.fna.fbcdn.net/v/t42.4659-2/312583504_8127870893951231_6993026774285756993_n.mp4?_nc_cat=111&ccb=1-7&_nc_sid=73e57b&_nc_ohc=tFESzBf1qcQAX952z7n&_nc_ht=video.fcai19-7.fna&oh=00_AfCHwoBVqwn0apw3OVThYyZiWqtAE-sY8Q3g6W8HmAN8qw&oe=64DEE6E8'],https://scontent.fcai19-7.fna.fbcdn.net/v/t39.30808-6/325778832_698827051748700_462688704174944649_n.jpg?stp=dst-jpg_s960x960&_nc_cat=109&ccb=1-7&_nc_sid=9267fe&_nc_ohc=LdaSzxTJfUkAX_s34B6&_nc_ht=scontent.fcai19-7.fna&oh=00_AfAwcCZnQlWhNt2s7N1ci_G3Z--MtvQVU1eYRBARqJBzdg&oe=64E3E6AC https://external.fcai19-7.fna.fbcdn.net/emg1/v/t13/10450756573861748027?url=https%3A%2F%2Fmedia1.tenor.co%2Fimages%2Fd2564979acbd1c69958d880ceaee7c65%2Ftenor.gif%3Fc%3DVjFfZmFjZWJvb2tfd2ViY29tbWVudHM%26itemid%3D5691733&fb_obo=1&utld=tenor.co&stp=dst-jpg_flffffff_q75_s960x960&ccb=13-1&oh=06_AbH_wKd6AMGlxqDkaHHwCimd8DkEZotks_zGRxTCQboBvA&oe=64E0AA70&_nc_sid=75c735,https://www.facebook.com/NVIDIAAI/photos/a.119492422050369/1117812408885027/?__cft__[0]=AZU1NsFnRt8J5033SGXQt0zOEgTyKsDqOdDgQ-JhqvuebLuOk-sF_RIUxCiLhqMF0y_nUyfcNIkmWOum5G7oHNsY_ekoBxD-lgnGnPBdPIW7EGuWTzwy4pvb-BtCaOYIRX95_Q7ZrVapu3qyTdUBs7-HheAbH76a4KVAPiwmJh7jqHSmND51BNUPrsoxoFGjypx1L2zbSVKPQ8sLtrNAeLDs&__tn__=%2CO%2CP-R,19,0,positive,19
1117690952230506,NVIDIA AI,0,11,0,0,2,0,0,1,14,0,"Today at 11:30 a.m. ET join #AI industry experts from Kroger, Lenovo Data Center and NVIDIA at #NRF2023 to hear how Kroger is reimagining the shopping experience using #simulation and #AI to optimize store layouts and the checkout process. https://nvda.ws/3GjFd5Q",2023-01-17T00:00:00,[],https://scontent.fcai19-7.fna.fbcdn.net/v/t39.30808-6/325921438_1208237713454713_8068723848931248550_n.jpg?stp=dst-jpg_p526x296&_nc_cat=106&ccb=1-7&_nc_sid=9267fe&_nc_ohc=eeXEAMOab-UAX8qnsp2&_nc_ht=scontent.fcai19-7.fna&oh=00_AfBdwBpdLyEFBi7ikdpGmC0d1bCjwbM1sGos4fCRVV4NEw&oe=64E3123D,https://www.facebook.com/NVIDIAAI/photos/a.119492422050369/1117690952230506/?__cft__[0]=AZVxKsZAwmwMqKQ-H8ppy4ptPkyqLqB6a0gwvVVSuCS4jJrqxDM1HCffjTqJTA5UG2AA9_afEpU4q_INpnDxfJz4B1D9Z_SHy99qR41G8TISa2B0kMMvg9ex6ffPU5CcvPbDPx-wR1iSi_iI2XBf0yisIbgGLo-WgovzSSdShRNGlrvch_IAgn7QluD9RTQOu4KW2bZoevkI89xU27CMqH57&__tn__=%2CO%2CP-R,14,0,positive,14
1116813865651548,NVIDIA AI,0,13,0,0,1,0,0,0,14,2,"Wondering what’s the latest in #AI? Discover highlights for how to build and operationalize AI, Machine Learning, and Deep Learning models in an organization at any scale. https://nvda.ws/3XhzjYU#MakeAIYourReality #AzureHPCAI #NVIDIAonAzure",2023-01-15T00:00:00,[],https://scontent.fcai19-7.fna.fbcdn.net/v/t39.30808-6/325580384_1319486648889141_3982671018301028948_n.jpg?stp=dst-jpg_p180x540&_nc_cat=111&ccb=1-7&_nc_sid=9267fe&_nc_ohc=Ypi5pjigtY0AX_LLqRa&_nc_ht=scontent.fcai19-7.fna&oh=00_AfD46RsdOibEQAu-sXvp5fhfPiXbhXN2V6hr3BgsnQPHZA&oe=64E2D238,https://www.facebook.com/NVIDIAAI/photos/a.119492422050369/1116813865651548/?__cft__[0]=AZWKuNDhD1sSda23D_Gg9GhH7DBhpq3zLKodk1oZtD6Nhsr0gxodbu0I0keEejMzS7Cpj1LiWj5r6mSG0KWg2QoSZFnbFZongWUySCgDqc2byBKFHkSYIdJxDsKICV_QcTZDFJSeozKEBCU5X2At3nnkVz_r9V6R7KH7O4HE_ijGhLLX5vyz4Vv4oBUq0gwMig2LM7KEJ5QK3f_m3Ay0w4TB&__tn__=%2CO%2CP-R,14,0,positive,14
1116570689009199,NVIDIA AI,0,12,0,0,1,0,0,0,13,1,"Today at 2:00 p.m. ET join #AI experts from Lowe's Home Improvement, Dell Technologies and NVIDIA at #NRF2023 to hear how they're using #digitaltwins to optimize operations and localize plans to better serve customer needs. https://nvda.ws/3GmH9uA",2023-01-15T00:00:00,[],https://scontent.fcai19-7.fna.fbcdn.net/v/t39.30808-6/323715807_1336985530199092_6150317737575344996_n.jpg?stp=dst-jpg_p526x296&_nc_cat=100&ccb=1-7&_nc_sid=9267fe&_nc_ohc=CCn1YwlHlQkAX_QEV12&_nc_oc=AQkXVuskl6xuYsku5JNhWYeMXNzza_4vETTYpHAr3pyOyNV0egmlAZ9DHhgiJCpceNs&_nc_ht=scontent.fcai19-7.fna&oh=00_AfBUOY9hvCzp8cosXdv7bjt_c4V0849Bef0HZOwuEhJosw&oe=64E361C3,https://www.facebook.com/NVIDIAAI/photos/a.119492422050369/1116570689009199/?__cft__[0]=AZWp-i5W5sx2Ec1kxzBJMO1XRYBwgdGraCULaq9i243tza6e8L3wYuUb3wjJWynWsrRhR40htIM3G9y-gxjSbp21Tks3fsQKDdrNOKUeGVbIx5XociwZfNs18rrqP8sudjbg_PlCtzW8SmNo6UfK1be06kcbpAhX9AdWUBYs94balJ9lD0R9LA1WEIKYR2F3fGLVxMWgpWKF0xUIyB73Z66i&__tn__=%2CO%2CP-R,13,0,positive,13
pfbid0312WjButboL6zSZfECRgx8YTmj5d2siGG9qsgTeNJiXPZGEWoGCRsTLFWFQd1bBVJl,NVIDIA AI,0,15,0,0,1,0,0,0,16,4,Tech Explainer: What is federated learning?Federated learning makes it possible for #AI algorithms to gain experience from a vast range of data located at different sites.  Learn More: https://nvda.ws/3GIBBcR,2023-01-14T00:00:00,[],https://external.fcai19-7.fna.fbcdn.net/emg1/v/t13/16209378189945259720?url=https%3A%2F%2Fblogs.nvidia.com%2Fwp-content%2Fuploads%2F2019%2F02%2Fxx-health-care-key-visual.jpg&fb_obo=1&utld=nvidia.com&stp=c0.5000x0.5000f_dst-jpg_flffffff_p500x261_q75&ccb=13-1&oh=06_AbFnOf5OCOrQsoWYEafZzRYMmTSPLwWNTC5jh2UgbeVVqA&oe=64E0AFC9&_nc_sid=dbad39,https://www.facebook.com/NVIDIAAI/posts/pfbid0312WjButboL6zSZfECRgx8YTmj5d2siGG9qsgTeNJiXPZGEWoGCRsTLFWFQd1bBVJl?__cft__[0]=AZVE0MxjfbJocag2sFP3Gm14gn0tYjAHoMlyfTQKTzFM2dHWi7U_QZH-WAU0FXu0NDHFAMXiypGwEDoNfiSv_ubte9o0wuNOcE-HqmGx2EThQM2RI6h4D3O22xshxFe0Mj8Gnvjbg1PzKkYUv8WumP9Q7Q0HsSqLSAyspOWpZcqPG6EWeTkAyiCSDTuzPDEKJxqeWC90-UCb7nOguSVb6zlJ&__tn__=%2CO%2CP-R,16,0,positive,16
pfbid0wCpN8V3AoPN2xB5gUUeABNv1Nfycm3tGmqyxTpLgTNa1J7h7zvKAchJCMa1UMmv4l,NVIDIA AI,0,12,0,0,1,0,0,0,13,4,NVIDIA is leading the way in #AI computing and we would love your feedback! Your input directly influences the product roadmap and provides a diversity of data needed to train our AI models.,2023-01-14T00:00:00,[],https://external.fcai19-7.fna.fbcdn.net/emg1/v/t13/7916480964227877211?url=https%3A%2F%2Fwww.nvidia.com%2Fcontent%2Fdam%2Fen-zz%2FSolutions%2Fgeforce%2Fampere%2Fbroadcast-app%2Fnvidia-broadcast-app-announcement-gf-lp-og-1200x627.jpg&fb_obo=1&utld=nvidia.com&stp=c0.1.1200.626a_dst-jpg_flffffff_q75_s500x261&ccb=13-1&oh=06_AbH2WsWlODC0Vb5wi3X3Qm25XO91yFls1NSDOl44QzDJ1A&oe=64E019D1&_nc_sid=ff403b,https://www.facebook.com/NVIDIAAI/posts/pfbid0wCpN8V3AoPN2xB5gUUeABNv1Nfycm3tGmqyxTpLgTNa1J7h7zvKAchJCMa1UMmv4l?__cft__[0]=AZX0JBVo0Ksp0Ld_4z4VLvSNXiBMmfjZfH09l8ktupEgbXjvDHvVXk_qjQNIxwb2ebJjj4e__BDgMqTloA_5zHCoWlcclulhWsnyKh8UFMdxgodzyxDLVO1uH5h_nJ1dxl9h0Nada2bY95GCjO6mNh-sAw1-oruVBGysf8Ym9_kD88ZPQ4r7O0Zm36upa0TwuI1De5wBlKMSLxrqO3ITvYV_&__tn__=%2CO%2CP-R,13,0,positive,13
pfbid0beLqZArLuAJtR3w79uj6xoRZnhG32NKZ9zkEQUzyXuvjYnmeb146CoTniqbVE8bol,NVIDIA AI,0,9,0,0,1,0,0,0,10,0,Stay up to date on the latest large-language-model (#LLM) technologies and breakthroughs. https://nvda.ws/3GHSnsv,2023-01-13T00:00:00,[],https://external.fcai19-7.fna.fbcdn.net/emg1/v/t13/17456621709451467310?url=https%3A%2F%2Fwww.nvidia.com%2Fcontent%2Fdam%2Fen-zz%2FSolutions%2Flp%2Flarge-language-model-news%2Fnvidia-llm-news-og-100.jpg&fb_obo=1&utld=nvidia.com&stp=c0.5000x0.5000f_dst-jpg_flffffff_p500x261_q75&ccb=13-1&oh=06_AbFiTZHILFtWbbORWMrN2p6DNZJnDrJFSW8gUGQNtAuHFg&oe=64E058F4&_nc_sid=dbad39,https://www.facebook.com/NVIDIAAI/posts/pfbid0beLqZArLuAJtR3w79uj6xoRZnhG32NKZ9zkEQUzyXuvjYnmeb146CoTniqbVE8bol?__cft__[0]=AZUx3iJWAp1M-ts1LVcqKAx6ZiFvANlWB-eqpxFUyYZqa3miDfQwUk0I7YI7jACO8d0n5d7a_pzF3ABBs35dphgrcFF3evc9ajF2HVZK5WQMDC3CBqaqtld2xYKsswb6TgA0ZuL8JFAAm5q8DsZbxNOTLp-hpJYzB67va0Ph2x8BFuiMyQZDZaDQrIJ1LTDBowz5n-Du6GF9dyrPLmP3kHH4&__tn__=%2CO%2CP-R,10,0,positive,10
1115393165793618,NVIDIA AI,0,13,0,0,1,0,0,0,14,3,The high demand of today’s AI is outpacing modern computer advancements. That’s why purpose-built cloud infrastructure is needed for AI applications in organizations of all sizes. See what it can do in this latest article: https://nvda.ws/3IE4GIZ#MakeAIYourReality #AzureHPCAI #NVIDIAonAzure,2023-01-13T00:00:00,[],https://scontent.fcai19-7.fna.fbcdn.net/v/t39.30808-6/325417770_584595689665525_3801014474859948579_n.jpg?stp=dst-jpg_p180x540&_nc_cat=110&ccb=1-7&_nc_sid=9267fe&_nc_ohc=YEtBDuJ6UrkAX_vzbk2&_nc_ht=scontent.fcai19-7.fna&oh=00_AfCF1GGePDokDlVpxDmNJDlOd_7yC-3CYQKx9MwxXxUemQ&oe=64E32A21,https://www.facebook.com/NVIDIAAI/photos/a.119492422050369/1115393165793618/?__cft__[0]=AZVR2aCSXuem1QoE7WcluXIRNI8kku0QV8YH6lRQheiPXsSkCRj6zM20ow4f6MT3xFSo9YhJW-Q0lhkEkSX_Hrl3nZ1ekEE6ffj8UVPo_yXf9ucvU77WYuPIS95fM-sgFhCh9Xt1cPY46ZzdOjiwtS0MDo5YX0aTTiMEAFy-JxdiSo5-bgCHPNcIlv8Re_HMCZXFPYChNyUAeN7yNY9BxHVI&__tn__=%2CO%2CP-R,14,0,positive,14
1115176505815284,NVIDIA AI,0,15,1,0,1,0,0,0,17,3,"Did you know that next-gen data science now runs on GPUs? Join NVIDIA, Katonic.ai, and PI.EXCHANGE on 1/18 to learn how RAPIDS platform built by NVIDIA can help you increase efficiency and achieve more cost-effective data operations for better business strategies. Register now: https://nvda.ws/3CJa7md #NVIDIAInception",2023-01-13T00:00:00,[],https://scontent.fcai19-7.fna.fbcdn.net/v/t39.30808-6/324108792_5845616525529209_2097115877008271593_n.jpg?stp=dst-jpg_p526x296&_nc_cat=109&ccb=1-7&_nc_sid=9267fe&_nc_ohc=B9U0g3PSiS4AX8mZqAr&_nc_ht=scontent.fcai19-7.fna&oh=00_AfAIpOGbnTTKThOUIeTAY8FHTPvWReBMzBjjvclKh6bTlA&oe=64E40CC5,https://www.facebook.com/NVIDIAAI/photos/a.119492422050369/1115176505815284/?__cft__[0]=AZU8qxuJKXEv-8ReVCV1wFLoHWp9drHOZlTSRrWSTHYev42lQ02k2roTXr1onGHN49frc4rkPj_SQnJ7UqeYjOYGHqB3rYj6q8IgnHFLw9BZC_UIvAmxpHbRh53UjUHMPkaMs8mFP3ZnYrK-gy0IGi0N8udsXIt-9X-3lbvQG09LEW7QfGx4xwB1KLzRIpz3R4S1khTefC_USk0Ih0MHLTxg&__tn__=%2CO%2CP-R,17,0,positive,17
pfbid0ctRReAchTi6GVa61EyJfnU9hLVC9B4a7cyvXRBLhydqmkAeAyotaNcbYBLwMLZL1l,NVIDIA AI,0,8,0,0,1,0,0,0,9,0,Today we unveiled three Retail AI Workflows to help solve the #retail industry’s $100 billion shrinkage problem. Learn more: https://nvda.ws/3vYkzCh#NRF2023,2023-01-12T00:00:00,[],https://scontent.fcai19-7.fna.fbcdn.net/v/t39.30808-6/325419941_690246492836391_7187086916062465943_n.jpg?stp=dst-jpg_p526x296&_nc_cat=104&ccb=1-7&_nc_sid=9267fe&_nc_ohc=W4XDmCNuRpEAX-D9h9T&_nc_ht=scontent.fcai19-7.fna&oh=00_AfCui4dUGaRzKLgwcPAQlECra1Uax66wlKZCzmD2s5EwWg&oe=64E38B4C,https://www.facebook.com/NVIDIAAI/posts/pfbid0ctRReAchTi6GVa61EyJfnU9hLVC9B4a7cyvXRBLhydqmkAeAyotaNcbYBLwMLZL1l?__cft__[0]=AZU1lB35hJPZU8pyBuh5jCouCqDsaoox0z7FHdZHsOCVcbkGMBVUUMUhqypBUxZtWlk9dHrcSpyJ-2hZ0FEEPOIG_H9AuN5VcnZTvJkPln-J4U6PJ5RRL3Qkbfw0altBjLzE6aWLWd-vcTOuOcVITIp_bTqmFQWIEVBOEnk8hvJ9BoL0TA7IvQVcyKiH70HJiQCcUa9JbNr_TqdZXwaXMf2u4OHFKWYWbhcfhAm9dkTHi0EYPPCQwe9AFcH0cI0Sk5GL0Ijzq7jOoO15wIL8Qn7X&__tn__=%2CO%2CP-R,9,0,positive,9
pfbid036F8kwWG6K8LepyxkeMUHBr96yf8mR3VeXiaFLyBG5yeXtCSP7gYvNUaQ3F1Up8nol,NVIDIA AI,0,8,0,0,1,0,0,0,9,0,Evozyne uses NVIDIA #BioNeMo for #LLMs that generate high-quality proteins that can speed drug design. Learn More: https://nvda.ws/3iz6mst,2023-01-12T00:00:00,[],https://external.fcai19-7.fna.fbcdn.net/emg1/v/t13/4280061668227778958?url=https%3A%2F%2Fblogs.nvidia.com%2Fwp-content%2Fuploads%2F2023%2F01%2FEvozyne_protein_3.jpg&fb_obo=1&utld=nvidia.com&stp=c0.5000x0.5000f_dst-jpg_flffffff_p500x261_q75&ccb=13-1&oh=06_AbEsCS8TxGBoD2bHeOtUgI8OlQ-6NIumHFSXZ3spbNqqJA&oe=64E0A0B6&_nc_sid=dbad39,https://www.facebook.com/NVIDIAAI/posts/pfbid036F8kwWG6K8LepyxkeMUHBr96yf8mR3VeXiaFLyBG5yeXtCSP7gYvNUaQ3F1Up8nol?__cft__[0]=AZW_eOUHUM02C1J9zN97kvGha2eI_6ClkNqN4B3xXNShGweJSO6mhXwEC3VgLPlYx8NVr2RYYJvC2C-VomLQl5g4O9gBmPk6n0QKfSIj_EBvap06jVyOiOjGgeMpI1Mp95A_OnuQEZqg1vaBH4uPS9V34fw2HGIkpJStfOdi1pcX3rkvvP3XzbmTiIln9mTFQbcUzmVRAs0toSDxEIFYso3W&__tn__=%2CO%2CP-R,9,0,positive,9
pfbid0LWBeRX2ZsvnMkMMkCVY2nirxwPDH6d7hJEFNov93q6zCgLqhVpbnXotuVtsbDkTVl,NVIDIA AI,0,11,1,0,1,0,0,0,13,1,"Thanks to our employees, NVIDIA is again one of the Best U.S. Workplaces, according to Glassdoor. Learn more about us: https://nvda.ws/3VYcIiV #GlassdoorBPTW #NVIDIAlife",2023-01-12T00:00:00,[],https://scontent.fcai19-7.fna.fbcdn.net/v/t39.30808-6/325309493_512523894068656_5200727847944407514_n.jpg?stp=dst-jpg_p526x296&_nc_cat=109&ccb=1-7&_nc_sid=9267fe&_nc_ohc=dUQom5AhsnIAX89DY7V&_nc_ht=scontent.fcai19-7.fna&oh=00_AfD4oUt38eY53HUVfvwqMicaeptd-PkPwvHLOoMIZ5ki1A&oe=64E4A993,https://www.facebook.com/NVIDIAAI/posts/pfbid0LWBeRX2ZsvnMkMMkCVY2nirxwPDH6d7hJEFNov93q6zCgLqhVpbnXotuVtsbDkTVl?__cft__[0]=AZXWSZwtTROhupnpucFUj2M8f5PH02Dw2sK3v5EHzBXm81N3RCwinR5cyYXnRS7ohFl2snLgwvLFC8MuACCrEDwZjxOXMpJts3uTK2tzN-aEGrRuRWHbcbetf85_IIJFd_2uTQbXAA8H9BH4c-hHR9KJgpkxySDG9aTUPMXOExMrJ5xs1lt4PDBr5YAZ4E39rDNsk9fULX2qA5FJVzyjL66SIRWEl0X4nps49WlLZBdMd7icIFTXEtj1NK5Az6ddDFQ7XimCU5niviUKbhLWkjWS&__tn__=%2CO%2CP-R,13,0,positive,13
pfbid02ZMemQwb7La2uRwfD7mppj7p7xZPgrfEtiMRDfxCTgmgPkvhhSAYgF3amTmFNkD6dl,NVIDIA AI,0,17,2,0,1,0,0,0,20,6,"Robots are becoming more connected and collaborative through the industry with platforms like #NVIDIA Isaac ROS and protocols like VDA5050. In this webinar, learn how to use Isaac Mission Dispatch to manage a heterogeneous fleet of #robots from the cloud. Register today > https://nvda.ws/3GBE6h3 #ros2",2023-01-12T00:00:00,[],https://scontent.fcai19-7.fna.fbcdn.net/v/t39.30808-6/322018306_701573218103410_1358144388162309010_n.jpg?stp=dst-jpg_p526x296&_nc_cat=102&ccb=1-7&_nc_sid=9267fe&_nc_ohc=a3WgTVCfgCkAX8m_h5P&_nc_ht=scontent.fcai19-7.fna&oh=00_AfCgWdPikorMSlHfQynV7iR-civ9AwNamchskcxPLemT_A&oe=64E46A4B,https://www.facebook.com/NVIDIAAI/posts/pfbid02ZMemQwb7La2uRwfD7mppj7p7xZPgrfEtiMRDfxCTgmgPkvhhSAYgF3amTmFNkD6dl?__cft__[0]=AZXxaplYfGPu4fZXIV1kn-EiA6eflYyuKLvXDU5cuUL1QyK1a636Y6uncQGFx-rpaI2_AqRXGUnMDKBGBVfr5v4EAZ93qf9fYQTy6GcUt1aZvsPsa5nIyQr-IU-GY0nMBw3BMqKVmrrPfN8-v3oigrWtoGvFhdiYNIvuHPIIooVBRUD288UQmhVZtDUzdB5ymWwAxcGP_QNQ1uuCHDPBpua5YeIR1F5HNbNdBsuuUJI_wPuYGgdiCvC6gq8cxfQMgVKLnn_0127EfiWIrHm93JyV&__tn__=%2CO%2CP-R,20,0,positive,20
pfbid03jLiQ9rBxfoyViX2XnUQU9ZsS5R2JN7XNkLFSbWvuJ8mnKhgoT9Ezx8rzXihVUP5l,NVIDIA AI,0,17,0,0,1,0,0,0,18,1,Tech Explainer: What is edge computing?  It is the concept of capturing and processing data as close to its source or end user as possible. Why is this important?Learn more: https://nvda.ws/3k5z0C4,2023-01-12T00:00:00,[],https://external.fcai19-7.fna.fbcdn.net/emg1/v/t13/239920434870500704?url=https%3A%2F%2Fblogs.nvidia.com%2Fwp-content%2Fuploads%2F2019%2F10%2Fedge-ai-image-what-is-edge-computing-1280x680-1.jpg&fb_obo=1&utld=nvidia.com&stp=c0.5000x0.5000f_dst-jpg_flffffff_p500x261_q75&ccb=13-1&oh=06_AbG7HUXLRs_G1s9xLBE6nw_epKMkyU7z02c-j_oEjpDQdg&oe=64E08C96&_nc_sid=dbad39,https://www.facebook.com/NVIDIAAI/posts/pfbid03jLiQ9rBxfoyViX2XnUQU9ZsS5R2JN7XNkLFSbWvuJ8mnKhgoT9Ezx8rzXihVUP5l?__cft__[0]=AZUv3yCsOa0tf4p2Mq7VDowdtTZdGZklhUd1BkN-EHSAU44Yeq2Ko-XppLHRG6xuqzghRW3Vn9CE60lG9_wi0Y6Dk-T6iL5PvMhmqo1niEhgjyESPZVbQFGiXdIhCXkUiFuirNa5MZmLNqRjJG1ohzsTCXtqO7U4C-cjJ5ntQc_KFZ4VPdAtqfHbTc8qyVavkryjiossb48UPSfTVFiDuOVF&__tn__=%2CO%2CP-R,18,0,positive,18
pfbid0c4NMmktm94m5mG3vcubpU3PGXT5xpReAdic87EovX86Au73emK3XQ8avQFiyAeMGl,NVIDIA AI,0,6,0,0,1,0,0,0,7,0,"Advance your technical skills at #GTC23 with Deep Learning Institute. Take a hands-on training DLI workshop in AI, accelerated computing, data science, graphics, simulations, and more for $149. Register now: https://nvda.ws/3k8CzHH",2023-01-11T00:00:00,[],https://external.fcai19-7.fna.fbcdn.net/emg1/v/t13/3831688130014303499?url=https%3A%2F%2Fprod2-sprcdn-assets.sprinklr.com%2F50276%2Fc2a71390-08e5-4ebd-878d-9564b6ee4c10-1879607931%2Fgtc23-spring-dli-x4-drive-reg-.png&fb_obo=1&utld=sprinklr.com&stp=c0.5000x0.5000f_dst-jpg_flffffff_p500x261_q75&ccb=13-1&oh=06_AbEgLauJ1aLgMQRAxg-In_WhKuF4xo-3GrkjiAfJgCv1Cw&oe=64E044F0&_nc_sid=dbad39,https://www.facebook.com/NVIDIAAI/posts/pfbid0c4NMmktm94m5mG3vcubpU3PGXT5xpReAdic87EovX86Au73emK3XQ8avQFiyAeMGl?__cft__[0]=AZWZ2Y3sfdIH66AFVzIBF39Hwx31a20Q3gpkU19T6ee-da3RnkZqHMOFsx95RMB_v9CsjH-qeQ4XGBanYxRoXamnuepR_T6jbB8u7qK7COC7aRVRlBrj79xrtYkcFgQdam3EApNBZSX-qD-mQ8agSYSH3Sq9rJZXrXnXC0tDmutLqG2xgJJCuDceYhFZC9Q0w5Rya6LcRycJHTYWn-EMc7SM&__tn__=%2CO%2CP-R,7,0,positive,7
pfbid0KbYbM4tJF4ERZHWUYmPU8wbTvBk2ZQ4vrfARmb7JCLc7HHwBz2tZmm5t9cdcu8Rfl,NVIDIA AI,0,9,0,0,1,0,0,0,10,0,Explore the top four ways #speechAI is personalizing customer experiences in contact centers. #transcription #avatars Read now: https://nvda.ws/3IKwUBI,2023-01-11T00:00:00,[],https://external.fcai19-7.fna.fbcdn.net/emg1/v/t13/9524642840731926106?url=https%3A%2F%2Fblogs.nvidia.com%2Fwp-content%2Fuploads%2F2023%2F01%2Fspeech-ai-contact-center.jpg&fb_obo=1&utld=nvidia.com&stp=c0.5000x0.5000f_dst-jpg_flffffff_p500x261_q75&ccb=13-1&oh=06_AbEsOgNVDm5ciB8fDWSr25wm2NBtZ-Il1c7KQw5QdmPCLw&oe=64E04969&_nc_sid=dbad39,https://www.facebook.com/NVIDIAAI/posts/pfbid0KbYbM4tJF4ERZHWUYmPU8wbTvBk2ZQ4vrfARmb7JCLc7HHwBz2tZmm5t9cdcu8Rfl?__cft__[0]=AZV5B_Ue17k3B1bEt186AlYaYwO9jdAOhgj71QTRA6hiMETWyXsuTAvc8iYSvLoL992pl3FoU6ppRqh9DMToBoqjfCOVDV_WVM-Jd_f2Bxe1A0aiJGUoggzrhbWRgqEIngl-GMcXMpz7xXWLSxngUnHiwfplhoEVKYHGQkrk0hbE4mwpGb4oXd7lEf8XB9-ZC0SyCfY5vBndPQXJcBhbCp-d&__tn__=%2CO%2CP-R,10,0,positive,10
1114330835899851,NVIDIA AI,0,9,0,0,1,0,0,0,10,0,Learn how your company can build and deploy speech AI-based #intelligentvirtualassitants to engage with customers and improve their experience in real-time. Register now! https://nvda.ws/3CJtjjx,2023-01-11T00:00:00,[],https://scontent.fcai19-7.fna.fbcdn.net/v/t39.30808-6/321916092_901080841343211_6553994173339654297_n.jpg?stp=dst-jpg_s960x960&_nc_cat=103&ccb=1-7&_nc_sid=9267fe&_nc_ohc=ZE5slbQvfocAX9-hDFy&_nc_ht=scontent.fcai19-7.fna&oh=00_AfB5KPba7eLIhKHoSGC-_V5qChed4OjFG_IeWI4u5HiTVw&oe=64E33998,https://www.facebook.com/NVIDIAAI/photos/a.119492422050369/1114330835899851/?__cft__[0]=AZXuOHZtcruCSsiYXAHjLZHWgFEyO2NDVdKcQ24sA3St_OJ-Z-KeL7pf1oNFxbXHEBzA9sonyuP518GOCGKuiAjiruRXuyVnmOQ6L6eSXfGzAwf_-pzjTM1xitV7IaVoj8gpQ48AYi4gC0RZwOqqOKDJXRYbsEi65lZ6YJSZTDyBZJFKkbWpv6V6Y-Gp2csiLHkXdjRzniVRL3JUmJ7S8RG1&__tn__=%2CO%2CP-R,10,0,positive,10
1114307965902138,NVIDIA AI,0,9,1,0,1,0,0,0,11,1,"Each year, over 100 million tons of plastic waste is generated and less than 10 percent is recycled. On January 25 at 8 AM PT, learn how Encina simulated advanced recycling technologies over 500x faster using CPFD Barracuda Virtual Reactor, accelerated by NVIDIA, running on Microsoft Azure.Register now: https://nvda.ws/3ZrVKMM",2023-01-11T00:00:00,[],https://scontent.fcai19-7.fna.fbcdn.net/v/t39.30808-6/325339826_844242033310084_377914012695419716_n.jpg?stp=dst-jpg_p526x296&_nc_cat=100&ccb=1-7&_nc_sid=9267fe&_nc_ohc=5Rt0ASog6PIAX_2ol-Z&_nc_ht=scontent.fcai19-7.fna&oh=00_AfAopp9dkOk8a_d4cbr46EV8d2Zo_BN2T-EQFq4GNWSsBA&oe=64E3E43C,https://www.facebook.com/NVIDIAAI/photos/a.119492422050369/1114307965902138/?__cft__[0]=AZV1D1hAmt8bZOm15dcmC_ItoFUdubyoXHnb0YBCLeMN3i0OSjLc1bpygcj_xjpQedQPVjszP798jZzGbnbpGyIooQDeWWiMbhRuCII7pkJsOivBRIibMc1ITfeT5APReSvobllNTyLWh-8DnWho_phjOgNdWEW5_IAyQ-82sQcxNV9b5KgXXzlaf4l_ZUHjjGZAEyiRT7v_FM_nbOYu2QIz&__tn__=%2CO%2CP-R,11,0,positive,11
1114004472599154,NVIDIA AI,0,8,1,0,2,0,0,0,11,1,Data teams of today are responsible for architecting some of the most critical business decisions organizations make. Join us to explore how NVIDIA powers data driven decisions with RAPIDS. Register now: https://nvda.ws/3WJLsWA,2023-01-11T00:00:00,[],https://scontent.fcai19-7.fna.fbcdn.net/v/t39.30808-6/322479664_1372951213537853_9154952026941928853_n.jpg?stp=dst-jpg_p180x540&_nc_cat=102&ccb=1-7&_nc_sid=9267fe&_nc_ohc=m9Y7KzDCFTkAX-HeITK&_nc_ht=scontent.fcai19-7.fna&oh=00_AfDGzpDFacjEh0xMmr67MPqw3ROtWiXjEBgGe2impfB8sA&oe=64E344DE,https://www.facebook.com/NVIDIAAI/photos/a.119492422050369/1114004472599154/?__cft__[0]=AZXCtgAvChaLtrnq-7UA0wKuudcIq5H0cC6EelPepMDPNQj3u5P3R9brQuS6GTf5bTtYK9wjo1RRK7_RqZCXWAiUFmv6RxuZQurRHKtWKgHKnQQ33uhgBMwI1a7hFtATc0KiA3QQShHwjfXZaXHF_jKmSVJ6VAd-Fo4Me5Z3wjYyvr4XuQF1f-u8mrN0xZRolZs1w0JqTQUpSD8Xyso36gmn&__tn__=%2CO%2CP-R,11,0,positive,11
1113819832617618,NVIDIA AI,0,12,0,0,1,0,0,0,13,1,Attend our speaking session at #NRF2023 with Kroger and Lenovo Data Center—1/17 at 11:30 a.m. ET— to hear how Kroger is optimizing store layouts and the checkout process using #simulation and #digitaltwins. https://nvda.ws/3VxjMm5,2023-01-11T00:00:00,[],https://scontent.fcai19-7.fna.fbcdn.net/v/t39.30808-6/322241341_3093016570997348_7573943353664643693_n.jpg?stp=dst-jpg_p526x296&_nc_cat=110&ccb=1-7&_nc_sid=9267fe&_nc_ohc=opj1xR5sr50AX-b2Yyn&_nc_ht=scontent.fcai19-7.fna&oh=00_AfDdFO4BvCubfCCWsWQMNapBRouYFGwlbpDHh605qFfwkg&oe=64E32AA5,https://www.facebook.com/NVIDIAAI/photos/a.119492422050369/1113819832617618/?__cft__[0]=AZWGsRSbDxw7npSAoGbupuR9m_SifW2V9Ij9X0j4Z163-t_RaLZF6tqcJoJJ9xjZrljCwovBsPFLucX9mdeVOeyph2giH2DGKwHCZ7ypuzVmPlt-c9t_iw7A4OAyW9UK3ACJfmyHfyMDnG8br2zHySs6t5MBQiL_DoSMAFZabOSiFUbo-v1Kh1QGBufkonVCs_zJC9zUCuKBdXa_RzolFZ3f&__tn__=%2CO%2CP-R,13,0,positive,13
pfbid0xhy3cDKKdzja7pS7MdGFb5Q6oPFUEWPYQfVj3q6bP9YYGwL9mXVjFUHHTVntgDWel,NVIDIA AI,0,11,0,0,1,0,0,0,12,1,Announcing early access of NVIDIA’s new Live Portrait Microservice. Watch how Live Portrait and #NVIDIAOmniverse Avatar Cloud Engine (ACE) bring 2D photos to life in the NVIDIA #CES2023 Special Address.,2023-01-10T00:00:00,[],https://external.fcai19-7.fna.fbcdn.net/emg1/v/t13/17674987432760409597?url=https%3A%2F%2Fi.ytimg.com%2Fvi%2FCJWZuZsD0zQ%2Fmaxresdefault.jpg&fb_obo=1&utld=ytimg.com&stp=c0.5000x0.5000f_dst-jpg_flffffff_p500x261_q75&ccb=13-1&oh=06_AbHOUlnxqqFr7ILH3mgiinfirvZz-avzYmPOchTQEE7X6g&oe=64E01712&_nc_sid=dbad39,https://www.facebook.com/NVIDIAAI/posts/pfbid0xhy3cDKKdzja7pS7MdGFb5Q6oPFUEWPYQfVj3q6bP9YYGwL9mXVjFUHHTVntgDWel?__cft__[0]=AZX3zeGClQggGoE1z6QZBTlPTzbiONn6xbluvd4fhusC7pPsmkcwx5amFV6RibswdHkIL4miy9KhN-LwPF0hUJDSyPfV1zLHlXHs1B2VmVUYBq1yNAOBwbHPaGT__mhr-A-YiBwfl-WWSP-s3o5yGTLXGQc7SCglSPR9ACSbZKKzjkIChRSXgzxOKuyk2v7S93aMRABTOoBRIw_uvBFJIdPf&__tn__=%2CO%2CP-R,12,0,positive,12
pfbid0Uc1LgdY7ZjnBifWz1pNV96nVpPtjCNWudNJoqYFMyF3yFiocBLwMNiPpCvVQ41kMl,NVIDIA AI,1,40,3,0,0,0,0,0,43,7,Our suite of #AI microservices for building digital humans -- #NVIDIAOmniverse Avatar Cloud Engine (ACE) -- is now available in early access. Developers and teams building avatars and virtual assistants can register to join. https://nvda.ws/3X2yP90,2023-01-10T00:00:00,[],https://external.fcai19-7.fna.fbcdn.net/emg1/v/t13/15401231532560550237?url=https%3A%2F%2Fdeveloper-blogs.nvidia.com%2Fwp-content%2Fuploads%2F2023%2F01%2Fomniverse-ace-early-access-featured.png&fb_obo=1&utld=nvidia.com&stp=c0.5000x0.5000f_dst-jpg_flffffff_p500x261_q75&ccb=13-1&oh=06_AbG7-jUf76KTie469D3EDgHWq7DFsQPsrrsSMA6HCWvZ1Q&oe=64E0358A&_nc_sid=dbad39,https://www.facebook.com/NVIDIAAI/posts/pfbid0Uc1LgdY7ZjnBifWz1pNV96nVpPtjCNWudNJoqYFMyF3yFiocBLwMNiPpCvVQ41kMl?__cft__[0]=AZUbmiDI2Txj68BfxD_xijbDfMnz9L3Ohgt5FuKVC_aimkWA6Df2r0Hal_xsyMCLKYAHb3EqshwZcXcic513nh33DsQtT0vD5Zktu0VFuo49R00WBRPKXgALms3UtHMAxO7grcOztGqSyb3G_oduiQlsRRj1aMGHhPJy6i92lqG2ddMqN_svADaDUACZkXN9kHu0MLfpyEqf_w5rQZhfJKGJnWRpcXvF0z4VIJjw6BJinA&__tn__=%2CO%2CP-R,44,0,positive,44
pfbid02MMYdyuGY4uTKMxzqiKyrdZ9CBbWBJJhgwFGw2zC575M1he9wk7PmS6o7DwXAjZg9l,NVIDIA AI,0,11,0,1,2,0,0,0,14,0,Find out how Aetina and Innodisk developed and deployed an #AI solution to perform accurate inspections in less than one second -- increasing inspection efficiency tenfold. https://nvda.ws/3QpW4Yi,2023-01-10T00:00:00,[],https://external.fcai19-7.fna.fbcdn.net/emg1/v/t13/7638245404506283491?url=https%3A%2F%2Fdeveloper-blogs.nvidia.com%2Fwp-content%2Fuploads%2F2022%2F12%2FSmart-Spaces-Innodisk-e1670615136277.jpg&fb_obo=1&utld=nvidia.com&stp=c0.5000x0.5000f_dst-jpg_flffffff_p500x261_q75&ccb=13-1&oh=06_AbFrjhAxtRu8wwuNrn1BUpFKYLlS-AJt1ysSqusQjIwGEQ&oe=64E04770&_nc_sid=dbad39,https://www.facebook.com/NVIDIAAI/posts/pfbid02MMYdyuGY4uTKMxzqiKyrdZ9CBbWBJJhgwFGw2zC575M1he9wk7PmS6o7DwXAjZg9l?__cft__[0]=AZW38fn0YdyhS2un5P0-SXy7EVG3Fv7JWH6hdvQNF-xBZljyh_YYzNbCALV0tnsaO1EXfMTPJW_osVJZBPlyMM3B_6J1t9PTYd84Ecqi3QM4AdFV7PG4pMC2tvvziDdYe-dEPXmBJ9WOQ1Rq3TmdJOeSvVN67EVFGVKHSXI8cprTjgjCkIz12J2rVxUT50jdkQhTlQD8Mvq2x44zsLbTnBC2LM4eGchj8GhSxcylqMW9BQ&__tn__=%2CO%2CP-R,14,0,positive,14
pfbid03eY2zUHCxKfYFSHC8gHCjPmNwSChMMJ6L24Q87tcr7wZVLsrd4NYp3yJrL8gaAhil,NVIDIA AI,0,10,0,0,1,0,0,0,11,0,"How can you raise your customer service experience in contact centers to a new level? By generating an accurate transcript of customer interactions in real time, enabling #AI to provide contextual insights, measure sentiment, and recommend the next-best action to the agent. Watch our demo to learn more! https://nvda.ws/3GLdpaM #transcription",2023-01-09T00:00:00,[],https://external.fcai19-7.fna.fbcdn.net/emg1/v/t13/3359351112898201407?url=https%3A%2F%2Fi.ytimg.com%2Fvi%2FamwfHzXaTps%2Fmaxresdefault.jpg&fb_obo=1&utld=ytimg.com&stp=c0.5000x0.5000f_dst-jpg_flffffff_p500x261_q75&ccb=13-1&oh=06_AbHzBT8cD4Lb3lRI491E_MCYePrZVbcaTYARcomWwyJquw&oe=64E0617C&_nc_sid=dbad39,https://www.facebook.com/NVIDIAAI/posts/pfbid03eY2zUHCxKfYFSHC8gHCjPmNwSChMMJ6L24Q87tcr7wZVLsrd4NYp3yJrL8gaAhil?__cft__[0]=AZVwrRHDR1wmmV9zGuUTlVv6tiOxVTTEH1jjRd8cp6-P2aIYzw3cpVU91eKiE9c4jurcBtNzqL4TpYVRqz1ye9nm8fduA_u6ymWd_OwJG53sazQdHhX9DpmvHwHZA6v20fx8gJ0dCatXBUYGRuSfllz74Cpi7yrhaQNOeD50E8-uJb_HIyKPypGGSzGx_9zwUiAdQgMIDSG9i2jJijDlMTFp&__tn__=%2CO%2CP-R,11,0,positive,11
1113149059351362,NVIDIA AI,0,10,0,0,1,0,0,0,11,0,Attend our speaking session at #NRF2023 with Lowe's Home Improvement and Dell Technologies—1/15 at 2:00 p.m. ET—to hear how Lowe's is shaping the future of retail with #digitaltwins to optimize operations and localize plans to better serve customer needs. https://nvda.ws/3YSQ91B,2023-01-09T00:00:00,[],https://scontent.fcai19-7.fna.fbcdn.net/v/t39.30808-6/324785043_1271396663407020_8568556464056638329_n.jpg?stp=dst-jpg_p526x296&_nc_cat=104&ccb=1-7&_nc_sid=9267fe&_nc_ohc=dxsN_N-skxEAX90iSa4&_nc_ht=scontent.fcai19-7.fna&oh=00_AfBQabea3wbi6_rFT2znSZvhss_MXDmzTKWd3RFOeNQjpA&oe=64E34F63,https://www.facebook.com/NVIDIAAI/photos/a.119492422050369/1113149059351362/?__cft__[0]=AZWiftlEUVrwleNMamn-AunQm9IMKSbl3vpQ7lFMjqy3YjaYfrf164koq9qggPXIDKyaPc_qQgIldshP8UZ_Q3_D1ZZLPvFW6agXf2Eyn0mHESmgIj1iKPUM4ki7QEol8LA4Y6DV0ZWU3_4_s7DN1wjB2HTRkR9d7LA77OsVJVtAtPBAcbf98CjEa-roQI9L2zum7HWoNK_uq53aQjqdMg4p&__tn__=%2CO%2CP-R,11,0,positive,11
pfbid02zXTovmVT1pERusa2X2syrLUmJnhxQaYZfUKTeo1pLgQP5a2vSCSGUZxFrGVFLjVel,NVIDIA AI,0,14,0,0,2,0,0,0,16,0,Technical Explainer: What is Active Learning?Finding the right self-driving training data doesn't have to take a swarm of human labelers. Learn More: https://nvda.ws/3IvCNCQ,2023-01-06T00:00:00,[],https://external.fcai19-7.fna.fbcdn.net/emg1/v/t13/16404204562833435821?url=https%3A%2F%2Fblogs.nvidia.com%2Fwp-content%2Fuploads%2F2020%2F01%2FActiveLearning.jpg&fb_obo=1&utld=nvidia.com&stp=c0.5000x0.5000f_dst-jpg_flffffff_p500x261_q75&ccb=13-1&oh=06_AbH7IMLjNP7dGUcZTlkPBpt7lSdSIf7fOgFEY97IcqEwGA&oe=64E0B648&_nc_sid=dbad39,https://www.facebook.com/NVIDIAAI/posts/pfbid02zXTovmVT1pERusa2X2syrLUmJnhxQaYZfUKTeo1pLgQP5a2vSCSGUZxFrGVFLjVel?__cft__[0]=AZWLGkjZ0MimfeoWbSjaezlj_zoofiJGH0mghX0oJRUWpLn8kOepT1ZAOlZzRYfsZpGJ2zATx_Mec8wUM2vbmU7XzmwMcXtAmaqaYZm9pCN7pwjuZX9Tt3PDyZVA7mxVgkYSAVDEDHJ0eBkmcywbawPDV8W-VEOBJSOZV3xzxEwtiW6WfRs7HwlZF7qWDHrCGaMXy7_LpnzTrOXUF9D3SgYG&__tn__=%2CO%2CP-R,16,0,positive,16
1111438246189110,NVIDIA AI,0,14,0,0,1,0,0,0,15,0,"On March 21, join the one-day conference for the era of #AI, #HPC, 3D simulation, and the industrial #metaverse. Learn, network, and collaborate with the brightest minds across energy, healthcare and life sciences, and IT in Houston, Texas. Register for free: https://nvda.ws/3VPAkpV",2023-01-06T00:00:00,[],https://scontent.fcai19-7.fna.fbcdn.net/v/t39.30808-6/323641125_711207290678472_8492120523682692675_n.png?_nc_cat=111&ccb=1-7&_nc_sid=9267fe&_nc_ohc=RzKH33GdWF4AX-Vvqcb&_nc_ht=scontent.fcai19-7.fna&oh=00_AfC3zpFPeogi1im7zEms2CS2QWzdUvciw8P4DVpfUJcifQ&oe=64E49903,https://www.facebook.com/NVIDIAAI/photos/a.119492422050369/1111438246189110/?__cft__[0]=AZWwB8RC6rLEhmrCR9iVkS6fcgJYSsRK0vkk24MXhg1ctxAAS5dcS_Cue_Wkbm5pPZCI6RTdtPtUeS40__Jb6L4WYSUK9GYmlPtNnslnEQs8CWDBG2wrMK5jZXy-mRu4RNqVWxKWnfIJvAFc-ITpdHrULO5AUC3uAYuqa7OLFqTq7uvpnzWxnzD2NISZBqGM13eqg81Rra-JHny2xgQzsLxx&__tn__=%2CO%2CP-R,15,0,positive,15
1111414919524776,NVIDIA AI,0,15,0,0,2,0,0,0,17,0,"At #NRF2023, discover how #AI is helping #retailers improve forecast accuracy, optimize store layout, accelerate throughput in distribution centers and track routing optimization for last-mile delivery. Learn more about our Big Ideas sessions and partner booths here: https://nvda.ws/3GnqhT7",2023-01-06T00:00:00,[],https://scontent.fcai19-7.fna.fbcdn.net/v/t39.30808-6/324665934_713185733551353_223781053761920290_n.jpg?stp=dst-jpg_p526x296&_nc_cat=109&ccb=1-7&_nc_sid=9267fe&_nc_ohc=w_q-DKub81MAX-_tod3&_nc_ht=scontent.fcai19-7.fna&oh=00_AfAV_Tkg6Nly2PNyV0KsJ5MwkPpG_pc4P-qDdXtPfVVR-Q&oe=64E36EF2,https://www.facebook.com/NVIDIAAI/photos/a.119492422050369/1111414919524776/?__cft__[0]=AZXFynog6WkUWEnUStMmx9TlUoeBWhrjwzXKP4EDkFDT2z2kLij9J7Iyy4F1wmgC6JREfCHeFt5MkFXP54cXMHMhCUtPVIcancuLIZ0sAKDyBzrsG2Nn_gaD9DhO103wy8TpS2JvHLXcUqrTsbJrh0Bd2cYY1_lDUK39QTdUztsD901d_gow069W8rmLosJZ6K6uECA5qiTZktpkAmsAQdDG&__tn__=%2CO%2CP-R,17,0,positive,17
pfbid02kABy8Qs3Z4MM26SQKjBURZCP4e5R2HzMyG2sXJEywn1eMAMk6rnLCCEYj43AMH7dl,NVIDIA AI,0,44,0,0,0,0,0,0,44,12,"NVIDIA Maxine’s latest Video Effects Microservice includes Eye Contact. Using #AI, the Eye Contact feature aligns gaze with the camera and helps maintain engagement in conversation. Watch the feature demo here.#CES2023",2023-01-06T00:00:00,[],https://external.fcai19-7.fna.fbcdn.net/emg1/v/t13/12585320878281673076?url=https%3A%2F%2Fi.ytimg.com%2Fvi%2FO50BkP16eZo%2Fmaxresdefault.jpg&fb_obo=1&utld=ytimg.com&stp=c0.5000x0.5000f_dst-jpg_flffffff_p500x261_q75&ccb=13-1&oh=06_AbGto95Q2iWG9c2z5IzPVpSddP9l5ziD3j908LCA_UB4tQ&oe=64E02958&_nc_sid=dbad39,https://www.facebook.com/NVIDIAAI/posts/pfbid02kABy8Qs3Z4MM26SQKjBURZCP4e5R2HzMyG2sXJEywn1eMAMk6rnLCCEYj43AMH7dl?__cft__[0]=AZVSLz8B_mCIANYe_GRz17YCs8tfPYK9sf-_SS_PgVT3Wnq4LjVG_iVItuaFiDvV3DXea2M03_UwYMCjJGciwMhoru-V6X3OydVe7X19H6wsit-oM33V_kSs-b_Zsl-N6QjojnFloVLeS-UMzCddkmXcaBIFZ6vLBzQ2Q-UauKNA1wmbbAEvS_Gc4UwuQALXNypBDvKQErtE2Kygzex7eR_S&__tn__=%2CO%2CP-R,44,0,positive,44
1110920419574226,NVIDIA AI,0,16,2,0,2,0,0,0,20,6,"Join Jensen Huang and Michael Dell for a fireside chat at the Dell PowerEdge .Next event as they discuss AI breakthroughs that will help organizations realize smarter, faster outcomes. Register now: https://nvda.ws/3X4lMUR",2023-01-05T00:00:00,[],https://scontent.fcai19-7.fna.fbcdn.net/v/t39.30808-6/324471092_1150212422312851_8533059272544414557_n.jpg?stp=dst-jpg_p526x296&_nc_cat=111&ccb=1-7&_nc_sid=9267fe&_nc_ohc=4V7MiM3fOIQAX-tl9xu&_nc_ht=scontent.fcai19-7.fna&oh=00_AfAfjQPK72iacQ-Rm_aEmgL_Urfp9dM5qFveQ1RPXV3Hdw&oe=64E31E44,https://www.facebook.com/NVIDIAAI/photos/a.119492422050369/1110920419574226/?__cft__[0]=AZV_oej0B8M-Sv3inBVrBhaRXKH6vXW8-wxhuNL0BeIOOX3Tx2aNA5dquSM5gCursCe2ddgwHGLPk2a7vJrSsltBGQoO6gsE9fUixWIivsoma_rtxeaE0DczKa7YC0lYZhq8nx1OUBJ6j4s6NmXddXovqKwsPdugUI31Bz_BAUxowxwcW2yrXJ2UzyTVgu7kPnCF-W4Pb_gWWFjUWt0OIEi_&__tn__=%2CO%2CP-R,20,0,positive,20
pfbid06iL4mBMCVvemitCfSnRf3RXKwMJVdBnucE33UZocpBLcSj1e3vuJSRo1vt8iPCGWl,NVIDIA AI,0,15,1,0,1,0,0,0,17,0,"NVIDIA Maxine enables users to experience the communications of the future through accelerated #AI features for audio, video, and augmented reality. https://nvda.ws/3CnotZ6Read more about Maxine capabilities and key features announced at #CES2023.",2023-01-05T00:00:00,[],https://external.fcai19-7.fna.fbcdn.net/emg1/v/t13/6665803506583253242?url=https%3A%2F%2Fdeveloper-blogs.nvidia.com%2Fwp-content%2Fuploads%2F2023%2F01%2Fmaxine-ces-featured.png&fb_obo=1&utld=nvidia.com&stp=c0.5000x0.5000f_dst-jpg_flffffff_p500x261_q75&ccb=13-1&oh=06_AbEggSG6u-aWymmbAFpvfHUgAVlP4i93_MgKxQRTvWmNTw&oe=64E09447&_nc_sid=dbad39,https://www.facebook.com/NVIDIAAI/posts/pfbid06iL4mBMCVvemitCfSnRf3RXKwMJVdBnucE33UZocpBLcSj1e3vuJSRo1vt8iPCGWl?__cft__[0]=AZW-OPdS_ChpGFtcgSXWRR3wRVYP480-tpvvdZ8v3qfp7adBcBaSyLMSvrsdPvpl2ZV-qAs27_wnMNnC_PWbjIqF_3e3clo-gRh9bT-O4aQMYvRyJ914Fxs4D2ls33BihM2oWSDTv9Dz1e-AoC6crZfCGx8_u7aZ-2k02KwjMbLeBLaeSmpUPTW3kBEGndtHH0A_1FZECiezKMcg3Df8Xxiz&__tn__=%2CO%2CP-R,17,0,positive,17
pfbid0yjACXJ2Gf3H5ezYqAcrjVLAGKnhsvbCjqtnb9y3eYa46rASjG7vewZv7eCaahnSal,NVIDIA AI,0,17,0,0,1,0,0,0,18,4,This step-by-step guide teaches you how to deploy diverse #AI model categories using NVIDIA Triton Inference Server.Learn more here: https://nvda.ws/3X02kb3,2023-01-05T00:00:00,[],https://external.fcai19-7.fna.fbcdn.net/emg1/v/t13/3049127066565491697?url=https%3A%2F%2Fdeveloper-blogs.nvidia.com%2Fwp-content%2Fuploads%2F2022%2F12%2Fimage2-5.png&fb_obo=1&utld=nvidia.com&stp=c0.5000x0.5000f_dst-jpg_flffffff_p500x261_q75&ccb=13-1&oh=06_AbH7C8-vZ6FyNhtGJ3UHIW322sgDKh5sZLYsgwyg8rMAow&oe=64E0AE71&_nc_sid=dbad39,https://www.facebook.com/NVIDIAAI/posts/pfbid0yjACXJ2Gf3H5ezYqAcrjVLAGKnhsvbCjqtnb9y3eYa46rASjG7vewZv7eCaahnSal?__cft__[0]=AZW9vt4xW2FIbr4epHwP01LFPs5w_y0uC6vATsa-mWnWffbrvf7DYOethX4RX1Jrj25AJ-ZtBGku3x9CXVd5BY1jhtWW1Pk6AeZEUaEf9I7PFRYaKm-fDC4hFYA7tjWMp0JQg7lWDVnpA8HuOi43Na1FwZwTZM0mzOfveMt9y-gSiBumwvfquAHWU4VriKsZyR5M-rFeaAz82gl08tin_PBY&__tn__=%2CO%2CP-R,18,0,positive,18
pfbid0K3YgBgkLEKezUeAkWcupotsdYbiprM6TRNpi5HP4PaWRM3ZF3rayefmDpP4mqfn5l,NVIDIA AI,0,10,0,0,1,0,0,0,11,4,Watch how a ReadyPlayerMe 3D avatar is brought to life with the help of #NVIDIAOmniverse ACE animation #AI using only voice input.Early access is now available for developers. #CES2023,2023-01-05T00:00:00,[],https://external.fcai19-7.fna.fbcdn.net/emg1/v/t13/6129198929716727698?url=https%3A%2F%2Fi.ytimg.com%2Fvi%2Fa05X3rAfYLs%2Fmaxresdefault.jpg&fb_obo=1&utld=ytimg.com&stp=c0.5000x0.5000f_dst-jpg_flffffff_p500x261_q75&ccb=13-1&oh=06_AbGBqt5eGHzDIBKu7yN-EXGjIplfqGMmnnx2Cm5_LP872w&oe=64E03016&_nc_sid=dbad39,https://www.facebook.com/NVIDIAAI/posts/pfbid0K3YgBgkLEKezUeAkWcupotsdYbiprM6TRNpi5HP4PaWRM3ZF3rayefmDpP4mqfn5l?__cft__[0]=AZUnEoo-2jI1DmZz5zSScB6-SXG7OuHUpj5PJ1fZJMtL2cfzB4T1B7sMeIs3s_cEHYN3m-LlkRFAaJigdA9awIAtSEh7SepEPujPxynxpgQRu6d7E1PaYUYuA2mnR7RCQAmN5Fi5lros1NLLYEO106vmAV4otVvkZQC8MgSkia-QfBDWtIN0P75kYD01adh4Zt2vdEAPCxjKL7zfYbTNo4HU&__tn__=%2CO%2CP-R,11,0,positive,11
1110828199583448,NVIDIA AI,0,8,0,0,1,0,0,0,9,1,"Updated! Check out the NEW resources for higher education and research! Get access to free training videos, test NVIDIA solutions for free with Launchpad, access exclusive blogs and more: https://nvda.ws/3Z4YeAB",2023-01-05T00:00:00,[],https://scontent.fcai19-7.fna.fbcdn.net/v/t39.30808-6/324258024_1615564135560320_3516926845692852149_n.jpg?stp=dst-jpg_p180x540&_nc_cat=101&ccb=1-7&_nc_sid=9267fe&_nc_ohc=DdEZ9OGLWlYAX8x6yjr&_nc_ht=scontent.fcai19-7.fna&oh=00_AfAAlBAgThzkCLxaMe1OIchmfwucgdyc3V99beib0PvSNg&oe=64E434EA,https://www.facebook.com/NVIDIAAI/photos/a.119492422050369/1110828199583448/?__cft__[0]=AZV4kovTNQXDHYLJkGtrUTt50FvZFr-fAxmpMxf-OFq0GizntjgqqJiCb2bVj9tHXuvRaLnD46gMnjCs_mhLiHDi6FAwd9TWnMey9jjEMw0Gn_kEhRWlPc45lFzXo0ALWV8nO_452OAYxNfviJfBZCzEISyXdvCdTfBqZKzyrHM8geC4qpJwsig1w4rsaQqWmbSXLiAYUtTQCPPcz_33SLu-&__tn__=%2CO%2CP-R,9,0,positive,9
1110554486277486,NVIDIA AI,0,7,0,0,1,0,0,0,8,3,"Seeking to increase efficiency, streamline development, and achieve more cost-effective data operations for better business strategies? Join us on Jan 18 to learn how NVIDIA free RAPIDS platform for accelerated modern data science can help you get there. Register now: https://nvda.ws/3Io6RQv",2023-01-05T00:00:00,[],https://scontent.fcai19-7.fna.fbcdn.net/v/t39.30808-6/323637428_719810932788561_9082416653247543696_n.jpg?stp=dst-jpg_p180x540&_nc_cat=108&ccb=1-7&_nc_sid=9267fe&_nc_ohc=uV4jW7Qou-MAX-QoCsv&_nc_ht=scontent.fcai19-7.fna&oh=00_AfA1hZqfDz2PItqxOCzZZ0qeztmp6AhL4SGiPXq-2-hQGA&oe=64E42A96,https://www.facebook.com/NVIDIAAI/photos/a.119492422050369/1110554486277486/?__cft__[0]=AZU0aelXH5E2inVh-j6B0VSCCHOhld-R0Hexk1xX98N49ojb2xOHeNnLdWHcVwq3GNMyClSBFj9ns0pghHaU04y5aGDFYtQXZsbJOmRUqdJJfbF1p0EfDv86WZYL4GjS2sNQqZb800qLk69ozAAyDErw-WAnov8Z5Rkqyq4t6zuZhUSujYh5hg583anEenWS8-VLfRYpK-s0O6QYKe371ryT&__tn__=%2CO%2CP-R,8,0,positive,8
1110418609624407,NVIDIA AI,0,15,0,0,1,0,0,0,16,3,"To improve the safety, security, and operational efficiency of grid assets, such as substations, #utilities are leveraging #AI-enhanced intelligent video analytics. Learn more from Convergint, Dell, IronYun, and NVIDIA in a webinar on January 17 at 8 AM PT: https://nvda.ws/3GHectv",2023-01-05T00:00:00,[],https://scontent.fcai19-7.fna.fbcdn.net/v/t39.30808-6/320575503_896835964681066_7821463538607320510_n.jpg?stp=dst-jpg_p526x296&_nc_cat=102&ccb=1-7&_nc_sid=9267fe&_nc_ohc=cTzI4ocvRjkAX-Vqj6u&_nc_ht=scontent.fcai19-7.fna&oh=00_AfAgXlsLotuf3-5CLmekXnYYdMM8saH_yzMHsRpd6hAgZQ&oe=64E47CD0,https://www.facebook.com/NVIDIAAI/photos/a.119492422050369/1110418609624407/?__cft__[0]=AZWeIKUYk56wn_HWGNWs9cq7VCV9J6A5nO0ltvSQU7NpD0vQHE1nWO9n1ccRQrJ0ej7dKJzH-uEZvW9VYqpWvnJeDgB6IdjcxyDKwgjWKwxMMWGEVYa8OqiQfIJ9nbBUamZoc44xcnBqnj48T1zNVsz2bxQxCv81JlbF-UIQZAEthzURvCZ90n-dPX-4_6ceIh1Y0fj03CvSgFnBZ-wIOstn&__tn__=%2CO%2CP-R,16,0,positive,16
pfbid0M3JuxWmSJbzPC5itzrLzxaa1jKDkkxbWFD2dZwhhnYHC8hszqRCcStkoxsrFFVRZl,NVIDIA AI,0,6,0,0,1,0,0,0,7,0,"Retail Banker International details financial services forecasts from over 100 experts at leading banks, consultants, fintechs, technology providers and more for 2023.Explore the predictions: https://nvda.ws/3GBG1U0",2023-01-05T00:00:00,[],https://external.fcai19-7.fna.fbcdn.net/emg1/v/t13/13262043084314446337?url=https%3A%2F%2Fwww.retailbankerinternational.com%2Fwp-content%2Fuploads%2Fsites%2F2%2F2022%2F12%2Fimage-18-2023-1.png&fb_obo=1&utld=retailbankerinternational.com&stp=c0.5000x0.5000f_dst-jpg_flffffff_p500x261_q75&ccb=13-1&oh=06_AbENnbjnNqvITAX4L--saF22D3NJHxjuSV5qGpIIGc5iHA&oe=64E06193&_nc_sid=dbad39,https://www.facebook.com/NVIDIAAI/posts/pfbid0M3JuxWmSJbzPC5itzrLzxaa1jKDkkxbWFD2dZwhhnYHC8hszqRCcStkoxsrFFVRZl?__cft__[0]=AZUAy5FyfnmMVNcggp5xdkJxnFTrHbti8zn9tihFxvji-UTMe3G155AD5oPsgFaaUW-He6PYVdAc5Kh8c11DIGMgNjnl_dxMnCS3Gi88KEe3Z32xpBcTZz9dbCo2KIteg2livh0Ez9f6xoXH7txxSXIxRWTnisW9iBThmz6BMe8bKRkR8kntumRjU3kQddFA8-jmX56O3KVZeuD-mfrpvbJj&__tn__=%2CO%2CP-R,7,0,positive,7
pfbid02yJ9cPfHidPiR6wbTYsuTHxoun1bDcjxm9cLEAeuYyMDFaHReBZLLwc1rKEkgw2rsl,NVIDIA AI,1,9,0,0,1,0,0,0,10,1,"Did you read our top 10 most popular posts from 2022?Learn about the advancements in HPC and AI workload power, research breakthroughs, new capabilities in 3D graphics, gaming, simulation, robotics, and more. https://nvda.ws/3vEN0VI",2023-01-04T00:00:00,[],https://external.fcai19-7.fna.fbcdn.net/emg1/v/t13/1752665988357306368?url=https%3A%2F%2Fdeveloper-blogs.nvidia.com%2Fwp-content%2Fuploads%2F2022%2F01%2FDevBlog-weekly-roundup-featured.png&fb_obo=1&utld=nvidia.com&stp=c0.5000x0.5000f_dst-jpg_flffffff_p500x261_q75&ccb=13-1&oh=06_AbHYDd0a0bp64g3Xs3AusnvofR2V1P5fsb_DKeMypgvm8w&oe=64E07831&_nc_sid=dbad39,https://www.facebook.com/NVIDIAAI/posts/pfbid02yJ9cPfHidPiR6wbTYsuTHxoun1bDcjxm9cLEAeuYyMDFaHReBZLLwc1rKEkgw2rsl?__cft__[0]=AZWeKVWoDRZZZqof6z_NS8t_XWg1L5kffPEoq6ZtKlTJ2gv7d7NzFcVkFxg4phrdP6yE8trbPq2883HqBD4xw5Tu_yzImH2QUt_9VUzhTq6gU7fNI0AqjHG3-pDisR3mYPaB4--v3bt_7-WBYEkyrkQaz0GsJK_DIxTu91AMl2R_z9hEvRhyBM__tgYMyZ9DKjeSg9FMIWdREftJKhz-2sAt&__tn__=%2CO%2CP-R,11,0,positive,11
1110269046306030,NVIDIA AI,0,12,0,0,0,0,0,0,12,4,"Hear Joe Glover speak about The University of Florida's efforts to put #AI to work across all aspects of higher ed, including a public-private partnership with NVIDIA that has helped transform the University into one of the leading AI universities in the country. https://nvda.ws/3ZdfAek",2023-01-04T00:00:00,[],https://scontent.fcai19-7.fna.fbcdn.net/v/t39.30808-6/323444048_474194128215864_3193098321820376498_n.jpg?stp=cp6_dst-jpg_p180x540&_nc_cat=110&ccb=1-7&_nc_sid=9267fe&_nc_ohc=lLisY38qdjgAX9lMkvS&_nc_ht=scontent.fcai19-7.fna&oh=00_AfDAII1zuRdmL-I_N7HgmjkKz6rY2d9KBokfCt3IvQgATA&oe=64E49956,https://www.facebook.com/NVIDIAAI/photos/a.119492422050369/1110269046306030/?__cft__[0]=AZWrMjxZ4H-pURSqOjpWfM2G4n6pBnZX_6kxH5xgmGkQyJRGtWc8PVvkDYuFZy7X-AG0zT7qJsA3tViB3q-n-k-kwcjbXE_TSwr8dUEq4FfPFSANxQd4CVOPjw4k7SkA41cbryN8aJGXeEUhnbsbPrPNm_PN7_EwK6X27EU9NxQMgGZRaAXePTVxMJa5C6BrFZpqKwHPS4pr6PH2W4mppid3&__tn__=%2CO%2CP-R,12,0,positive,12
1110151659651102,NVIDIA AI,0,11,0,0,1,0,0,0,12,1,#NRF2023 is retail’s most important event. Connect with us on the show floor and attend our Big Ideas speaking sessions to hear how Lowe's and Kroger are using #simulation and #AI. Discover all activities here: https://nvda.ws/3PTv3fB,2023-01-04T00:00:00,[],https://scontent.fcai19-7.fna.fbcdn.net/v/t39.30808-6/322878447_2241648636017259_7273207419622171966_n.jpg?stp=dst-jpg_p526x296&_nc_cat=105&ccb=1-7&_nc_sid=9267fe&_nc_ohc=JjPiHFeGK2IAX957gwY&_nc_ht=scontent.fcai19-7.fna&oh=00_AfDdGnCOX0-GkSQ9KPY1cQWkGMZrnkhQM30TZJ8lCVSBjw&oe=64E2EC33,https://www.facebook.com/NVIDIAAI/photos/a.119492422050369/1110151659651102/?__cft__[0]=AZWoGFhpNTPHxBuwJdEQi560_-vqNQRtqSv3FINqiBFOTNB3X67XuioBHFWt6zGzW1hbooSsWoyhI2psgWbXGnKvssasOQxTwoT0UiCgHAV549Ng5FOGbRdDV1pWfdK_ZxNaC3P4KnJgWxlD8RZsf2JI0MFoVMpmlcnaywpEenItB6xo8c3BfLaQtxdM86GqvtYEo32HsxJJR67jIXm5nYIx&__tn__=%2CO%2CP-R,12,0,positive,12
pfbid0nrXYe7RaevnYDqj8npN7CX1fdAGmuaZJKtkbkr3h5bEvgU67L6SvfyjZ9HBTRhKl,NVIDIA AI,0,7,0,0,1,0,0,0,8,0,"New year, new career? Get tips and insights from #AI trailblazers on how to make your mark in this rapidly evolving field. https://nvda.ws/3ibkh80",2023-01-03T00:00:00,[],https://external.fcai19-7.fna.fbcdn.net/emg1/v/t13/14824353259406397210?url=https%3A%2F%2Fblogs.nvidia.com%2Fwp-content%2Fuploads%2F2022%2F01%2F5PathsImage-672x315.png&fb_obo=1&utld=nvidia.com&stp=c0.5000x0.5000f_dst-jpg_flffffff_p500x261_q75&ccb=13-1&oh=06_AbHrKFP4OnSd_4_1R_VqV9jHBZwC7X12tS9JOrrPgGdWlg&oe=64E0171F&_nc_sid=dbad39,https://www.facebook.com/NVIDIAAI/posts/pfbid0nrXYe7RaevnYDqj8npN7CX1fdAGmuaZJKtkbkr3h5bEvgU67L6SvfyjZ9HBTRhKl?__cft__[0]=AZXtMcEg2bUejm5Cb5USw7Zu4FsF0JIKfqAKTMRn9MsPl58E9eR8GhNfl2hb_xwG--aZIomErSPoBBkdIMgGa9QHNB9XGzPpk5J6X4wkuMQ20jLlxGlbq04F2x4MWnHbjauHBHC76fauF13WFfF7lljpwp6Wc4-5c0mh5L15Nc2Lj0Yvls3pjBSJD9OiC6e3XSzYv9pI5Cet1lIxv5EqEKdw&__tn__=%2CO%2CP-R,8,0,positive,8
pfbid02bipWDVY3NMfZcAPGzh17X7HxEdjjyDYQXVS8tiNSSCDdAdJRvKy3FsFwdJASxdHyl,NVIDIA AI,0,39,0,0,0,0,0,0,39,0,"Announcing early access of #NVIDIAOmniverse Avatar Cloud Engine (ACE) for developers. Apply now to contribute to the future of interactive #avatars for gaming, the #metaverse and beyond. #CES2023",2023-01-03T00:00:00,[],https://external.fcai19-7.fna.fbcdn.net/emg1/v/t13/17260454298590430595?url=https%3A%2F%2Fblogs.nvidia.com%2Fwp-content%2Fuploads%2F2023%2F01%2FCreating-Faces-of-the-Future_-Build-AI-Avatars-With-NVIDIA-Omniverse-Avatar-Cloud-Engine.jpg&fb_obo=1&utld=nvidia.com&stp=c0.5000x0.5000f_dst-jpg_flffffff_p500x261_q75&ccb=13-1&oh=06_AbHjMHQry2pdockl-au91KJ5yI_MP1I_D4LxnFO3Hpg4JQ&oe=64E0373C&_nc_sid=dbad39 https://static.xx.fbcdn.net/rsrc.php/v3/y9/r/Z-dbClQDXLv.png,https://www.facebook.com/NVIDIAAI/posts/pfbid02bipWDVY3NMfZcAPGzh17X7HxEdjjyDYQXVS8tiNSSCDdAdJRvKy3FsFwdJASxdHyl?__cft__[0]=AZVqZASNpC-8fGAKLmoqUv86g-Md0f8QEWp_f9I3alFXH3mehuB-7AkhW2vjHBKswicWwtSfPqqJ2KHN0QSR2B2Y6eBmsseOHW2PQQVPeGw7KMYhBBfqvuPKMr0NthlYNTXqU3x4nCbrEqjT87g0kfLEVLNtdUAUvh1JU-bkIlkGD_LUcCcnmnX0FddByW_jKucdYTvJzMK6WwKrscGRMqZ2&__tn__=%2CO%2CP-R,39,0,positive,39
1109670579699210,NVIDIA AI,0,20,0,0,0,0,0,0,20,0,Intelligent virtual assistants significantly increase contact center efficiency by reducing customer wait times and resolving customer challenges faster. Learn how you can build an #AI virtual assistant for your contact center. #speechrecognition Read now: https://nvda.ws/3G90ZJu,2023-01-03T00:00:00,[],https://scontent.fcai19-7.fna.fbcdn.net/v/t39.30808-6/323454123_2687045901427045_2702586637642260860_n.jpg?stp=dst-jpg_p526x296&_nc_cat=106&ccb=1-7&_nc_sid=9267fe&_nc_ohc=dFtG9O870GsAX-BySe3&_nc_ht=scontent.fcai19-7.fna&oh=00_AfAc3ZEXe8j7ionP5HfzBJA6OsLJNABkLprx5bXyRBo1nQ&oe=64E2CFDC,https://www.facebook.com/NVIDIAAI/photos/a.119492422050369/1109670579699210/?__cft__[0]=AZVfw5tvtq7CYs-3fTzEoGuKBRA-sfA4wKqRpZi-wHyd5kTXwXeEerwRGfvEgyQqgwJJfcxvGLZtB5tjcrFeO60udURrtM9NNnsRRtlOVkK7p4GrOA10uJ4ru2mdHAlthcXrHT71oT1p68X3JAlC63Ju8M2DGXKFMxiYulAQKDGHlrMvHh_LrF2Cyu4m5ZusTX1Gw4tlnolOJBW4CXl7A3wv&__tn__=%2CO%2CP-R,20,0,positive,20
pfbid02kyb1GNREU2WQoXbokX8aD2qtcz5rZMGZAAPXzzqGFN3FVDiGYUjRG5igBknERCxwl,NVIDIA AI,0,21,2,0,0,0,0,0,23,3,"In celebration of the holiday season, our CEO’s #AI avatar, Toy Jensen, sings in his musical debut. A performance created with #NVIDIAOmniverse Avatar Cloud Engine (ACE) technology. Learn more at https://nvda.ws/3Whi9KP. Special thanks to Ushio Tokura, Applerain, and AlphaRLe for the Minecraft RTX Winter Wonderland scene. Happy Holidays!",2022-12-27T00:00:00,['blob:https://www.facebook.com/5fa859b5-b6c3-4dea-ab98-c807887d392c'],https://scontent.fcai19-7.fna.fbcdn.net/v/t15.5256-10/318770630_1351344412367275_1768292323844558181_n.jpg?stp=dst-jpg_p180x540&_nc_cat=104&ccb=1-7&_nc_sid=ad6a45&_nc_ohc=49kEonRGlzEAX8rYKUm&_nc_ht=scontent.fcai19-7.fna&oh=00_AfAxkGdVmJSEHI8ZaV5uTP_NR-Bl9re017ukGdr-K41Bdg&oe=64E3F8AC,https://www.facebook.com/NVIDIAAI/posts/pfbid02kyb1GNREU2WQoXbokX8aD2qtcz5rZMGZAAPXzzqGFN3FVDiGYUjRG5igBknERCxwl?__cft__[0]=AZXt5qdBcay9HkojkTrNaYDa60b6OPB55d3zIc0655YARuGyBuaJ2zz88z0MbxFA8RoxJ1xiOobNBxQpfCGybrw0V3z3ieuIXASB16nW-aiYguDqDdDd4eVXq_9eAkekQ22jvvaokWJLtq6JP7Fulkbni349dZaiXkjiNV-bY0VUm14tPr5Wr03NzoIQ9wTCCqEXxcfd9q2Xb3bR-8BVikWUenNG9p3BCDplNKFONmOYDD8gyklLESwMEQyYxxnE4e8&__tn__=%2CO%2CP-R,23,0,positive,23
pfbid02BSSp8eqMGyf9rWvWkDNrdJfRM47QgRwyFdqgmgqbUEtiQk9riwSYtPmaMKHNDbEzl,NVIDIA AI,7,26,0,0,0,0,0,0,26,1,This step-by-step guide teaches you how to deploy diverse AI model categories using NVIDIA Triton Inference Server.Learn here: https://nvda.ws/3VfXJR4,2022-12-23T00:00:00,[],https://external.fcai19-7.fna.fbcdn.net/emg1/v/t13/3049127066565491697?url=https%3A%2F%2Fdeveloper-blogs.nvidia.com%2Fwp-content%2Fuploads%2F2022%2F12%2Fimage2-5.png&fb_obo=1&utld=nvidia.com&stp=c0.5000x0.5000f_dst-jpg_flffffff_p500x261_q75&ccb=13-1&oh=06_AbH7C8-vZ6FyNhtGJ3UHIW322sgDKh5sZLYsgwyg8rMAow&oe=64E0AE71&_nc_sid=dbad39,https://www.facebook.com/NVIDIAAI/posts/pfbid02BSSp8eqMGyf9rWvWkDNrdJfRM47QgRwyFdqgmgqbUEtiQk9riwSYtPmaMKHNDbEzl?__cft__[0]=AZUMvOE6yAKOEclKScoJ9cmP358YFXzC10UaIWKZPdI_bcTK-jzmnSwRElncy42jCAOCBAMSMEFoJ5_qiadnuknpk9tqfenurIK7ZblNGi5hDw0ATsQSLyYNwgaP-Q7cvFaLLClKz0FAAx06rfeluDF1nzIYpVkTOIXg_Jr27C4IJ0nd9IIYaL33GJIGmUg8x3jMma2OLfXlWlQelMZoh2WA&__tn__=%2CO%2CP-R,33,0,positive,33
pfbid025TA6pAn34XwsFnWiNyPdBraAtynh6n6GSUmWJZ2UBypbn7Pv3vEfh4cFzA1yNJyxl,NVIDIA AI,0,17,0,0,1,0,0,0,18,2,Learn how to build a seamless data processing pipeline for high-throughput and low-latency model inference.Check out this tutorial now:  https://nvda.ws/3PKB91z,2022-12-22T00:00:00,[],https://external.fcai19-7.fna.fbcdn.net/emg1/v/t13/8123156989190229113?url=https%3A%2F%2Fdeveloper-blogs.nvidia.com%2Fwp-content%2Fuploads%2F2022%2F12%2Fgcp-tensorrt-featured-1.png&fb_obo=1&utld=nvidia.com&stp=c0.5000x0.5000f_dst-jpg_flffffff_p500x261_q75&ccb=13-1&oh=06_AbFLOrEJz1fokBg_-1-2iXfdisVCbPW5FHQy4iUEbzgNPA&oe=64E0ADF7&_nc_sid=dbad39,https://www.facebook.com/NVIDIAAI/posts/pfbid025TA6pAn34XwsFnWiNyPdBraAtynh6n6GSUmWJZ2UBypbn7Pv3vEfh4cFzA1yNJyxl?__cft__[0]=AZUvYMQl9F3H3imJJhWSRlALo6A-WufKAdaYY1SGgkxu3AOEJ5tMsTbIKtllH11mS398xknpqGrLyVNY0UNYjKhZ1h_1kgtJWUrYDn8jbyoq5MvrdqcKgvmCrJsphtRCtgLQgg3X0Q_5UK1RyjFsQarFrxu2O5swcI1SyxKgpRI7LKCEqNm-Dx5-VBNHCh8s-5rjQ9hboX5ZfgfhzSB4svhU&__tn__=%2CO%2CP-R,18,0,positive,18
1101208660545402,NVIDIA AI,0,21,0,0,0,0,0,0,21,3,Build the highway to AI success.  Learn how AI-first cloud infrastructure drives AI innovation in manufacturing and see how BMW is using automated quality control in this #HPCwire article: https://nvda.ws/3HRSnbx#MakeAIYourReality #AzureHPCAI #NVIDIAonAzure,2022-12-21T00:00:00,[],https://scontent.fcai19-7.fna.fbcdn.net/v/t39.30808-6/321348127_3366509876971143_2355502277664579961_n.jpg?stp=dst-jpg_p180x540&_nc_cat=102&ccb=1-7&_nc_sid=9267fe&_nc_ohc=_TcOTJWbz14AX_DoyS0&_nc_ht=scontent.fcai19-7.fna&oh=00_AfAe4Kon3NUTUEhAu19akFmiLxSWh8s3gNKvfTqaRcapbg&oe=64E30ECB,https://www.facebook.com/NVIDIAAI/photos/a.119492422050369/1101208660545402/?__cft__[0]=AZWg4puHmFabR-9iF61QSAXBRt9L9-WllpiaSHj3dBDbc9yLBblmDErpnwbalcww2hQaCUALbH4HFwmq3CyioE0bTGFU1pLL_Ls_-NfWYwg5Uj9JAWRn4ys8u6-MJgoK95yZzzwCkLc2VISnqLz9m1HdDO2ARcUHudQJfhVKLVYlFXRiHB6xon1EdlmmdMaF1EhO26zo_zhmMm3rI5oXbbNR&__tn__=%2CO%2CP-R,21,0,positive,21
pfbid02M69X1KrKAkNcCMqgAyZoWghWN2VEePZQ9MgpVtfSEVv5A48Jube9YDSXM9pK7gPkl,NVIDIA AI,0,9,0,0,1,0,0,0,10,3,A successful #edgeAI deployment starts with a proof-of-concept.Read about the common challenges when designing your POC: https://nvda.ws/3HY3EHg,2022-12-21T00:00:00,[],https://external.fcai19-7.fna.fbcdn.net/emg1/v/t13/14995390611508261326?url=https%3A%2F%2Fdeveloper-blogs.nvidia.com%2Fwp-content%2Fuploads%2F2022%2F12%2Fedge-ai-poc-featured.jpg&fb_obo=1&utld=nvidia.com&stp=c0.5000x0.5000f_dst-jpg_flffffff_p500x261_q75&ccb=13-1&oh=06_AbH3Fd9AV9i0bG6Q87aEiIX1zrTnpMGcflHw_f_Wnnoc8g&oe=64E0B9AA&_nc_sid=dbad39,https://www.facebook.com/NVIDIAAI/posts/pfbid02M69X1KrKAkNcCMqgAyZoWghWN2VEePZQ9MgpVtfSEVv5A48Jube9YDSXM9pK7gPkl?__cft__[0]=AZV8QHh7ee61L4zR2_UhU71jWGCnGSVSULm09ZC9-yZyKnCAREK7eAnEhEpBP2bnsGUq2OkpVoB4Qfi8zBtZnqUDLFIludC2McC8E1nN-xoUJbE_vFq0yVx8xSCeM0ltrN4RUSzt2aLDtHnHT4vinr_2g5Z640U2aUkKOVBNh_zGyenSdmhHkOdzvpHkR3gOE20rG0i5m6Rcw1LQqRhaaTaw&__tn__=%2CO%2CP-R,10,0,positive,10
pfbid037jr6tRX9SLH4pf6RcHwKTu1cDDLwq7ZjL96q5cYkTQykUdtU4wwbLJ6hAh1JASNnl,NVIDIA AI,0,25,0,0,0,0,0,0,25,18,Human-machine collaboration. Cybersecurity. Digital Twins.Learn about the #edgeAI trends for 2023. https://nvda.ws/3WfX9Ed,2022-12-21T00:00:00,[],https://external.fcai19-7.fna.fbcdn.net/emg1/v/t13/15043038139270024009?url=https%3A%2F%2Fblogs.nvidia.com%2Fwp-content%2Fuploads%2F2022%2F12%2Fedge-ai-retail.jpg&fb_obo=1&utld=nvidia.com&stp=c0.5000x0.5000f_dst-jpg_flffffff_p500x261_q75&ccb=13-1&oh=06_AbFVAJ_DYpmAPTNTMgmV2b3nJbHOwgeTMO9dHe3FPbM9BQ&oe=64E01C5C&_nc_sid=dbad39,https://www.facebook.com/NVIDIAAI/posts/pfbid037jr6tRX9SLH4pf6RcHwKTu1cDDLwq7ZjL96q5cYkTQykUdtU4wwbLJ6hAh1JASNnl?__cft__[0]=AZVtcsjB_HDpA4Y24qk2SqWYRdf5LIAhXYXuoJCzhf5mfeps6bm7sJM1tvH_IgIAfliv9RauEJm2aKP0tAL4MYO2fUhsw22rcWQwyF1emRg7NUx4lZig2fSXy1P8_qgiWBGdKBodz8VhkmdYHWyH44NpzZkIwg8Z20k8OOAuONOD8lVrM53X1-Zgfn3zmeVjUveCth1l6YrzRTC5Tqe1k2bD&__tn__=%2CO%2CP-R,25,0,positive,25
1101001953899406,NVIDIA AI,0,13,0,0,1,0,0,0,14,2,"Want the latest scoop on AI?  Get answers to your tough questions about AI, HPC, and cloud vs. on-prem. Find what you need in these latest articles, white papers, and videos from Microsoft Azure and NVIDIA on #HPCwire: https://nvda.ws/3VixPMm#MakeAIYourReality #AzureHPCAI #NVIDIAonAzure",2022-12-21T00:00:00,[],https://scontent.fcai19-7.fna.fbcdn.net/v/t39.30808-6/321239747_559861155585256_5880405678854351478_n.jpg?stp=dst-jpg_p180x540&_nc_cat=109&ccb=1-7&_nc_sid=9267fe&_nc_ohc=hcYiOvyCyusAX-50JkW&_nc_ht=scontent.fcai19-7.fna&oh=00_AfBeP2iCnwgiQNDy8lkqCzT3xDnNRpgrW_roFVjc2KiZ5A&oe=64E46B33,https://www.facebook.com/NVIDIAAI/photos/a.119492422050369/1101001953899406/?__cft__[0]=AZU_NaUx6qb_GRSohPdu_lU1-FE-h6Bh1Tc6VVon3CRk3EDfQygiGGgfMiviyykeaEEQOBeI5urCMJInzboRd1KGT_4Ekar5y7qBpn5GFEFLOgi_lOjo42YrgJMA82XVwJqcWdoQCUVAmUEomSmxCwGxtugxRY0akumViwJgIbFuyqYB86v7IkSo70rgBz0kiDaThIe1KFj5ZIvtfy9L3Oyr&__tn__=%2CO%2CP-R,14,0,positive,14
1100634730602795,NVIDIA AI,0,15,1,0,1,0,0,0,17,2,"Did you know that next-gen data science now runs on GPUs? Join us on Jan 18 to learn how RAPIDS platform built by NVIDIA can help you to increase efficiency, streamline development, and achieve more cost-effective data operations to implement better business strategies. Register now: https://nvda.ws/3BHYTxx",2022-12-21T00:00:00,[],https://scontent.fcai19-7.fna.fbcdn.net/v/t39.30808-6/319725468_735815244155913_7782140208465607867_n.jpg?stp=dst-jpg_p180x540&_nc_cat=101&ccb=1-7&_nc_sid=9267fe&_nc_ohc=ceAvdYfrO7sAX_vB1Vy&_nc_ht=scontent.fcai19-7.fna&oh=00_AfDggd_9SN6SAvqnFHCoYS7XLMCCzfOVoQjymBBaEZAybg&oe=64E42F7A,https://www.facebook.com/NVIDIAAI/photos/a.119492422050369/1100634730602795/?__cft__[0]=AZXN8mEmNYp0ryu4pGiDr3BCc-YKfbjTAhwtG9mwFO1WbmEO4QvlC_Ck-OZCpoYRdCsj5J37NFuFyECo2xUrD5gEoBEq9s47Qmrfhxz3hzyzMNo6ykcfv75BqUsCB2-MB3P2_mOQCSAP2hEYMZAN4tvxK2QZQ593n_fKRcMBEvvnLC08IlHQNQSiTnOrxd2nTKIc380FLD3pNEZuavho90xz&__tn__=%2CO%2CP-R,17,0,positive,17
1100560597276875,NVIDIA AI,0,10,0,0,1,0,0,0,11,0,"At #NRF2023 discover how Lowe’s is shaping the future of home improvement #retail with #digitaltwins to give its retail associates superpowers to optimize operations, localize plans and improve productivity. https://nvda.ws/3WvE8xi",2022-12-21T00:00:00,[],https://scontent.fcai19-7.fna.fbcdn.net/v/t39.30808-6/319795710_713377767078570_5986628613332343542_n.jpg?stp=dst-jpg_p526x296&_nc_cat=105&ccb=1-7&_nc_sid=9267fe&_nc_ohc=PYr7cqzGwBEAX_TfDvu&_nc_ht=scontent.fcai19-7.fna&oh=00_AfBzgynwCtdwL-YPOQE4PpG4SnqFhuNd8YwwmtnNKn-hJA&oe=64E417BC,https://www.facebook.com/NVIDIAAI/photos/a.119492422050369/1100560597276875/?__cft__[0]=AZVwNvnqUQ8J9g6rzSIvs3mnjWxWgsOnNBna9FV9xgSxd1DpphzavsDjzPu7pWORhE8ONESVgmuKPKoj7wQMhnY9Sd0ck7qPn8lFKKIe13i0IoP3DFA9yn8NtPAFIqYjIMU9k6aVbsy9pxHEfz8FWB6Ahy_-K2RB_QZxzI7RSmp1krWzYVVflISDsjRLnl5Jm5bvTwvjWQe02Wju281O3m_s&__tn__=%2CO%2CP-R,11,0,positive,11
pfbid02M11p1oNuY2uoSiEG6wmUKsqVTak981mHrD1b79SFtPCsJsswpsfA9cSTQoGft1xel,NVIDIA AI,7,20,0,0,0,0,0,0,20,1,"After making its mark in pro leagues, #NVIDIAMetropolis member Track160 has set its sights on democratizing sports data and analytics for amateur players in soccer clubs and community teams worldwide using NVIDIA GPUs and software. Find out how: https://nvda.ws/3NzidR5#ComputerVision #AI #NVIDIATensorRT",2022-12-21T00:00:00,[],https://external.fcai19-7.fna.fbcdn.net/emg1/v/t13/9726193635179273575?url=https%3A%2F%2Fblogs.nvidia.com%2Fwp-content%2Fuploads%2F2022%2F05%2FTrack160-adult-x1280-scaled.jpg&fb_obo=1&utld=nvidia.com&stp=c0.5000x0.5000f_dst-jpg_flffffff_p500x261_q75&ccb=13-1&oh=06_AbHgadiAP7RzF9k4ctIbE1si8y44z-AHIe_CCdvq5fNp7A&oe=64E019A3&_nc_sid=dbad39,https://www.facebook.com/NVIDIAAI/posts/pfbid02M11p1oNuY2uoSiEG6wmUKsqVTak981mHrD1b79SFtPCsJsswpsfA9cSTQoGft1xel?__cft__[0]=AZWGhecRpwo4owthmxQA4YMr1j5aAtbZ4s75ezwqTlW7P7KPzzlOl7ZqmQ8-nS_GI_qRMKpCwC7MXx-6JDN7bpRIhOuy5RfjYxVRIH_KEqq0KAs4VEp-J_g8E3KCY5VeG2kjjnmfNdK8FbM-UHC0DQvhDHmdC_vFKWScwCN48wBsijGoIrXerlH5dc2rqTbjZvhluu-Ak-UiesCNjBs9f3Fv&__tn__=%2CO%2CP-R,27,0,positive,27
pfbid02AG2aN3FYPM3r7PzQjHxn4Lc2MnD2qwKi9XF2ABE7giZQDKtMvvJ8UbDvSaWCj3nl,NVIDIA AI,0,11,0,0,1,0,0,0,12,3,Deciding to build or buy an edge management platform takes time.Learn about the benefits and challenges of each: https://nvda.ws/3Wbjdj6,2022-12-20T00:00:00,[],https://external.fcai19-7.fna.fbcdn.net/emg1/v/t13/2992680733348464272?url=https%3A%2F%2Fdeveloper-blogs.nvidia.com%2Fwp-content%2Fuploads%2F2022%2F12%2FBuild-vs-Buy-Edge-.jpg&fb_obo=1&utld=nvidia.com&stp=c0.5000x0.5000f_dst-jpg_flffffff_p500x261_q75&ccb=13-1&oh=06_AbG29cZEw0Z2oKdRaeSRuEkE9oCgci5hHF0uBbz5MFm5gw&oe=64E04074&_nc_sid=dbad39,https://www.facebook.com/NVIDIAAI/posts/pfbid02AG2aN3FYPM3r7PzQjHxn4Lc2MnD2qwKi9XF2ABE7giZQDKtMvvJ8UbDvSaWCj3nl?__cft__[0]=AZUabuKwWOJ3_srjwD-z25pYc2K6SE8w3ccJvn7D_EyarkNf4s5QeeuJAw0IPSH9aC_ep1FxNH5vuInK8ASKoX4GUa5PbhsmEjp7zBi-9VJnLmmM5LGBCYUjGNWx8x16sf1JyaDHRmS17LP5dtOGgWkf2EW7NSms8OPhdI9pAV8EWqQVU26Pri2qFRqSQE877n3foKfw_wbj5I4Mdv67QFt4&__tn__=%2CO%2CP-R,12,0,positive,12
1100391980627070,NVIDIA AI,1,13,0,0,1,0,0,0,14,1,"In part 2 of a 2-blog series, MathWorks explains how to develop and deploy #AI-based seismic facies classification by leveraging cloud-based HPC resources for faster prototyping and development with large 3-D seismic datasets.Learn more: https://nvda.ws/3FDN4tp",2022-12-20T00:00:00,[],https://scontent.fcai19-7.fna.fbcdn.net/v/t39.30808-6/320986462_1014150062843387_8727872453556316269_n.png?stp=dst-png_p843x403&_nc_cat=111&ccb=1-7&_nc_sid=9267fe&_nc_ohc=cdw8bDjsIloAX_pTGmv&_nc_ht=scontent.fcai19-7.fna&oh=00_AfCth2NSHY59P2etTk1hws8HtOjM0yTO4QRUPyjUZDSL2A&oe=64E38D37,https://www.facebook.com/NVIDIAAI/photos/a.119492422050369/1100391980627070/?__cft__[0]=AZXEXlpw9UfMHhAfPTT0wAMH324BZGTZJCLGrG4mmVY3reSleyZjEZNHLDoX7szYahgAOAFkStK6-UjZqD59Ji0UrkaKRAniDc21INgDq7YfFlupu_bgoIqTkYfIbKy4ST4NP9DI-YnePj-wCRsbvSfYqVQqPqwlJG54MMSZq5_ELKBbJYthuChrYJyAs7c3TOyKpZbtzOopQT1Upxu8Muwe&__tn__=%2CO%2CP-R,15,0,positive,15
1099740044025597,NVIDIA AI,0,13,0,0,1,0,0,0,14,3,"In part 1 of a 2-blog series, MathWorks discusses how geoscientists can use shallow deep learning-based algorithms with MATLAB on AWS and #AI models to automatically recognize distinct geologic features in seismic images.Read blog post: https://nvda.ws/3PCKsk2",2022-12-20T00:00:00,[],https://scontent.fcai19-7.fna.fbcdn.net/v/t39.30808-6/319761667_1185811185643752_4863929782637479325_n.png?_nc_cat=111&ccb=1-7&_nc_sid=9267fe&_nc_ohc=ULSWdO2jqtoAX8mdVkz&_nc_ht=scontent.fcai19-7.fna&oh=00_AfDAjbFIO-KkdR5EwYpmIiGU40BdMQwATXmqPOF1yXGnzA&oe=64E440CE,https://www.facebook.com/NVIDIAAI/photos/a.119492422050369/1099740044025597/?__cft__[0]=AZXcrZ0lPKZsplsWDdVff9ROtC4Y_KKkC_GDaH1pzmZabqCN-rx1Fq5RXOoAkcWJGFx_P4LEB1zSfx2lxuB1lB6KGcP_OVZ-viZoHMJPIM7JjJPLNQxDiZhgYxU8p9n12LcW0Fcc3dLdVmZG0iAb-TGtquN7eD_Ch0D_bDDGRL3i-ahziLBY5lXDcFbha3tXscdvjVmrQ8J4SZ2Vsx2Pte69&__tn__=%2CO%2CP-R,14,0,positive,14
1099702690695999,NVIDIA AI,0,16,0,0,1,0,0,0,17,0,@GoogleCloud and @NVIDIA have collaborated to enable Apache Beam users to maximize the inference performance of ML/DL models within their data processing pipelines using NVIDIA TensorRT. Learn more! https://developer.nvidia.com/.../simplifying-and.../...,2022-12-19T00:00:00,[],https://scontent.fcai19-7.fna.fbcdn.net/v/t39.30808-6/320914576_1115772259114312_1479550565561567591_n.png?stp=dst-png_p843x403&_nc_cat=105&ccb=1-7&_nc_sid=9267fe&_nc_ohc=oflUSgI5eKoAX-MFRF9&_nc_ht=scontent.fcai19-7.fna&oh=00_AfDcER2thJlaGBzp1ZGZUNjzCiERvdNzQImhypO9hypOJg&oe=64E3E845,https://www.facebook.com/NVIDIAAI/photos/a.119492422050369/1099702690695999/?__cft__[0]=AZXQ1Y6ee8D5DpYjNN_53V7pQ8mvRsICw7FsTLGVRdZS5zR5UwLqCFr87TdcGTiOyStD-46QVJdOQ0DDnopovBQ1MX78jwjJuRoqbMfWL7p0IE-hc5-KBYT1mX_p5FryM7e5HUZIcM-7QvXsgz9VP2y3EC3qRNcIkZUPwPQPbGv9LT_TFBs0lvAZSSr2_iKHnsoWtk5NaQBnvbzhHNI-YvZW&__tn__=%2CO%2CP-R,17,0,positive,17
pfbid033fWvVrGrSny9KbMBAydNxUs9VSagHUxM9wGx5nGjXsbL6Cob2B5ZKg8cJLLRickhl,NVIDIA AI,0,19,0,0,2,0,0,0,21,3,How can complex inference scenarios be fully encapsulated within a data processing pipeline?Integration of TensorRT with Apache Beam SDK: preprocessing data for running machine learning models at scale often requires seamlessly stitching the data processing framework and inference engine together. Learn more in this technical walkthrough.https://nvda.ws/3hwyxIg,2022-12-19T00:00:00,[],https://external.fcai19-7.fna.fbcdn.net/emg1/v/t13/8123156989190229113?url=https%3A%2F%2Fdeveloper-blogs.nvidia.com%2Fwp-content%2Fuploads%2F2022%2F12%2Fgcp-tensorrt-featured-1.png&fb_obo=1&utld=nvidia.com&stp=c0.5000x0.5000f_dst-jpg_flffffff_p500x261_q75&ccb=13-1&oh=06_AbFLOrEJz1fokBg_-1-2iXfdisVCbPW5FHQy4iUEbzgNPA&oe=64E0ADF7&_nc_sid=dbad39,https://www.facebook.com/NVIDIAAI/posts/pfbid033fWvVrGrSny9KbMBAydNxUs9VSagHUxM9wGx5nGjXsbL6Cob2B5ZKg8cJLLRickhl?__cft__[0]=AZVcta7Afvt2XmoqT2L9-KRPKCuOxRpDqWirUveMis3LRSau22iPTQ-hTi5pTfCM6AlRQHX0xGAX-FMIWdUk_oDJwClHV08reA9xs0G5xwk6j8xO5HBiE7F4ZxqjOFhQpjgn4cZTi2SxpaMRimB8FbJfqKvb9Q21-WnRqEEEVYBa3mDzbHqncp86lWtnr8t33w9BNlyvjnwzwz-Io65AfBlR&__tn__=%2CO%2CP-R,21,0,positive,21
1096751147657820,NVIDIA AI,0,9,0,0,1,0,0,0,10,1,"Find out why Breeze users love getting real-time traffic, road updates, and parking information in a local Singaporean voice developed by NCS with #NVIDIARiva text-to-speech. #speechAI #speechrecognition https://nvda.ws/3g5jDI2",2022-12-15T00:00:00,[],https://scontent.fcai19-7.fna.fbcdn.net/v/t39.30808-6/320205163_692132602424582_8597189229330427038_n.jpg?stp=dst-jpg_p526x296&_nc_cat=111&ccb=1-7&_nc_sid=9267fe&_nc_ohc=Uup_gwWXzggAX9sNmwf&_nc_ht=scontent.fcai19-7.fna&oh=00_AfAWtr4VNI_FTvgLsM98lRnd5T4ev_xeIPQhXruNKNRpUw&oe=64E4A228 https://scontent.fcai19-7.fna.fbcdn.net/v/t39.1997-6/320273276_1545083639229660_6114912624828885974_n.webp?stp=dst-webp_s168x128&_nc_cat=102&ccb=1-7&_nc_sid=ac3552&_nc_ohc=-Dkz7v-wzYsAX9TWdnu&_nc_ht=scontent.fcai19-7.fna&oh=00_AfDmd6XMf51NFd1IJp6PZeO82IR4CTiNfpHbPfqJTGcnig&oe=64E2ECD0,https://www.facebook.com/NVIDIAAI/photos/a.119492422050369/1096751147657820/?__cft__[0]=AZXVjbNB-d_eU8dy1wM2rt1ZB2E_-l0keXuFJFWvIZDNwSzPt8mD4EIeK-ch3zgb0i0VDfSy8Rw9yRtT3o2TClmZtkK3GfHI1bU9A9qAKrcBiRXlNyZXQRnAGXz2eLJM2I__5W-U2_csDO92NqLDCLDvdv2Zq7kk3CJwRKocTybeuByYJMeSmYfInvZBIjQS72V3kKThcthKPnXVjdh1LwbY&__tn__=%2CO%2CP-R,10,0,positive,10
1096726954326906,NVIDIA AI,2,18,0,0,2,0,0,0,20,1,Are your contact centers struggling to keep up with customer demands?Check out this blog to learn how to accelerate building and deploying #intelligentvirtualassistants at a large scale with NVIDIA's intelligent virtual assistant workflow powered by #NVIDIARiva. #speechrecognition #texttospeech https://nvda.ws/3UXWWnB,2022-12-15T00:00:00,[],https://scontent.fcai19-7.fna.fbcdn.net/v/t39.30808-6/319636697_1391837135013145_6125131304244010133_n.jpg?stp=dst-jpg_p526x296&_nc_cat=102&ccb=1-7&_nc_sid=9267fe&_nc_ohc=KSYz7CSC8VIAX-4A_Kn&_nc_ht=scontent.fcai19-7.fna&oh=00_AfCklNvxN1YLe1NqpswnYL0ZH7zFCg9TJfredrLHn6ApFQ&oe=64E37F37 https://scontent.fcai19-7.fna.fbcdn.net/v/t39.1997-6/106596279_953856521743372_5660584279452470764_n.png?stp=dst-png_p320x320&_nc_cat=1&ccb=1-7&_nc_sid=0572db&_nc_ohc=oAAbZ-Y_KSUAX85f12f&_nc_ht=scontent.fcai19-7.fna&oh=00_AfDfiI3xrBxOAGbR-cSHujqVbx_WYxs1MOd1htWRZsc1Pg&oe=64E42905,https://www.facebook.com/NVIDIAAI/photos/a.119492422050369/1096726954326906/?__cft__[0]=AZV99z1ArYm_2m2InUHnPz_beZC0WZAF41KW1U_863FKotKtByeEDzB-G3MX39wnXlPKTCO-_d7SDYEwA4d4RKU6CZlVZncfMlk84ivfG_MuVikZ22HXEZvlp6vzPt4oAtkLbCgk7Xo87jgCWjJi-f3yFBWF0ohfrt0F1aBalp6QY8NGqmMkXUmIM6pxh7Dtj31QBaLYV5OjxffabBSvtRU0&__tn__=%2CO%2CP-R,22,0,positive,22
pfbid02gFaXosnhBnXSjLtSt8V1nGHbuYJa3yaPYo7GDSzbQh5r5xQ6c8oDY2Hyxo6Y7sa8l,NVIDIA AI,0,9,0,0,1,0,0,0,10,0,"Turn up the volume and listen how Gridspace, a #NVIDIAInception partner, uses natural-sounding virtual agents to provide exceptional customer service and make patient onboarding easier using #speechAI. Learn more: https://nvda.ws/3YCBWG6",2022-12-15T00:00:00,['blob:https://www.facebook.com/41154201-ece2-4656-958a-f63e36f0b66e'],,https://www.facebook.com/NVIDIAAI/posts/pfbid02gFaXosnhBnXSjLtSt8V1nGHbuYJa3yaPYo7GDSzbQh5r5xQ6c8oDY2Hyxo6Y7sa8l?__cft__[0]=AZXL5cZvvvBVNovqEvtwTETb9GnoDZ46wL8nSYhzeXVTACVuXHpqaSEdt_2ionheR7Jo00okuCJJHZ3D6PSCqmCbyB23ZjPR3NJ-Zyc9mc_bAzD6C3x2_Dx6jtDj2ztiZPmU95bn0crRZQQc_FdWjkonGRG7xxlrOsjuZ6rBDSmMCo8sM_R0zlKszVV83K3lOxSec1RC1rq74cYpDenkGdNCxzhbX5LEQ2xoiNgFzrd2hQ&__tn__=%2CO%2CP-R,10,0,positive,10
1096618007671134,NVIDIA AI,0,12,1,0,1,0,0,0,14,5,Spending more time on data prep instead of model development? Overcome CPU limitations by migrating Spark workloads in Google Cloud's Dataproc – up to 5x faster results with GPUs. See benchmarks and migration tips: https://nvda.ws/3hsrrnO,2022-12-15T00:00:00,[],https://scontent.fcai19-7.fna.fbcdn.net/v/t39.30808-6/319450311_487859183437350_2409054307116262487_n.jpg?stp=dst-jpg_p180x540&_nc_cat=107&ccb=1-7&_nc_sid=9267fe&_nc_ohc=y0wRttqTGAwAX-qqiXR&_nc_ht=scontent.fcai19-7.fna&oh=00_AfB-y4bymAcuIvxf_h0KHR6Y9wwCTDmRa6TCdPgr4Q_Ccg&oe=64E30D14,https://www.facebook.com/NVIDIAAI/photos/a.119492422050369/1096618007671134/?__cft__[0]=AZViBVTYuDojy_INYNaIzVNFc5gybEwUkSatfBodxa0p0TsYbtzh6mNSYe_0lwWGZ5yjXc2-LthGk-6oOTPS9libibnBAHT1wrEMqT3Fv6L3SwJhNVdGfOANryAq34YBcCU6uYgT8ojHwXRopArqMwRMNvhUXg-yh-MECWi6Jv2M_34zP_iuIInVCpMgqocKOxibxpkwMVc9fzmq4aFjHkXn&__tn__=%2CO%2CP-R,14,0,positive,14
1096496761016592,NVIDIA AI,0,23,0,0,2,0,0,0,25,4,Join NVIDIA at #NRF2023 and visit the Innovation Lab to see the most visionary #retail technologies. The Lab is an immersive experience where these technologies come to life through hands-on demonstrations. https://nvda.ws/3PvmAyI,2022-12-15T00:00:00,[],https://scontent.fcai19-7.fna.fbcdn.net/v/t39.30808-6/320170429_1629835640766274_6210809837801123610_n.jpg?stp=dst-jpg_p526x296&_nc_cat=104&ccb=1-7&_nc_sid=9267fe&_nc_ohc=FA4loeDtI7YAX8Sk5aE&_nc_ht=scontent.fcai19-7.fna&oh=00_AfDaZ3is5kNOL7vDDwkmeX2RU9qaDrkNcdW5bwzHDt-Y7A&oe=64E31467,https://www.facebook.com/NVIDIAAI/photos/a.119492422050369/1096496761016592/?__cft__[0]=AZUcun62WIRpQtBb72-Op0KxCEVVeAmzSWHoDM0WMBtwgc-2HkGncJaIlQSpwMZBQ11m-0y_DySqkveBaywLRWym1VqZUSp4s9xEJpnvjFOzUcuESyZGqN_fehaKWMXidn5EVng99-iYmWsE5LGnu40e_Go_bKe2qdlrElPHNUhk8RsKpitlcMXPBBv4kXA_w97JtXUrmt006ZM_AQzWUOSH&__tn__=%2CO%2CP-R,25,0,positive,25
pfbid029rGm3bqZjU2gwYFi3AogUFyQ4d2o4XoCWLXGbEjnC5cdZtXgUReJ3WzHr3inxUGfl,NVIDIA AI,0,9,0,0,1,0,0,0,10,3,Airidas Korolkovas was granted an NVIDIA TITAN V after applying to the NVIDIA Academic Hardware Grant Program. See how this helped accelerate the design and implementation of a GPU-accelerated tomographic reconstruction algorithm for XRD to supplement existing CT X-ray scans in airport security. https://nvda.ws/3VXa51A,2022-12-15T00:00:00,[],https://external.fcai19-7.fna.fbcdn.net/emg1/v/t13/4035222648549780051?url=https%3A%2F%2Fdeveloper-blogs.nvidia.com%2Fwp-content%2Fuploads%2F2022%2F12%2FXRD-Crystal-Research.jpg&fb_obo=1&utld=nvidia.com&stp=c0.5000x0.5000f_dst-jpg_flffffff_p500x261_q75&ccb=13-1&oh=06_AbE_eOPt29t4kZKSF8lK1RQ3TFwoGWZVelvUnloL-L7ltA&oe=64E0757A&_nc_sid=dbad39,https://www.facebook.com/NVIDIAAI/posts/pfbid029rGm3bqZjU2gwYFi3AogUFyQ4d2o4XoCWLXGbEjnC5cdZtXgUReJ3WzHr3inxUGfl?__cft__[0]=AZXKdRH3Twu1MQM8hXBtgttLSpDFceWpF2Fob9saTeXy9jo-y3RPKPBL-_Om8nnvasOvLQpHOYlL2DNX1osu3YeQmRLczztqUPNyjYYMn7g9Kbbo0CCjAQbKXyrd6xKklXdNaiQD_S5V2zYGG4EQjRt9Fr84JI96gcTOqjMqrgvtOoUNG2Epqn1FtoQ8hhpGzkxNpdHvljb9t6triBYg_qIr&__tn__=%2CO%2CP-R,10,0,positive,10
1095980364401565,NVIDIA AI,0,19,3,0,2,0,0,0,24,2,Learn the fundamental tools and techniques for accelerating C/C++ applications to run on massively parallel GPUs with CUDA. Register now for 1/11/23 instructor-led workshop: https://nvda.ws/3VTUNuw,2022-12-14T00:00:00,[],https://scontent.fcai19-7.fna.fbcdn.net/v/t39.30808-6/319284594_1798169720544895_4839037874111498497_n.jpg?stp=dst-jpg_p180x540&_nc_cat=107&ccb=1-7&_nc_sid=9267fe&_nc_ohc=4_YZJRfBMPMAX9duKyI&_nc_ht=scontent.fcai19-7.fna&oh=00_AfBLfoA47AQeZd0dQ5lak-y0W7avC1Pp6a7l3DahLp63xw&oe=64E2FCF3,https://www.facebook.com/NVIDIAAI/photos/a.119492422050369/1095980364401565/?__cft__[0]=AZVYp3abnXwpyT1RZD30B3IPcyo_2ufemrOmgQfOdRClF17YD2VSSwHzaMNyGuzHGmJnG6aIyN1iCMxNBMVFqZTdF4eUrzYj03-OhZkhhKEhaiStVn4_RDO10ykSOE_jgXm7t7aKR8T_E1oNKS0UhKNivs95jz9jdHfKBurTO0CIkDyfCx_sxGtqQj_OOYUuQ4hKUjf1jrhQLjqYPbWUo2He&__tn__=%2CO%2CP-R,24,0,positive,24
1095921214407480,NVIDIA AI,0,7,0,0,1,0,0,0,8,2,"#NVIDIARiva is a GPU-accelerated SDK for building and deploying fully customizable, real-time #speechAI applications. Read this introductory blog to learn about Riva’s architecture, key features, and components for building speech AI services. #speechrecognition #texttospeech https://nvda.ws/3HuA8c7",2022-12-14T00:00:00,[],https://scontent.fcai19-7.fna.fbcdn.net/v/t39.30808-6/319037706_514880597331649_4629496632668239015_n.jpg?stp=dst-jpg_p180x540&_nc_cat=102&ccb=1-7&_nc_sid=9267fe&_nc_ohc=DHV7JyKTLWwAX_XYl6M&_nc_ht=scontent.fcai19-7.fna&oh=00_AfB2mrtGEjllphBWDbdxBJoKVAx9Up6tMZQGUmIZA56xqA&oe=64E401EA,https://www.facebook.com/NVIDIAAI/photos/a.119492422050369/1095921214407480/?__cft__[0]=AZUTOuUsmnXSPS9CxndXafNIzUxxjWZ_jNicZSUA5i_Wn85XpsJpTi54WmVOyClJSgszI4rBhFXaclfjhs0Ee56kTjl9heHn77t055qspB00AfsJpOco7KWaW35RvPP8yIfQjl9f3rDTatqjuRplXBpzBkkEnjkQnbsj7Im_J-pLxApvOQv12aG8hUQAsLMlDfFqELAXxM4Z897SoGYhuKP1&__tn__=%2CO%2CP-R,8,0,positive,8
1095251287807806,NVIDIA AI,0,7,0,0,2,0,0,0,9,0,"To learn about the latest news and updated on #AI in #Healthcare, make sure to follow @NVIDIAHealth",2022-12-14T00:00:00,[],https://scontent.fcai19-7.fna.fbcdn.net/v/t39.30808-6/319789542_553338996639188_4458195890009046793_n.jpg?stp=dst-jpg_p180x540&_nc_cat=109&ccb=1-7&_nc_sid=9267fe&_nc_ohc=nPK18I4rkLwAX-IXbEG&_nc_ht=scontent.fcai19-7.fna&oh=00_AfCHD5xkoC5gjnBXo83bB88usDAH8eD0BuQw8rO5BYoBqg&oe=64E40D89,https://www.facebook.com/NVIDIAAI/photos/a.119492422050369/1095251287807806/?__cft__[0]=AZVE97Gy-xNu95ShOMJFeg6r2dxZXo-yrecyxDdME2taRDVlVaCSRSVyxh3MTn9yCSJ-jhsFpeMMhDLhPuwQCyNdlt-K9lFEkC71PKAluW3XQpai7Ag3fktIjMUXg8YlWEOZ3JEVxwYhubKy7-cJgxszzY0_APFfWUcccxhGcqIErdE6q2SkWqM9B-hKKc0LIr8g7GfuMcKmLbWfmiuOpOqG&__tn__=%2CO%2CP-R,9,0,positive,9
1095194097813525,NVIDIA AI,0,19,0,0,3,0,0,0,22,3,"Use your NVIDIA GPUs to turbocharge your data analysis work, thanks to RAPIDS cuDF, now available to try on Google Colab: https://nvda.ws/3PqjPPd",2022-12-13T00:00:00,[],https://scontent.fcai19-7.fna.fbcdn.net/v/t39.30808-6/319153371_1439022076624465_3796126336214755161_n.jpg?stp=dst-jpg_p526x296&_nc_cat=106&ccb=1-7&_nc_sid=9267fe&_nc_ohc=U39IxYqxdDUAX9Q-KG5&_nc_ht=scontent.fcai19-7.fna&oh=00_AfDXGRJO5PnNJ5dtrATW36yKBZFDW8QmQkichsPCQ9FiXQ&oe=64E49FBE,https://www.facebook.com/NVIDIAAI/photos/a.119492422050369/1095194097813525/?__cft__[0]=AZVCg7M46mGBW2lW5CE8jhXrpLmcTuG2DG9z-CMZrboblR_fjUAgdJS_Hxj22amNtqMh_Y1x2iDZf7o8dVjwQWmtv19D1hc4PGtCdBjTdFeXTnGS6yG1QFW3ofSXpio_CfMJ5oOVLJVBVrvfupG6o65taJ1RZn-C5u6ZqcJYwHunqpbfRKlHGS7xymZgKU3ybPe0TC8EOQGJxLrFimbAD72B&__tn__=%2CO%2CP-R,22,0,positive,22
pfbid02iFvJWY7iNDG6FE4dkWfPTtr3szh4kF8DAEVBhBXaQewW9hyEJtH521bgj8E25vLl,NVIDIA AI,0,42,3,0,0,0,0,0,45,10,"Today, we announced the latest release of the #NVIDIATAO Toolkit, a low-code AI model development toolkit that simplifies the creation of custom AI models. The new 4.0 version makes it easier to experiment TAO on #GoogleColab, and further boosts developer productivity with all new #AutoML capability, integration with cloud and third-party #MLOps services, access to complete source code and model weights, and new pre-trained vision #AI models.Read news: https://nvda.ws/3FPnVgT",2022-12-13T00:00:00,[],https://scontent.fcai19-7.fna.fbcdn.net/v/t39.30808-6/320060660_1189546375252995_6540453041549720273_n.jpg?stp=dst-jpg_p526x296&_nc_cat=107&ccb=1-7&_nc_sid=9267fe&_nc_ohc=UfwBUEJzAT4AX9Xx4WG&_nc_ht=scontent.fcai19-7.fna&oh=00_AfCZebZcGRz__pyvVLMoBR82P0ZkTRv3hKDAIEWLF-ecwQ&oe=64E30FCB,https://www.facebook.com/NVIDIAAI/posts/pfbid02iFvJWY7iNDG6FE4dkWfPTtr3szh4kF8DAEVBhBXaQewW9hyEJtH521bgj8E25vLl?__cft__[0]=AZXQ0XwE_HpS-OfotKqaqazGI2900LwPWOdMVV3cmykJCdLi8wJHkOm-ujVOe93tDV5KEbClYUtSZcWkZclJJKdrPvZqUwUCWZkYJ5_FmYoaesMdK7qHHptFGVV7YzbhecH7h2J0EUX0okfeZDAbhLEgFNBPkZoCKw0Js3MM6eHHkKC6Yiaa3d_A61hcQWti5tyStdk2BHdWn1kdFhHF0ck2JabsJMEVkp-CsslOydCDeEYBKKEZRm0yA5wrlRdle1Baax23rjDLLL2pYkjAZZpt&__tn__=%2CO%2CP-R,45,0,positive,45
1095131297819805,NVIDIA AI,0,6,0,0,2,0,0,0,8,0,Considering web scraping? Learn proper etiquette and how to build a spider module for crawling JavaScript websites with Scrapy: https://nvda.ws/3FJBXAA#datascience #bigdata #ETL,2022-12-13T00:00:00,[],https://scontent.fcai19-7.fna.fbcdn.net/v/t39.30808-6/319880459_1336119090539107_425251239078106619_n.jpg?stp=dst-jpg_p180x540&_nc_cat=103&ccb=1-7&_nc_sid=9267fe&_nc_ohc=BJvhhHZlnk0AX-kgez0&_nc_ht=scontent.fcai19-7.fna&oh=00_AfCN_lVhN_lemM6ulhj9bOsAx90SknUc5pLTlMSkmaAy2A&oe=64E2EF97,https://www.facebook.com/NVIDIAAI/photos/a.119492422050369/1095131297819805/?__cft__[0]=AZXaBMqhbbdyd4Zn_GYRz9ASe3J3YbykqVMinTdDhbw4PRV4fH8HoeD-1dTHHbzrqSmMNY_KgyAk27HXOG6JNEP3H95VWf_65Vc2ovitIwkSMBBnOlPCKDOYeayx256VLf5ZwN1CnBBJrYnoPZE4MSRv27YOsZKHfSsfXtxytdVbWQA0pTrrf_HmTWfup49DVAYJtqLVbLMIehMuD-KQmHmV&__tn__=%2CO%2CP-R,8,0,positive,8
pfbid0WT2qqFBFNBwMQN31UjKjYej3Nvd3e7MPaPPZzWqUsrRyCQk3YFUShQavDqkYJgJgl,NVIDIA AI,0,9,0,0,1,0,0,0,10,0,Be the next wave of physically accurate #3D virtual worlds and learn to build on #NVIDIAOmniverse. Enroll in this course to build your own custom scene manipulator tools in Omniverse with hands-on exercises. https://nvda.ws/3HjnGfa,2022-12-13T00:00:00,[],https://external.fcai19-7.fna.fbcdn.net/emg1/v/t13/17859241139552585059?url=https%3A%2F%2Fprod2-sprcdn-assets.sprinklr.com%2F50276%2F0e12654e-796d-4978-95c5-921713ead78b-30150991%2Fdli-social-new-omniverse-works.png&fb_obo=1&utld=sprinklr.com&stp=c0.5000x0.5000f_dst-jpg_flffffff_p500x261_q75&ccb=13-1&oh=06_AbHsEomgoaIt-gpP3EET1CxsuvSVW5ZFsXw6iTkqtGXbhg&oe=64E080A0&_nc_sid=dbad39,https://www.facebook.com/NVIDIAAI/posts/pfbid0WT2qqFBFNBwMQN31UjKjYej3Nvd3e7MPaPPZzWqUsrRyCQk3YFUShQavDqkYJgJgl?__cft__[0]=AZXsl4C3mhRjjD_VnLFBqj3kCSnDds7aPTYFAA4gESGm9reDfcFCfCb5zumOgDSlKR4n0ixYaY1ohunbEK1BcMj8hV_v4GiFe987S36uBr7TpwEEGApASY8rcXbdVdA7QebZJcbmhpCo-iStaKy81T8bo5-BvPba-hLVKa2dGMxX6Kt2I3NAY6PvSG8kI0KsvmtFTEW9tjMTsIGn6QXHivh_&__tn__=%2CO%2CP-R,10,0,positive,10
1094929471173321,NVIDIA AI,0,11,0,0,3,0,0,0,14,1,Join us at #NRF2023 to hear from #retail industry experts how Kroger is reinventing the customer shopping experience by simulating various store configurations for faster checkout. #AI #Metaverse. https://nvda.ws/3iRti68,2022-12-13T00:00:00,[],https://scontent.fcai19-7.fna.fbcdn.net/v/t39.30808-6/319698389_571032691531291_1093411319516367556_n.jpg?stp=dst-jpg_p526x296&_nc_cat=101&ccb=1-7&_nc_sid=9267fe&_nc_ohc=CuTh5JalnaQAX8pwEFj&_nc_ht=scontent.fcai19-7.fna&oh=00_AfDcksJJ7kYJpbADYdgV4Ky-lQ1RtPBI7GCfGIi6EYFjdQ&oe=64E407F7,https://www.facebook.com/NVIDIAAI/photos/a.119492422050369/1094929471173321/?__cft__[0]=AZXvk0ekk_yyXduXPc7pKcKwzFr5PVG_CaMRXOv21TXsdW1q77Ly20YVB2ny65WspisLIVSl2PeqQT3Yy39Z3I03SYK_Wp1XBabIdIehjxjplS9eLOR01E_IQM2xm2anI-CqF15Tfy70d4nhKegKxxO8SAEccQLbr6kau4YoM9udTa_vd0CW4CEeZxh4AUOXVuFQDiD691plSyG0R0TfnH8g&__tn__=%2CO%2CP-R,14,0,positive,14
1094396987893236,NVIDIA AI,0,13,0,0,2,0,0,0,15,2,"Missed the news from Deutsche Bank and NVIDIA? Get the details on the multi-year innovation partnership to improve anomaly detection and risk management, improve operational efficiency and enhance customer service in financial services: https://nvda.ws/3YjHXHm",2022-12-13T00:00:00,[],https://scontent.fcai19-7.fna.fbcdn.net/v/t39.30808-6/319708364_1093823564631644_425660001170433816_n.jpg?stp=dst-jpg_p526x296&_nc_cat=107&ccb=1-7&_nc_sid=9267fe&_nc_ohc=FW4VnOHtdqoAX-yckSN&_nc_ht=scontent.fcai19-7.fna&oh=00_AfCFkHp4NidzYHqQsjyj8Kq-2pIJamMvwkwEQgiy9eZjsQ&oe=64E49ADD,https://www.facebook.com/NVIDIAAI/photos/a.119492422050369/1094396987893236/?__cft__[0]=AZUVk165cdtcn7a-sSudh-QATZTw4oe0DUQwES51UU0fa_JaRE8EGUF2aGm-ojfcHHWeaNjCSmwWv0CIgSaN291msMYQuhKptZcT16nncgLv2z3r8csEzuNhRPsnhAVkjg2by7FodXsStwNEh7gnIfiaVwC0Zt6nSoHhjD94Rm9L756lFFwZhRsT5PRTkpHnuGB_OMCz_f4XM-N5MgbOoYib&__tn__=%2CO%2CP-R,15,0,positive,15
1094306887902246,NVIDIA AI,0,13,0,0,2,0,0,0,15,4,How did AT&T process more than a trillion rows of data on GPUs using NVIDIA RAPIDS Accelerator for Apache Spark? Check out our blog and gain an insider's perspective! https://nvda.ws/3FaBINw,2022-12-12T00:00:00,[],https://scontent.fcai19-7.fna.fbcdn.net/v/t39.30808-6/319319105_1094306884568913_4432035682870954149_n.png?_nc_cat=108&ccb=1-7&_nc_sid=9267fe&_nc_ohc=CA0bP9O7EdEAX_NNUzc&_nc_ht=scontent.fcai19-7.fna&oh=00_AfCLhRw68jph3r6hFby1gtKHdtPl27ACecmTEKDtB-TzvA&oe=64E3D105,https://www.facebook.com/NVIDIAAI/photos/a.119492422050369/1094306887902246/?__cft__[0]=AZU7g7EGe0NJy1kaaglplTA2B7xw0MzVgHZDqhomlV2L759u6D-PVN8fkJvJFymoYCTNh7Nww1l0k6Ilaf_PvqF5cYSnhiYtMvKhBjgp_rMDI3N2ClgSko4E_fB-7ymgzrfy0mk97lzzbnlaJeNKDKnjQ03XzU6yOvyASkq6Kbsoh_2jPpijasu0uBXDwo3TMuOrNFPOzYAosXc6UodAKjuy&__tn__=%2CO%2CP-R,15,0,positive,15
pfbid0uckfrsSG2Lte6x5ve8Y2CnXUguiV4pYWrRALdHbYRv47CButxYSX2XWKbtF1E9Zwl,NVIDIA AI,0,9,0,0,2,0,0,0,11,1,"Explore the evolving AI inference landscape, architectural considerations for optimal performance, end-to-end deep learning workflows, and how to take AI-enabled applications from prototype to production. https://nvda.ws/3iysSRL",2022-12-12T00:00:00,[],https://external.fcai19-7.fna.fbcdn.net/emg1/v/t13/12743870749826399505?url=https%3A%2F%2Fwww.nvidia.com%2Fcontent%2Fdam%2Fen-zz%2FSolutions%2Fdata-center%2Fgated-resources%2Finference-technical-overview%2Finference-gpu-accelerated-ai-og.jpg&fb_obo=1&utld=nvidia.com&stp=c0.5000x0.5000f_dst-jpg_flffffff_p500x261_q75&ccb=13-1&oh=06_AbHkSadsrpLWENO9UCONa80TICxH9qBV1J4YKCwHKeEQVA&oe=64E0AF45&_nc_sid=dbad39,https://www.facebook.com/NVIDIAAI/posts/pfbid0uckfrsSG2Lte6x5ve8Y2CnXUguiV4pYWrRALdHbYRv47CButxYSX2XWKbtF1E9Zwl?__cft__[0]=AZWjHqjjBnD5f_miMcN6R_1A8TW1iNeauxf41SaAAUYk3EJ3dX8CdHXTjOrg-4EzaLtMh2MMF2drl2kjm1Lj4jZtSb0rZKymTj66atJlBIkf4ULq6L51l5P0vHd-6rcEE1Xdmm0J4e0OjWD5dT7cs-lggRMG1WDqTkQDzVZJtVey6dX58ls6oI39-GsEgTnaltC5WCfYZ4L2gG-tIoOtbY05&__tn__=%2CO%2CP-R,11,0,positive,11
pfbid026wemzgXYKz58xD9JiXftKqgfpsJGuKZfix369oHhVN8qWf5TYa184XJ2ixsVtr5Gl,NVIDIA AI,0,8,0,0,2,0,0,0,10,2,Get hands-on experience with #NVIDIAOmniverse in this self-paced course. Learn to create your own custom scene layout tools in Omniverse Code with a few lines of #Python script. Enroll now: https://nvda.ws/3Y5Vfan,2022-12-12T00:00:00,[],https://external.fcai19-7.fna.fbcdn.net/emg1/v/t13/7985495469811972015?url=https%3A%2F%2Fprod2-sprcdn-assets.sprinklr.com%2F50276%2Faa8e4e7b-c197-4283-b424-424a9b244cc8-450187885%2Fdli-social-new-omniverse-works.png&fb_obo=1&utld=sprinklr.com&stp=c0.5000x0.5000f_dst-jpg_flffffff_p500x261_q75&ccb=13-1&oh=06_AbEyAjrmQLBQufC-N6DdxVm000Ig_oz0qX_Gw_DPgk8wqQ&oe=64E09864&_nc_sid=dbad39,https://www.facebook.com/NVIDIAAI/posts/pfbid026wemzgXYKz58xD9JiXftKqgfpsJGuKZfix369oHhVN8qWf5TYa184XJ2ixsVtr5Gl?__cft__[0]=AZW_Ek5qRqkNCKr9shxf-mXFj03TjwhDRip0RaewHc1VysMjwnKi-_XjJqKZ08IyHZxkvKhtHdyzWUJurPZ7lSS9_jNdNnLqcfyuqQSL8RQqg4DlAsU0zurETDkNz2DopxnaYD8QGp99xVICPOeYFs-g8Y5OvxXzb0AaFANd0rzOZtp_LJJj6xPDgHhBfPFoEIygl09ZpNtFPmAQOI3c9vNG&__tn__=%2CO%2CP-R,10,0,positive,10
1094207777912157,NVIDIA AI,0,14,1,0,2,0,0,0,17,2,"On December 14 at 8 AM PT, learn how Red Hat and NVIDIA are working together to help build an #AI platform to accelerate key workflows in trading, fraud detection, document digitization, ESG activity, and more.Register now: https://nvda.ws/3iUWtoO",2022-12-12T00:00:00,[],https://scontent.fcai19-7.fna.fbcdn.net/v/t39.30808-6/319010579_1094207771245491_2532445592292009384_n.jpg?stp=dst-jpg_p526x296&_nc_cat=104&ccb=1-7&_nc_sid=9267fe&_nc_ohc=AChmvWmM-_AAX8f5_4r&_nc_ht=scontent.fcai19-7.fna&oh=00_AfC7FaEXAfDPMOTG1hYxJt6SnFwdIb_vIkQOwlNwUKTQ8Q&oe=64E3642E,https://www.facebook.com/NVIDIAAI/photos/a.119492422050369/1094207777912157/?__cft__[0]=AZWhBSQG_UzQgwBVDDTNKn1f3IoIR0ggWnVKYo1-37dWb5fPd6KtvCO71RTOJUsck0-Wo32sJ1qivhbzg8JILfAKO5hf8aXbyTjL1MCmR4O7vrayDW-DzoRr5WuRNHarz5SiBb7kheK2eGtD2iTQRSV_UxT8z0i5VZtGv6blx12-F53oKbHkQs-i9OZEF0oOvuM-Cgt4XziFWzoWwU_S17fE&__tn__=%2CO%2CP-R,17,0,positive,17
pfbid0LcxPbKThH8XEvWbuUo4783obwBAEwP4oF2x6s182hTRL6HWiVTG8Zm3n5fzu1dsgl,NVIDIA AI,0,14,1,0,3,0,0,0,18,3,"The NVIDIA BioNeMo service is now available for early access, providing scientists and researchers with a turnkey cloud solution for #AI #drugdiscovery pipelines, optimized for chemical, proteomic, and #genomic applications. https://nvda.ws/3VMYQbZ",2022-12-09T00:00:00,[],https://external.fcai19-7.fna.fbcdn.net/emg1/v/t13/7572600633188227934?url=https%3A%2F%2Fdeveloper-blogs.nvidia.com%2Fwp-content%2Fuploads%2F2022%2F12%2FBioNeMo-Tech-Blog-1600x900-1.jpg&fb_obo=1&utld=nvidia.com&stp=c0.5000x0.5000f_dst-jpg_flffffff_p500x261_q75&ccb=13-1&oh=06_AbGxTHlm20yceFl0uY6T8oQPr7_gUbOni536u4KIjKrVBQ&oe=64E06527&_nc_sid=dbad39,https://www.facebook.com/NVIDIAAI/posts/pfbid0LcxPbKThH8XEvWbuUo4783obwBAEwP4oF2x6s182hTRL6HWiVTG8Zm3n5fzu1dsgl?__cft__[0]=AZVKBNBeE7TprujMvqZeB0WeQJ7kIEyBMpryNyTjgxMuSXVHXpPWxlTbXbe8Vs_-gGyDPFgTAZe_bjqSaisFwxhF2omKGJS6ZPT_iC1CWujDeiZ8CSpvclkeDbVjuJ-VyVI0ugI3eyvk40TYX_O8l72kSJKNrvoqMJh-78ssSFGN-4hPPeiLXjYjklnVJK_8yjG43CW4MKeqkbiDyiv1U_FD&__tn__=%2CO%2CP-R,18,0,positive,18
pfbid02nR8f7QnpfhyXdJGtEtdxwat13ZL7zX8U5PH8B38WWGwaLyp87TwCvSbKWJbuv66ol,NVIDIA AI,0,29,0,0,4,0,0,0,33,9,"Learn the basic concepts, implementations, and applications of #graphneuralnetworks in this self-paced course. Build fundamental knowledge in hands-on interactive activities to get started using GNN as a graph analysis tool. Enroll now: https://nvda.ws/3XYSaZP",2022-12-09T00:00:00,[],https://external.fcai19-7.fna.fbcdn.net/emg1/v/t13/1272534132490687890?url=https%3A%2F%2Fprod2-sprcdn-assets.sprinklr.com%2F50276%2F6198956b-ef2f-4072-ab69-18d965143ff5-476299824%2Fdli-gnn-course-social-li-tw-20.jpg&fb_obo=1&utld=sprinklr.com&stp=c0.5000x0.5000f_dst-jpg_flffffff_p500x261_q75&ccb=13-1&oh=06_AbEWWQN02ynuw59OA5l0PlNLqrG1qHFkUrqJ1k4Mqk86nQ&oe=64E0B072&_nc_sid=dbad39,https://www.facebook.com/NVIDIAAI/posts/pfbid02nR8f7QnpfhyXdJGtEtdxwat13ZL7zX8U5PH8B38WWGwaLyp87TwCvSbKWJbuv66ol?__cft__[0]=AZV1DTFAMAkWktxE5M_Q7BhvHOFSlAD9KSPYukbMIu1rC7e_vnmgVrQHioy0m3BFJXtqvDqglyRCdnu9kykgAUXJVtG4CBfS0GrlYyWKaoRCP9_fD4XlW9NRhP-bRLmXnHbNslLydAJjHafICOgVm4A_H9O0-NQXPZl7obHXuwj_5nwTCuiqVsguq8CYjEFZZDV99YHRo2T4On-ggGHYnmYJ&__tn__=%2CO%2CP-R,33,0,positive,33
pfbid0XJwYLdT9nu5qmPycmtvfFZcvtTNZvxvCYPxtBc7zFHt1MHvhsem4ioVFND8oyHP1l,NVIDIA AI,0,7,0,0,2,0,0,0,9,1,Experience the #NVIDIAOmniverse development platform for builders and creators of virtual worlds. Learn to build your own custom UI for workflows in Omniverse with hands-on exercises. Enroll now: https://nvda.ws/3P67EXT,2022-12-09T00:00:00,[],https://external.fcai19-7.fna.fbcdn.net/emg1/v/t13/12642566070324306482?url=https%3A%2F%2Fprod2-sprcdn-assets.sprinklr.com%2F50276%2F25088507-4178-48b0-854c-5be5e2deeaa4-48199946%2Fdli-social-new-omniverse-works.png&fb_obo=1&utld=sprinklr.com&stp=c0.5000x0.5000f_dst-jpg_flffffff_p500x261_q75&ccb=13-1&oh=06_AbEYjLmu7xFeGzwmjo0POhtRb43ZH0Yrfd6OddVDVLUMvg&oe=64E06AD9&_nc_sid=dbad39,https://www.facebook.com/NVIDIAAI/posts/pfbid0XJwYLdT9nu5qmPycmtvfFZcvtTNZvxvCYPxtBc7zFHt1MHvhsem4ioVFND8oyHP1l?__cft__[0]=AZWqZmJBQjFxklXTU5krAFb2pNqSbh099gIl_iE0LdCFzyBmOFFY_C_xddnKU7Kb-dJ158EZ2QbfG6mtRJEUqglMPaQm4kvyMqFtsfDHzvaKKoQrZCUdHfg00gjHJ05Xn0xl6c1y1kNx4YOB1hiV99fIDleIIEDHU2CP0UxfXiP1BIplkpl7ygFKFHW3Xq5ooRM2JxB7LB2O-Eo-69y7Ixpu&__tn__=%2CO%2CP-R,9,0,positive,9
1091170254882576,NVIDIA AI,0,6,0,0,2,0,0,0,8,6,See how #machinelearning is the latest tool in the pioneering career of meteorologist Dale Durran and how his team's latest neural network can process 320 six-week forecasts in less than a minute on the four NVIDIA A100 Tensor Core GPUs in an NVIDIA DGX Station! https://nvda.ws/3GGjMMQ,2022-12-09T00:00:00,[],https://scontent.fcai19-7.fna.fbcdn.net/v/t39.30808-6/319028475_1091170244882577_8352297994037495675_n.jpg?stp=dst-jpg_p180x540&_nc_cat=109&ccb=1-7&_nc_sid=9267fe&_nc_ohc=l9YqOjLDAb0AX87_qTN&_nc_ht=scontent.fcai19-7.fna&oh=00_AfBd1OYR7LOypf3GzV6UlEuxZxYR0OKniYaa15OES3RJ8g&oe=64E2BF46,https://www.facebook.com/NVIDIAAI/photos/a.119492422050369/1091170254882576/?__cft__[0]=AZVW6TwwWtYhCokC35xtowM3TdVk0E2IEv3pHiZ0Wl1BwGx8WzIISvuKXOVJ7NVm2wXz3tLGi9zDEY6IiG9QOqaWegIsW6TwKsM5PSegQRScqxWedQjSwC__r2Ul6V2AuPglueZphXGEzGneFoPtwc1INuJXXiPySfM5_QkdkrRWwhdGBDh868cQMQlNOskOgHm2Z8hyBvi9THADgCneQVxa&__tn__=%2CO%2CP-R,8,0,positive,8
1091120791554189,NVIDIA AI,0,8,0,0,2,1,0,0,11,1,"Prototype, test, and fine-tune your conversation-based AI solutions with NVIDIA Riva’s automatic speech recognition skills in this free trial. #ASR #NVIDIARiva #SpeechAI https://nvda.ws/3EaqCYn",2022-12-08T00:00:00,[],https://scontent.fcai19-7.fna.fbcdn.net/v/t39.30808-6/318151475_1091120788220856_5942032555567849740_n.jpg?stp=dst-jpg_p526x296&_nc_cat=103&ccb=1-7&_nc_sid=9267fe&_nc_ohc=UnHBQakQNc0AX8wUUYN&_nc_ht=scontent.fcai19-7.fna&oh=00_AfDHbqKoup_NWyJRW6Oxx0XDg6Z_ffI3YEVXclu_ES3XxQ&oe=64E44EA1,https://www.facebook.com/NVIDIAAI/photos/a.119492422050369/1091120791554189/?__cft__[0]=AZVmorUOTyb9KU2hDonQhUUYLgURirjXE0-5TiSFlIrBboDYIM-1WqZE47t8TLoo4Y8dNOU23Q9y4RN-DXzyNfvtFptoBTLIhoZM-ki6uaBMI-FDidQK7GXqbl5Pxht2GaRpJvdQdnf3lUUGMsbsceeVGHtBHXi8ipHFtbg7Lr0ul6gGTdoYO0TmPGAlT-YiRmIx7CBf18n5GOyWYmb_2VWn&__tn__=%2CO%2CP-R,10,1,positive,9
pfbid0x457D84dLXVL2xgP3zqNKZM9ixruyPE9LvZZ3pFaHEbNk5SJi7yicMxBsHnjpdFal,NVIDIA AI,0,6,0,0,2,1,0,0,9,14,Learn about what pretrained AI models are and how they are advancing various #AI use cases. https://nvda.ws/3FBFL6L #AIModels,2022-12-08T00:00:00,[],https://external.fcai19-7.fna.fbcdn.net/emg1/v/t13/15929676425829527788?url=https%3A%2F%2Fblogs.nvidia.com%2Fwp-content%2Fuploads%2F2022%2F12%2Fai-for-dev-blog-pretrained-models-corp-blog-1280x680-1.jpg&fb_obo=1&utld=nvidia.com&stp=c0.5000x0.5000f_dst-jpg_flffffff_p500x261_q75&ccb=13-1&oh=06_AbHzCkzJC4Yd1se67no9s5vv4F857lJsexz28RCBHhDHuA&oe=64E07CBB&_nc_sid=dbad39,https://www.facebook.com/NVIDIAAI/posts/pfbid0x457D84dLXVL2xgP3zqNKZM9ixruyPE9LvZZ3pFaHEbNk5SJi7yicMxBsHnjpdFal?__cft__[0]=AZV0MJ4X6LVecU8QqMmDJTHFl_uy09TaQp6ZIeVIHnfuwuuxbZRg4kcJ3chI5HNyWHolIg5sLRwsI8Z-Z_zEaJ4lMkkGA-EiKLay2pF4NP1fKyaPncN5JFaiWWPKAWSjPVeCXSQ9Z8rPbRqWNjfKTf6-QdkoKmsbstJhsiVjqVvMmHTjxQ7WdfLo-lyJ8Y-k_UcuVRvon4sUSWRoZJswW1-1&__tn__=%2CO%2CP-R,8,1,positive,7
1091063724893229,NVIDIA AI,0,4,0,0,2,1,0,0,7,0,Curious to know how NVIDIA is supporting #innovative #tech #startups across the globe? Join the open house session to explore #NVIDIAInception and #NVIDIAClara. Register for the 12/13 webinar: https://nvda.ws/3Bhj7ye#developers #engineers #entrepreneurs #startupecosytem,2022-12-08T00:00:00,[],https://scontent.fcai19-7.fna.fbcdn.net/v/t39.30808-6/318931702_1091063711559897_1734316192032293104_n.jpg?stp=dst-jpg_p180x540&_nc_cat=104&ccb=1-7&_nc_sid=9267fe&_nc_ohc=cufpATYtAR4AX9I30y1&_nc_ht=scontent.fcai19-7.fna&oh=00_AfBvKNgdMC0FBRgTc_Tl_gFBFc1dDHZfMmsMAssARyhUOA&oe=64E3731F,https://www.facebook.com/NVIDIAAI/photos/a.119492422050369/1091063724893229/?__cft__[0]=AZXT1yyPi2PY1qrlZjzcnHv1XIDoI_vMQvk7bNbM9MiM6W23SdTCWiqpZJ8c59B1nz1-WWjy5zgKRYfywSNeiMIO7xZg9b7YYRnXDloCRYS_jWUu-QkR9OtYzX0FNJbBo-COiija0vdqnewNfxfWMEfCMN872dw2l4Llt4rLw-WJRwIkj2FWxQU5jgmFEqQta29PkEv_gOtppWwM-prVWTNy&__tn__=%2CO%2CP-R,6,1,positive,5
1091000104899591,NVIDIA AI,0,16,0,1,1,0,0,0,18,1,"Refiners and energy tech developers are using #CFD simulations to boost the performance and reliability of heavy industrial equipment.Learn how CPFD is accelerating CFD models by over 500X to minimize unplanned downtime, reduce costs, and increase production: https://nvda.ws/3HcUw1d",2022-12-08T00:00:00,[],https://scontent.fcai19-7.fna.fbcdn.net/v/t39.30808-6/318479777_1091000101566258_2128169394433869131_n.jpg?stp=dst-jpg_p180x540&_nc_cat=100&ccb=1-7&_nc_sid=9267fe&_nc_ohc=gjh9TNmTxRIAX9lX4Ml&_nc_ht=scontent.fcai19-7.fna&oh=00_AfBMZXCMV-lB0DF9XoiRRcD74fij9HZo7zG3yVFUZjxOqQ&oe=64E4111E,https://www.facebook.com/NVIDIAAI/photos/a.119492422050369/1091000104899591/?__cft__[0]=AZXe7r76U-Frr-jLkXfp8YDMiUraNbkJk2lF-G2wbMSdXu0SU8iir1JXMrgLWoup-L46LNqrHEUEzkqE3uU1QrUd4fww-W9vjVkK65rUdn52TPoqF-oVgfOs8rUQc5ga4ahqSW5hgzg__r6bNRbvFRg3D-_71dKcGqdjyFt6Qbj5tpFhUqRPq68CEEed_szRFwphLfdL3gxUb3Ukb8lOpA3M&__tn__=%2CO%2CP-R,18,0,positive,18
1090931674906434,NVIDIA AI,0,5,0,0,2,1,0,0,8,0,Retail’s Big Show is retail’s most important event. Connect with #NVIDIA on the show floor and attend our Big Ideas speaking sessions to hear from Lowe's and Kroger. Discover all activities here: https://nvda.ws/3PdtKI6 #NRF2023,2022-12-08T00:00:00,[],https://scontent.fcai19-7.fna.fbcdn.net/v/t39.30808-6/318880683_1090931664906435_5366693851019129389_n.jpg?stp=dst-jpg_p526x296&_nc_cat=103&ccb=1-7&_nc_sid=9267fe&_nc_ohc=PneFBc9bFUcAX-Ew8uj&_nc_ht=scontent.fcai19-7.fna&oh=00_AfAvoTMCu_-8L0g39FV4XUmQdNaJEtspPnjE6DH_zBoxcQ&oe=64E2C06A,https://www.facebook.com/NVIDIAAI/photos/a.119492422050369/1090931674906434/?__cft__[0]=AZWDz2uq3Qe4jhOPuglkz8XAfV1FzdPPyz7X37F_9Dq1iqlwLOg6DInoWZOcdjtfyMQIDyQiTU_ln7TkSsvY9Vagv1Cbjd4-6nVitmwOj27BypiK4Zj0Hv5Ggt9jwuX19JTeNlsoWA1KXzb4xa9TGTYN0d0dQurKc6uiQAA4mWXOA_PyC2KbwKm2_9lQXxwwmroxhThZcoiVdVdAAKsiQKWI&__tn__=%2CO%2CP-R,7,1,positive,6
pfbid02N4HKCjRaC3GvFh1MJe3hmt4tUYjm4DG8yJaRLW43XT5SNfGXdVLCverRZpmQq2vJl,NVIDIA AI,0,6,0,0,2,1,0,0,9,0,"It's been 50 years since @NASA's original Blue Marble image.  Today, #NVIDIAOmniverse is being used to create Earth's #DigitalTwin, allowing scientists to better visualize & more accurately predict #ClimateChange.Learn more: https://nvda.ws/3uxANBH",2022-12-08T00:00:00,['blob:https://www.facebook.com/153f789e-f788-49d0-a2c1-8136dcf10b80'],,https://www.facebook.com/NVIDIAAI/posts/pfbid02N4HKCjRaC3GvFh1MJe3hmt4tUYjm4DG8yJaRLW43XT5SNfGXdVLCverRZpmQq2vJl?__cft__[0]=AZWBdBDf9uIky_k8f4vwkw9Rj0tiHIQyUCg5hkIlf0C6RkKHnx80LPGBRZysymej6ANl420mbQOs7pcAzRDydNgukX65SGpNKgwj1Q0B6AUXN9IOQ7GGJvhqyoztvpL8sO8IQYNeBzi387dNcsPmM6vCgkhrZAkSsYqMRR2SNSk5cmcsPj337DJ_onxszEdbv9beo1y0TnmTj4SJpGyc4NPQ-xmltzCKug9FWeibL0UNdg&__tn__=%2CO%2CP-R,8,1,positive,7
1090127921653476,NVIDIA AI,0,13,1,0,1,0,0,0,15,4,"Deutsche Bank is partnering with NVIDIA to develop #AI applications that improve risk management, boost efficiency, and enhance customer service. Learn more about the multi-year innovation partnership: https://nvda.ws/3F8VsRC",2022-12-08T00:00:00,[],https://scontent.fcai19-7.fna.fbcdn.net/v/t39.30808-6/318922963_1090127914986810_7850687595480842348_n.jpg?stp=dst-jpg_p526x296&_nc_cat=107&ccb=1-7&_nc_sid=9267fe&_nc_ohc=bvqi_WgvwG8AX_7ZT8j&_nc_ht=scontent.fcai19-7.fna&oh=00_AfB6M6bNWTGjsXTDIxv2XrfoRqGzUIExSs7MwQyah-wwEw&oe=64E3C131,https://www.facebook.com/NVIDIAAI/photos/a.119492422050369/1090127921653476/?__cft__[0]=AZWQ6l5wYkEK-Of5PmMsfvUn0hlswce4S1wgSnXwbk6tKOxxN6f9a0P4hT85edXjri1Pch2VcT5EBnFvGtXteq4ezSJ2GzJMJBUKTpb-FQPRumzWaHiDAP3Xa0bB5ZSNOL2NPT46cwM0wD_qF-aS0hOqpDh5CasOaiWQXrUvt0eiy-oFqdiRMjYzmj5MvlvI7p-GZS0N75ZBRvVQvJWuqmF-&__tn__=%2CO%2CP-R,15,0,positive,15
pfbid02FUNfY17hgYpHAnyMveFam19zak8gpxZo3aqd1sJ7UqA2NmzR16CqvSCY2jkVk99gl,NVIDIA AI,0,4,0,0,2,1,0,0,7,0,"Our #AIModels recap discusses NVIDIA’s pretrained AI models that are facilitating efficient #AI application development spanning across multiple industries such as healthcare, retail, and many more. https://nvda.ws/3UFNe99",2022-12-07T00:00:00,[],https://external.fcai19-7.fna.fbcdn.net/emg1/v/t13/15288355568762087002?url=https%3A%2F%2Fdeveloper-blogs.nvidia.com%2Fwp-content%2Fuploads%2F2022%2F12%2Fimage1-1.jpg&fb_obo=1&utld=nvidia.com&stp=c0.5000x0.5000f_dst-jpg_flffffff_p500x261_q75&ccb=13-1&oh=06_AbGMQkYTrgNTzvirxxBIvYayuLNbvf6-IjT9E_z-ITTWVA&oe=64E09F3A&_nc_sid=dbad39,https://www.facebook.com/NVIDIAAI/posts/pfbid02FUNfY17hgYpHAnyMveFam19zak8gpxZo3aqd1sJ7UqA2NmzR16CqvSCY2jkVk99gl?__cft__[0]=AZVoM4ZjC7J9FcdsKcp32W5zeXurXJGQ4rNulYRmCszsCMZ_IJWny1qUiccCK4-Dlq9MVSMrjIm6m8odM1_-t5g8tzVYmE2lBiDHiBxa2ozEhC1YWTlz3Rw4Diw76srjdFQsVPTno6AjPax7Ss8jpd59JIqc8JQlLmwHS3gMG26y9jwFAwjGhIJKWpjZdwhfl3qJyj3IVtyqWy-zcI3B8YAI&__tn__=%2CO%2CP-R,6,1,positive,5
1090050001661268,NVIDIA AI,0,9,0,0,2,0,0,0,11,1,Waiting hours for HDBSCAN soft clustering to finish processing a few hundred thousand records? The RAPIDS cuML library can do HDBSCAN soft clustering in seconds rather than hours. Get the code and latest benchmarks:https://nvda.ws/3BfnQ37,2022-12-07T00:00:00,[],https://scontent.fcai19-7.fna.fbcdn.net/v/t39.30808-6/318200449_1090049998327935_5531147638195241405_n.jpg?stp=dst-jpg_p180x540&_nc_cat=110&ccb=1-7&_nc_sid=9267fe&_nc_ohc=Qr7NOTKBgE4AX8Vrrub&_nc_ht=scontent.fcai19-7.fna&oh=00_AfAPPDuDAAZ6rD1JzN9l5oJFyY9L2v4ilUW_mxtVhqsJpg&oe=64E45C43,https://www.facebook.com/NVIDIAAI/photos/a.119492422050369/1090050001661268/?__cft__[0]=AZX9Pcp2cmql3oAAKg116UFFUz6PObERfCBFUC3HKzQx6dInsNuosx2Zdb1VhO1ZDagodUOO5OMy6VLXKtrIEIUkDBFpMdkQeGUOuXm4FVs4XoHhwqUUUlZGKitxq7a3m3ebAE1vEljC0CoirEWqN4AOtKDwvLDG0YFifDrIH14-GmvNkgmDCkGjh92dhETuKV53SgcqlvkfOyCG4ktmzjFB&__tn__=%2CO%2CP-R,11,0,positive,11
pfbid02KKpQkfJb8QnPWP3J3ZdB5VqJ1S646XbKxN54KmSoDY1FRfxAGremomewz4MJX5c4l,NVIDIA AI,0,11,2,0,3,0,0,0,16,0,"Save the date for GTC—the AI conference that brings together thousands of innovators, researchers, creators, thought leaders, and decision-makers. #GTC23 https://nvda.ws/3Hfp6Y7",2022-12-07T00:00:00,[],https://scontent.fcai19-7.fna.fbcdn.net/v/t39.30808-6/318529165_5708988259148809_2727128942814128433_n.jpg?stp=dst-jpg_p526x296&_nc_cat=104&ccb=1-7&_nc_sid=9267fe&_nc_ohc=xndVlbPCYPQAX_jSayC&_nc_ht=scontent.fcai19-7.fna&oh=00_AfAErCTWGlfLbseKG0piTACph6vVuz-RG3Qnk4I58ZbEZg&oe=64E31608,https://www.facebook.com/NVIDIAAI/posts/pfbid02KKpQkfJb8QnPWP3J3ZdB5VqJ1S646XbKxN54KmSoDY1FRfxAGremomewz4MJX5c4l?__cft__[0]=AZUc6aHAUJ-YtOqbNBY-1QSzdUIjci27b1XHTbVc6-HvR-UjUvSHPdHomlRHVDLiTpojvGp5FGNuUTnzHSjKT0q8LHx3hcL78TdA2VFFFOlIwSuqygms3RFHsd5gjqIOTELdpPxtsDolzRtCD3-znaPlFZ-3fcirT0A4AIBI-KIyxh0DJ4qr539viVNwJT4nWDpICX4fwWdZ6aWuImRzp5Pl-g6yspmGJXyrKpePqUKbKs3ncvnxZ-MHiTBjLaDayFovznW4vnPzxIWu_jiIv2sh&__tn__=%2CO%2CP-R,16,0,positive,16
pfbid02VeHkXHFYbHvkjBeSxaXmi5wELDcRQEqm5aVzf8D7UdMaTqXXrR3MQUPphqqMMXqnl,NVIDIA AI,0,11,3,0,2,0,0,0,16,0,"Metropolis partner Landing AI is bringing data-centric #AI to the edge with their new product #LandingEdge, which captures images and runs inference on industrial PCs equipped with NVIDIA Jetson AGX Xavier modules. The results feed directly to controllers that operate robotic arms, conveyor belts, and other production systems inside factories. Learn more: https://nvda.ws/3NCilzE#NVIDIAMetropolis #Robotics #visionAI",2022-12-07T00:00:00,[],https://external.fcai19-7.fna.fbcdn.net/emg1/v/t13/15578463676861703731?url=https%3A%2F%2Fblogs.nvidia.com%2Fwp-content%2Fuploads%2F2022%2F06%2FLanding-AI-wafer-inspect-x1280.jpg&fb_obo=1&utld=nvidia.com&stp=c0.5000x0.5000f_dst-jpg_flffffff_p500x261_q75&ccb=13-1&oh=06_AbFEoFsdwFZ_FZAjvxaRAEbopUhCQGZ56ZXCPk_BNjOOxg&oe=64E055CA&_nc_sid=dbad39,https://www.facebook.com/NVIDIAAI/posts/pfbid02VeHkXHFYbHvkjBeSxaXmi5wELDcRQEqm5aVzf8D7UdMaTqXXrR3MQUPphqqMMXqnl?__cft__[0]=AZWGyJhOpfQTTTPVrXVpCI-jfy-JNrW1VBLiHK4mwoZhBNRn8K5ZEEOaDJj3mCW4tQiUYbDS1Ek5A4dpt_FcFu3O6TgD3TNlWs294EcX0hDrtP4MUICSmXib8NXpS81-yVIeyF1yqZdttiLEwUZHk9pOVE2nXVoZEDPn2-26dejwRz1MJ_FMbVYHsYYsfqNMxk1gKJ04KP2JwsQUs64eCHYt&__tn__=%2CO%2CP-R,16,0,positive,16
1089366578396277,NVIDIA AI,0,9,0,0,2,0,0,0,11,2,Register today for our webinar on January 25 to learn how to build and deploy intelligent virtual assistants for financial services contact centers: https://nvda.ws/3OVmJeB #SpeechAI #Finance #intelligentvirtualassistant,2022-12-06T00:00:00,[],https://scontent.fcai19-7.fna.fbcdn.net/v/t39.30808-6/317911923_1089366575062944_3935636893739257560_n.jpg?stp=dst-jpg_p526x296&_nc_cat=100&ccb=1-7&_nc_sid=9267fe&_nc_ohc=2pCHCVxqSw8AX_edAFu&_nc_ht=scontent.fcai19-7.fna&oh=00_AfAo5wjacf_Hy4VKXIw6vpntKBVImKtO2UdjmemEeCcjCw&oe=64E49082,https://www.facebook.com/NVIDIAAI/photos/a.119492422050369/1089366578396277/?__cft__[0]=AZUCS2Kf53Xymzq29x9A1iFBF01FHtg7DgkuZP_cX6P5AsyzdlTh6-T9p_cuCWwRZBPOMnHXDGQMeAQti32upIRfaY5413rRJYNAsL11adWdlQmkE5dVVrPvHiOoQRi-OLKUmQ0OFx2iRqzi0KLKPLzTusnQULyFWboo2HAKEMUtjigK5O0AtQSUe9TOsKDy_hUeEutAIJliT6OFLkBMxuom&__tn__=%2CO%2CP-R,11,0,positive,11
pfbid02tzbzgZihJZc6qxxqrjDRGmsHU1SrWCaAdAjdMJMMyb2hWn2zxcnRzXTBAPRzCaxRl,NVIDIA AI,0,11,1,0,2,0,0,0,14,5,"Download this white paper to get tips and best practices for deploying, running, and scaling AI models for #inference in applications. https://nvda.ws/3iysSRL",2022-12-06T00:00:00,[],https://external.fcai19-7.fna.fbcdn.net/emg1/v/t13/12743870749826399505?url=https%3A%2F%2Fwww.nvidia.com%2Fcontent%2Fdam%2Fen-zz%2FSolutions%2Fdata-center%2Fgated-resources%2Finference-technical-overview%2Finference-gpu-accelerated-ai-og.jpg&fb_obo=1&utld=nvidia.com&stp=c0.5000x0.5000f_dst-jpg_flffffff_p500x261_q75&ccb=13-1&oh=06_AbHkSadsrpLWENO9UCONa80TICxH9qBV1J4YKCwHKeEQVA&oe=64E0AF45&_nc_sid=dbad39,https://www.facebook.com/NVIDIAAI/posts/pfbid02tzbzgZihJZc6qxxqrjDRGmsHU1SrWCaAdAjdMJMMyb2hWn2zxcnRzXTBAPRzCaxRl?__cft__[0]=AZXs8fiV9gj7h50NiekAwbUBsBN3hIw89wJ4A2jXjTIaSI0eGpaTm0eNXQfj44droXCW5ejVB67cfYzfO8DjE2m33pONSxRwiBKwQ0oXQl1o5zM2UXxvDgGvM9hCKyN7HIVstscCvvE2_p_17buHp8FDTcmhr38CtENYkGI6gMr2ItAVtMUVrmW33TBF6dEJoSawA2Nqxh10OAV6aeisCNkY&__tn__=%2CO%2CP-R,14,0,positive,14
pfbid032GGHh4kXjs16Q1h7rMyKbkxicPbYkhKnr9kM3Jdf76sd44csbP5QMmFTgJXvmnHFl,NVIDIA AI,0,8,1,0,1,0,0,0,10,4,"Learn how Australia-based #NVIDIAInception member, EMVision’s portable brain-scanning device is able to diagnose brain strokes in just minutes, enabling faster stroke diagnosis, ensuring fewer disability outcomes and an improved quality of life for patients. #AI #healthcare https://nvda.ws/3iEWe0R",2022-12-05T00:00:00,[],https://external.fcai19-7.fna.fbcdn.net/emg1/v/t13/5035499293155863428?url=https%3A%2F%2Fblogs.nvidia.com%2Fwp-content%2Fuploads%2F2022%2F12%2FEMVision-scanner.jpg&fb_obo=1&utld=nvidia.com&stp=c0.5000x0.5000f_dst-jpg_flffffff_p500x261_q75&ccb=13-1&oh=06_AbHayLkRG52l3Uy_gOC5OfeF66Zr2BzyxMXImTc1lqp6RQ&oe=64E09592&_nc_sid=dbad39,https://www.facebook.com/NVIDIAAI/posts/pfbid032GGHh4kXjs16Q1h7rMyKbkxicPbYkhKnr9kM3Jdf76sd44csbP5QMmFTgJXvmnHFl?__cft__[0]=AZVFTjxzo7fO-eueaM7m-Zm_oA2XqtWHTsyVb6psHhhbHpM_XhQvBN-dUqlV3ahGfQFfVTgfjoDlCm4k_4WmNIR61FIM4xEeQpPckBNNdeXS_QDINs_dIn20ZPIwTIHkIEll7TXMoNqAjLW6TjeEsUpFRSHXdwCG3dsfeX7ZK67OYaVbLtF0kNLzEx4V3U5Gj-LJp1593_KSTLhS_EfRkmkX&__tn__=%2CO%2CP-R,10,0,positive,10
pfbid0TnpyK5VUWPmjC98aeC9pAxveDjZKjYmReDvwXPS5SiWxur8unHMsiEHPaBxm1jQvl,NVIDIA AI,0,3,0,0,1,0,0,0,4,0,NVIDIA #speechAI team won first place in an automatic #speechrecognition competition for Telugu language held by IIIT-Hyderabad. Read about the achievement in our blog: https://nvda.ws/3UzghLN,2022-12-05T00:00:00,['blob:https://www.facebook.com/acc37126-f1e1-4839-ba9d-b0d0ee8a80d2'],https://scontent.fcai19-7.fna.fbcdn.net/v/t15.5256-10/318254088_1369397353464740_5056150423927864261_n.jpg?stp=dst-jpg_p960x960&_nc_cat=111&ccb=1-7&_nc_sid=ad6a45&_nc_ohc=K89gl728xAMAX95Vv1R&_nc_ht=scontent.fcai19-7.fna&oh=00_AfCwxsbaENcoH-eVhWD8HyUtBU8QCxolqs4i1G98fliZmw&oe=64E45E11,https://www.facebook.com/NVIDIAAI/posts/pfbid0TnpyK5VUWPmjC98aeC9pAxveDjZKjYmReDvwXPS5SiWxur8unHMsiEHPaBxm1jQvl?__cft__[0]=AZV7caFR3WB1nYQxaS2pKaDE3GOCotIAJ3WTjCYcp02E_Snw2SNuF13C-l4NvginWAF3AWGO-MDX2X5UPfjqOBA-0Cwdat7fFnoOHq21TbXa9QH4Qeslf6YiO7IcX4PZzDMSK0j3x5yvXsBq6YxdUdk5fg-q_xgz5l9FjLB8Mj-lGBve8eXV0vdPYrVwsO-ZcLzQuLITNOglQVd8RsxXAFHiZ-5LOKHXqWVOnrv0OjXwZA&__tn__=%2CO%2CP-R,4,0,positive,4
1088705561795712,NVIDIA AI,0,6,0,0,2,0,0,0,8,0,"Join the NVIDIA Triton and NVIDIA TensorRT community to stay up to date on recent product releases, bug fixes, news, and more. https://nvda.ws/3cP6uRw",2022-12-05T00:00:00,[],https://scontent.fcai19-7.fna.fbcdn.net/v/t39.30808-6/317949377_1088705551795713_2861888856388854362_n.jpg?stp=dst-jpg_p526x296&_nc_cat=100&ccb=1-7&_nc_sid=9267fe&_nc_ohc=iApgUjuNm74AX-rQSjG&_nc_ht=scontent.fcai19-7.fna&oh=00_AfDvUpuiiv9ADvBGEnAPRPeEYDDbQIeFlo0rtAfUL88kkA&oe=64E33B0C,https://www.facebook.com/NVIDIAAI/photos/a.119492422050369/1088705561795712/?__cft__[0]=AZWrqyLk-YbCYwX0A_kIwRqRV9ByqvrGP_CufvIeqjP-nnfDq8dmbxP9hcpfHmYJm80trecysXYp5zqpjreYtSi1t5kqx2dK6VJCdAcWm0Ij1BmUlKr3MaYqJBGzXY3o6eT2v26QMspqnVA4OqqtzkxS31lTWSXE9zyS-ovThK3Ui_sLL0rsbt8xd-GRH79-gDTLuNFNQBJEtRreoJ6THUEw&__tn__=%2CO%2CP-R,8,0,positive,8
pfbid0AMKjmy8sx2t2RXZrjKMHQewQiNZGhddQtbSQy4FnzYeUNzhPdCUcCVLQ3zPNHGE5l,NVIDIA AI,0,25,4,0,2,0,0,0,31,6,"NVIDIA's newest generative AI model, Get3D, not only understands what it generates but also combines multiple techniques to output high-quality and accurate 3D models. @twominutepapers dives into this new model in this video. https://nvda.ws/3XXgwTG",2022-12-05T00:00:00,[],https://external.fcai19-7.fna.fbcdn.net/emg1/v/t13/10433493654195584555?url=https%3A%2F%2Fi.ytimg.com%2Fvi%2Fshy51E-MU8Y%2Fmaxresdefault.jpg&fb_obo=1&utld=ytimg.com&stp=c0.5000x0.5000f_dst-jpg_flffffff_p500x261_q75&ccb=13-1&oh=06_AbGaBTNyZFLxxT12Kgj1lTlwh3gEeUU8qx-FUL-8jUouAg&oe=64E095CD&_nc_sid=dbad39,https://www.facebook.com/NVIDIAAI/posts/pfbid0AMKjmy8sx2t2RXZrjKMHQewQiNZGhddQtbSQy4FnzYeUNzhPdCUcCVLQ3zPNHGE5l?__cft__[0]=AZXYti-8QBswIPbxlm7x8nf_joRUVTO3RRACNAv594C1UuWxAjht6_2UnqUdqDi7JHGDQ0-qhXbMQfTBXDRw5VmUiWtcctL65bo-LTXDiW5REDFgs1yD0RY9A65qSGwmdiAumYbh_40-SV_-B266FmfKh6hPcdntUNUXV-pJrY3s2hthrjfkjndMZBG75EPBSd7xaZsqcJMx7nxr4UTkmKfw&__tn__=%2CO%2CP-R,31,0,positive,31
pfbid0QKE4exFWjqG8GtN6yu4GD3HmxiC8L1zq9DJmWQZQWkiYUA8wxR6tQqmaQcNbeo6fl,NVIDIA AI,0,5,0,0,2,0,0,0,7,0,We have been very excited about #InstantNeRF for the better part of this year.In this video Corridor Crew shows just how big of an impact NeRFs can have. https://nvda.ws/3P0dY2X,2022-12-03T00:00:00,[],https://external.fcai19-7.fna.fbcdn.net/emg1/v/t13/3524721554137775823?url=https%3A%2F%2Fi.ytimg.com%2Fvi%2FYX5AoaWrowY%2Fmaxresdefault.jpg&fb_obo=1&utld=ytimg.com&stp=c0.5000x0.5000f_dst-jpg_flffffff_p500x261_q75&ccb=13-1&oh=06_AbGnGcv0LMttQQyjE_xZJcoPliridTSfeeTWlC6Hckz3VQ&oe=64E0B905&_nc_sid=dbad39,https://www.facebook.com/NVIDIAAI/posts/pfbid0QKE4exFWjqG8GtN6yu4GD3HmxiC8L1zq9DJmWQZQWkiYUA8wxR6tQqmaQcNbeo6fl?__cft__[0]=AZW7IXeaDNgZxDH_PAJYvCH2AS9KoEbvEC1Y7zeL-SnbqG6ikvm9w8pa88h-B2lXbqrzOxvfpBBkJUq6upnqmQD-ZpfGcloPLpaISeOXi3LkMB6aFDZyyyXFPWLmP7I8I_KgfJirVl7UDWRwF_4fUAPoEP_1HtaxhlXyT1154YBiJtK6u9szREj816jeyOpiIhyJL8prrLQRPMQ-DAxS4Fx7&__tn__=%2CO%2CP-R,7,0,positive,7
pfbid02YshDR4Nog1jNYVLxtGHqQ4zy2ikVJvEzsLrTyp23yHTixqKMWVTFiLXN6ZR9krNul,NVIDIA AI,2,6,1,0,1,0,0,0,8,1,Half a million photographs of two shipwrecks will blend into lifelike VR/AR exhibits thanks to accelerated computing. See how 3D researchers bring naval history to life! https://nvda.ws/3ODjTLm,2022-12-03T00:00:00,[],https://external.fcai19-7.fna.fbcdn.net/emg1/v/t13/4675660559718058004?url=https%3A%2F%2Fblogs.nvidia.com%2Fwp-content%2Fuploads%2F2022%2F11%2Fcurtin-hive-3D-projector-shipwreck.jpg&fb_obo=1&utld=nvidia.com&stp=c0.5000x0.5000f_dst-jpg_flffffff_p500x261_q75&ccb=13-1&oh=06_AbEGiwYZ0ecPkc9C1Znl5bC7-j-_KnZvKbQCBB9O58RH4w&oe=64E07F75&_nc_sid=dbad39,https://www.facebook.com/NVIDIAAI/posts/pfbid02YshDR4Nog1jNYVLxtGHqQ4zy2ikVJvEzsLrTyp23yHTixqKMWVTFiLXN6ZR9krNul?__cft__[0]=AZX4kADVXfb4PxbLcovNIVZOc7Kg1dnowi-WTG8Dat1xxQdgSKnTWQ3Oed4vYaaYR5ztT1gGPWC9QCqINiiavxRmRJMbB3JivciLHLyByt-InpVE3iU984MDuJNSbtrWDSK2OSKZxa7nuIrzAsh6EoJ_XFrDd-VaztgMWo2-O2LAEqO43g2q713VsDFB0h7f3SzW2ImjMVfDOBbF0avytLGC&__tn__=%2CO%2CP-R,10,0,positive,10
1086841955315406,NVIDIA AI,0,14,0,0,1,0,0,0,15,4,How can financial institutions use #AI to solve unstructured data and real-time analytics challenges? Join Red Hat and NVIDIA on December 14 at 8 AM PT to learn how AI-enabled workflows help reduce costs and enhance customer experiences. Register now: https://nvda.ws/3B6mlUS,2022-12-03T00:00:00,[],https://scontent.fcai19-7.fna.fbcdn.net/v/t39.30808-6/317743100_1086841951982073_381499373298995544_n.jpg?stp=dst-jpg_p526x296&_nc_cat=101&ccb=1-7&_nc_sid=9267fe&_nc_ohc=BuPf7eL8W-IAX-ulgDc&_nc_oc=AQl51glRbR1N8QUFRZiKH4HudENTTycYMbcFAmNX1SfxIbKQJRRiJAXsftHlOhABs1U&_nc_ht=scontent.fcai19-7.fna&oh=00_AfBtWHX18yg4GPDTMa4Y9IpFiJxXdns2Qtc2MVUHcAudRw&oe=64E3B989,https://www.facebook.com/NVIDIAAI/photos/a.119492422050369/1086841955315406/?__cft__[0]=AZUjIFmGnU4mIG3Z0HZwwH72DA1wm2cFT-FJMa6AM96AqUEExAThNY08-iGCLo03LRTpga_LAPvbBjmmUgCEi8XVFF49KxmiX7IkLE1PGzM8j0OQskFlu7FLtKgAxIWZcuAmRbhoBIwoR6Z4tvuylxftsl2Rj-2E7sc_E76w5H655OgPt080WItEtBp0Dq1UeJdTK-Lgskj08ZxZSYEf9hEb&__tn__=%2CO%2CP-R,15,0,positive,15
pfbid0xfTPEnbc8FZspPTHfrRRQEHdZjv8UFvDGtck798yZRFCx986LCvoNhXc2y3ytmUbl,NVIDIA AI,0,5,0,0,2,0,0,0,7,0,"On December 6-8, join us at Gartner #IT IOCS to learn how NVIDIA is leading the charge of enterprise #AI with #NVIDIADGX systems and enterprise software. Come by booth 111 to learn about NVIDIA technologies that are powering businesses around the world. Learn more: https://nvda.ws/3H47PAU",2022-12-02T00:00:00,[],https://scontent.fcai19-7.fna.fbcdn.net/v/t39.30808-6/317762872_1301369373972056_7115176201948806689_n.jpg?stp=dst-jpg_p526x296&_nc_cat=101&ccb=1-7&_nc_sid=9267fe&_nc_ohc=Dge8vW6jMHQAX-b96wR&_nc_ht=scontent.fcai19-7.fna&oh=00_AfAq3bcinD0C9ohwz7CCgF2tZRM_QTtg1YRB6XEP-PLo5w&oe=64E2DFAA,https://www.facebook.com/NVIDIAAI/posts/pfbid0xfTPEnbc8FZspPTHfrRRQEHdZjv8UFvDGtck798yZRFCx986LCvoNhXc2y3ytmUbl?__cft__[0]=AZXKADXhXXdZohlNBxAhhossyjMze3oa5xAtgL_UJu8_n41W0lk3av3p7PTwaozq3x4CsEoYLMFLnAjDm8ZBfKROEhJJW2Wh6CWgb90Mxs2P2OcZ_VpV34AfEh9GuxE6598eejR0omaAvgQX08kJpz2MULL14Ewe4sNIX_AAr6j9KLi_VTPghE6AuhRUCeP_3viOrD3iEIIRCsxChXagaIa5rdsX793DP-Mw0a6rqLc7eKlADj9GrljD5QfIWbJyGnbpxbrvtW1sC4e3O3f9rlQd&__tn__=%2CO%2CP-R,7,0,positive,7
pfbid02PyTVTp73RuNqjjUC68u3vJCCqoD4vrTzXeqFcQq9fC5XoV13gkUwKVxZp8YD4mJGl,NVIDIA AI,0,12,0,0,2,0,0,0,14,2,"#MONAI is an #opensource framework for developing and deploying medical AI applications. With MONAI application packages (MAPs), you can build an application from trained models in under 20 minutes for clinical deployment. Learn how: https://nvda.ws/3VGSAlm",2022-12-02T00:00:00,[],https://external.fcai19-7.fna.fbcdn.net/emg1/v/t13/8356462943856123336?url=https%3A%2F%2Fdeveloper-blogs.nvidia.com%2Fwp-content%2Fuploads%2F2022%2F11%2FMONAI-Tech-Blog-Image-1600x900-1.jpg&fb_obo=1&utld=nvidia.com&stp=c0.5000x0.5000f_dst-jpg_flffffff_p500x261_q75&ccb=13-1&oh=06_AbH9udx6NWbF5--d8eo2mLcZUQkvOT0I_PuauROQ4HvoeA&oe=64E0B828&_nc_sid=dbad39,https://www.facebook.com/NVIDIAAI/posts/pfbid02PyTVTp73RuNqjjUC68u3vJCCqoD4vrTzXeqFcQq9fC5XoV13gkUwKVxZp8YD4mJGl?__cft__[0]=AZXEyYkq4xg6xJ4pnEUD43so69WJDpgYeOkuWXNzA6FIMzeU_D0Tt2LqOa_P9SD8wDbbrvvgrgQlTbPthldCnHSw4MGTrAX7LBg16mMNt0HLKlGu-_XlZdrOg6eYOKcHEv-TbLO4upzLlV643yomyNm7oc6ZaiGf2Bi74bm9khNmQwKllkciQkQRi_ZbrtfHLCzUub2mXm5PfVB8pzhdiHIk&__tn__=%2CO%2CP-R,14,0,positive,14
pfbid0ox2mcqgddfySSva7X29g4TfpKejjb3RaRejWm92WNA59WgEa6iwrMjeNJ9k9bzQAl,NVIDIA AI,0,7,1,0,2,0,0,0,10,1,"Minecraft played by AI  Honored that our paper describing MineDojo, a generalist #AI agent that can perform actions from written prompts in Minecraft, won an  Outstanding Datasets and Benchmarks Paper Award at #NeurIPS2022 ICYMI: https://nvda.ws/3VNi7cY",2022-12-02T00:00:00,[],https://external.fcai19-7.fna.fbcdn.net/emg1/v/t13/13629332248224071417?url=https%3A%2F%2Fcdn.arstechnica.net%2Fwp-content%2Fuploads%2F2022%2F11%2Fmine_dojo_hero_2-760x380.jpg&fb_obo=1&utld=arstechnica.net&stp=c0.5000x0.5000f_dst-jpg_flffffff_p500x261_q75&ccb=13-1&oh=06_AbHTyQvhKGci4ns5_vwEbsIrdGdUjPTXTe_Y49ZpacSfHQ&oe=64E03ED5&_nc_sid=dbad39,https://www.facebook.com/NVIDIAAI/posts/pfbid0ox2mcqgddfySSva7X29g4TfpKejjb3RaRejWm92WNA59WgEa6iwrMjeNJ9k9bzQAl?__cft__[0]=AZWIbevRNzN2m9jNjdb64pp3wd9mKcEXKvXkKBOCpgOy9ULncnlE2etxG346_DNojmpw-5aa4xsjH86xDnTuAT473uP7-j70zcH0RC-tFA2MRX70LlkIQRTE_awRk8xWVjYAZgNNNhwMk_ZzhEesHvOsb5bhj0eGB2u9barV7ZhJV78bEPIgAM7QQV9VdaOyMYlKaig4Q6b0k97df3ak0MSd&__tn__=%2CO%2CP-R,10,0,positive,10
pfbid0z2XLPX2SGWd7pbPcQMTqMkoN4v2QPZrmzBSDBgeQibA4RqqXpYmFXwStDhUnvhopl,NVIDIA AI,0,9,0,0,1,0,0,0,10,2,"Stay up-to-date on the most recent product releases, bug fixes, news, and more for NVIDIA Triton and NVIDIA TensorRT. https://nvda.ws/3cP6uRw",2022-12-02T00:00:00,[],https://external.fcai19-7.fna.fbcdn.net/emg1/v/t13/9445042165651605771?url=https%3A%2F%2Fwww.nvidia.com%2Fcontent%2Fdam%2Fen-zz%2FSolutions%2Fdeep-learning%2Fdeep-learning-ai%2Ftriton-tensorrt-newsletter%2Ftriton-og-100.jpg&fb_obo=1&utld=nvidia.com&stp=c0.5000x0.5000f_dst-jpg_flffffff_p500x261_q75&ccb=13-1&oh=06_AbGdGB8Ap80a6Sb0GAz7XpM7EOS2P0jJPJCh6WlUnUQLzA&oe=64E03240&_nc_sid=dbad39,https://www.facebook.com/NVIDIAAI/posts/pfbid0z2XLPX2SGWd7pbPcQMTqMkoN4v2QPZrmzBSDBgeQibA4RqqXpYmFXwStDhUnvhopl?__cft__[0]=AZW4g4HoRiFjotQ9KKSyzhwRctej6Z0UufOJ7bGVQ2EtfDAlqK2nNuHCxYJDg5cWsMUMfjpyQHkqVcculhYyC6RDPNZ4_aAiyF4SqovJ8m30MT1Eft4rhyCqkVy5E3Mpc_MtO29gbgui68elBz-nUBhSeR_KZDrqxmA0Msnax67k-oRQeLfT-fU480g7vPqAX_qGn4ZN06bjO3--eb5gB6zf&__tn__=%2CO%2CP-R,10,0,positive,10
pfbid02vNKx8WgB1fdohCvoBLCKmfsSnrtuEE2f2NYspKUcL7LSeV4Ej9DcaZqCuwtkiMbvl,NVIDIA AI,0,15,0,0,1,0,0,0,16,5,How do you begin developing machine learning security skills?Competitions offer a promising opportunity to gain exposure to the #MLsecurity field. https://nvda.ws/3ijtqee,2022-12-02T00:00:00,[],https://external.fcai19-7.fna.fbcdn.net/emg1/v/t13/7801825446977728606?url=https%3A%2F%2Fdeveloper-blogs.nvidia.com%2Fwp-content%2Fuploads%2F2022%2F11%2Fimage3-2.jpg&fb_obo=1&utld=nvidia.com&stp=c0.5000x0.5000f_dst-jpg_flffffff_p500x261_q75&ccb=13-1&oh=06_AbF0xxE7zY62YSKK9KPDZ71ndU-mLmIPMiaiI_BducDzzA&oe=64E028CE&_nc_sid=dbad39,https://www.facebook.com/NVIDIAAI/posts/pfbid02vNKx8WgB1fdohCvoBLCKmfsSnrtuEE2f2NYspKUcL7LSeV4Ej9DcaZqCuwtkiMbvl?__cft__[0]=AZXMDh0JLYsVJ8CTpQAEKD4tQ6dpTchPfX0FOF4_FQQL5Z_0PwVQ7kT8hgsFsbbKIsQVR4KnCPpPC2HMvNkpSrLycKEMzA5Vxvcw4rN4dTmbb3NSPCOZ9EO-bB9TkM11Z_3nE9AYKKLVlcOucuDvJQRc_iJdOdgx2mEG6aHix_TVsbElYzyvkgEhzOXp5TF-o0gljhrrfkS81iBLO-XsTjru&__tn__=%2CO%2CP-R,16,0,positive,16
pfbid036Lhn2c7VpVMbe9R6gTQq2wYKT7GUrjKooW8vRnmp4Xx1YTva5RUhLesA2nd3i6UNl,NVIDIA AI,0,12,1,0,2,0,0,0,15,0,"On December 8 at Gartner IT IOCS, Charlie Boyle, VP of #NVIDIADGX Systems, will speak about how #IT can deliver more #AI applications and help businesses achieve a faster ROI on AI investments. Check out his talk (session SPS49) at Venetian F, Level 2. Register now: https://nvda.ws/3UzUHH3",2022-12-01T00:00:00,[],https://scontent.fcai19-7.fna.fbcdn.net/v/t39.30808-6/317634480_1299893970786263_9061743018550827464_n.jpg?stp=dst-jpg_p526x296&_nc_cat=107&ccb=1-7&_nc_sid=9267fe&_nc_ohc=rxTtQO1ow28AX9STRcb&_nc_oc=AQmJAZWL8hMO95NoJOxVdf0r1v9B1x07uG85MNe4e7huJqHuqP3trghYH0vxDKDG47g&_nc_ht=scontent.fcai19-7.fna&oh=00_AfB02HBINpZyxHLvzd_mUQIIdpeY-3aSoVDrVin0avp4kA&oe=64E46007,https://www.facebook.com/NVIDIAAI/posts/pfbid036Lhn2c7VpVMbe9R6gTQq2wYKT7GUrjKooW8vRnmp4Xx1YTva5RUhLesA2nd3i6UNl?__cft__[0]=AZXRoEzz2-ExrtxC1rcJewDDPsvNtGXYzv8vkDqVXB2jMDCvhNsIDSyZCDB16wpnIiJ4jGtpibcH90rGX8RO3gTbAZkE87tFLa6M_eZBsDQNSrRzA5sy7BWh8b6BGmt_bA-u274eMUifRtzZfSDYEiAAQdgDr3IOsnv0gILfK7j4PU50i71jCx4TlTk7JM0ToK4tDB3NHEo9VOdc74kNbtL5EmtT-NCWXpjNvJBhyIJkjQarbv74iv6QVyaGWsjBQ84xE9YA5B7yRF1qLu2K9WPf&__tn__=%2CO%2CP-R,15,0,positive,15
pfbid02YXbhYXsB1r1Ff4jmfFMcmXAJDgvUPT7gyhkCVa2EJAgy6b5wby8Mbm2Hpxdm9xB7l,NVIDIA AI,0,12,0,0,2,0,0,0,14,1,The benefits of using pull requests are numerous and make collaborating on code easier. Here's why you should use pull requests and how to best utilize them within your coding environment: https://nvda.ws/3VnvCAg,2022-12-01T00:00:00,[],https://external.fcai19-7.fna.fbcdn.net/emg1/v/t13/8223195771805122713?url=https%3A%2F%2Fdeveloper-blogs.nvidia.com%2Fwp-content%2Fuploads%2F2022%2F11%2Fai-for-dev-devnews-best-practices-blog-1920x1080-1.jpg&fb_obo=1&utld=nvidia.com&stp=c0.5000x0.5000f_dst-jpg_flffffff_p500x261_q75&ccb=13-1&oh=06_AbENHKmiqBbPvtqnMOE0-jV-IeW1FXkVxXqaHcC7qE-muA&oe=64E071D2&_nc_sid=dbad39,https://www.facebook.com/NVIDIAAI/posts/pfbid02YXbhYXsB1r1Ff4jmfFMcmXAJDgvUPT7gyhkCVa2EJAgy6b5wby8Mbm2Hpxdm9xB7l?__cft__[0]=AZUgjSiVFnWf1AMYskQWhjV_1dUzzMeRp5t8hhRUi5OjM7poC8gsSUHOdSbw-5WpvBe7ERcVAk1OAgipuHJtX6QsyUZyrWTstJMHT8yxBDbOH23v9HJLwwU96VtL8E-12E38crhQ5IVZUgoEszZK10yJ5JsvksDlimkh7yNgsVW_xc2D0aCbg7HoqjJXcgVcO0merMsXGxkuTRjnIEX2uJDT&__tn__=%2CO%2CP-R,14,0,positive,14
pfbid02iuvbj4mHVUQDp8S6Rr2uaw6HJ8TCNGnNryCwnHqoDCR5PsDDxMBAvFR7AioXuM5l,NVIDIA AI,0,11,0,0,2,0,0,0,13,4,New technical workshop: Data Parallelism: How to Train Deep Learning Models on Multiple GPUsLearn how to decrease model training time while retaining the accuracy of training in this instructor-led workshop.https://nvda.ws/3GTHUff,2022-12-01T00:00:00,[],https://external.fcai19-7.fna.fbcdn.net/emg1/v/t13/14477775682929453886?url=https%3A%2F%2Fwww.nvidia.com%2Fcontent%2Fdam%2Fen-zz%2FSolutions%2Ftraining%2Finstructor-led-workshops%2FModel-parallelism-neural-network-og.jpg&fb_obo=1&utld=nvidia.com&stp=c0.5000x0.5000f_dst-jpg_flffffff_p500x261_q75&ccb=13-1&oh=06_AbFMKEZr6d_zbppA85kDubK6JQefT8hVh935yGKXQ4SH0w&oe=64E07EF2&_nc_sid=dbad39,https://www.facebook.com/NVIDIAAI/posts/pfbid02iuvbj4mHVUQDp8S6Rr2uaw6HJ8TCNGnNryCwnHqoDCR5PsDDxMBAvFR7AioXuM5l?__cft__[0]=AZUxG6GYqjOnZBqfWl5AW42q0AT8zRddu6wlF3LPsyZxTHHIi_izDjVhjA4erDTbAKJu-jq7OCClOr4juKXmwoMghI1T7Cg72dGRUO06VgOjms5L2fbRQIPfsCd5IK5fP-ZRqZl7tXDsbEVGsN5y6ZWhkfY76O2Mg9iU1VD2Bs6ijjyCPLaySrSSF8JOBsbrNYSJFPqVIW8T4vWMq4IjLUUa&__tn__=%2CO%2CP-R,13,0,positive,13
1085645812101687,NVIDIA AI,0,14,0,0,2,0,0,0,16,1,Join us on 12/13 to discover how #NVIDIAInception can help your #startup build its solutions and get a brief overview of #NVIDIAClara. Ask the experts: https://nvda.ws/3XH1r8E #AI #innovation #startupecosytem #inception,2022-12-01T00:00:00,[],https://scontent.fcai19-7.fna.fbcdn.net/v/t39.30808-6/317599941_1085645808768354_637017234956840024_n.jpg?stp=dst-jpg_p180x540&_nc_cat=105&ccb=1-7&_nc_sid=9267fe&_nc_ohc=Zbj__iKp_EkAX_q3khC&_nc_ht=scontent.fcai19-7.fna&oh=00_AfCsL1xr_sPw0fLOLvirzEdukEk9OEAkV2qAcsYRCd-hsg&oe=64E49C59,https://www.facebook.com/NVIDIAAI/photos/a.119492422050369/1085645812101687/?__cft__[0]=AZVCmIs6LM_gL9ySJ0xyQaTBVdoN-WQeaiX5NAIr4KT0fEelPYoSzMVPFpgKXBAtW2PHG_rtqoJoIbRqO5-KI1dnQNWIwDQgvVA0z90YYtc5yOuICRVnk0L0OaMZFdtwyJjV_VdFKDuVHZ3IqiQJd4C2il20Yxeo5cFlDlUuy-18CaqgnBTmCUR0ICcrW5EQnLSkGb86xLOwWatVStI2RE8-&__tn__=%2CO%2CP-R,16,0,positive,16
pfbid0MDMdjvZbsZguX5jZNLBE4aGSo8iLYciMBrm1T4t8DSU3HTdwuw7pBM514UsYsJXsl,NVIDIA AI,0,8,0,0,2,0,0,0,10,0,Self-driving cars generate a lot of data that needs to be processed and mined quickly. Check out this blog to see how electric vehicle manufacturer NIO  integrated NVIDIA Triton Inference Server into their autonomous driving inference pipeline to achieve a low latency #inference workflow. https://nvda.ws/3UpSv4C,2022-11-30T00:00:00,[],https://external.fcai19-7.fna.fbcdn.net/emg1/v/t13/12123153076516737624?url=https%3A%2F%2Fdeveloper-blogs.nvidia.com%2Fwp-content%2Fuploads%2F2022%2F11%2Fimage1-2.jpg&fb_obo=1&utld=nvidia.com&stp=c0.5000x0.5000f_dst-jpg_flffffff_p500x261_q75&ccb=13-1&oh=06_AbFHgCMQecZsXaQM8hfPhhscrLMpXFQWzLI52SusWWknjg&oe=64E08DFC&_nc_sid=dbad39,https://www.facebook.com/NVIDIAAI/posts/pfbid0MDMdjvZbsZguX5jZNLBE4aGSo8iLYciMBrm1T4t8DSU3HTdwuw7pBM514UsYsJXsl?__cft__[0]=AZXi0zUHL-4TXyWub85kIZXp8CZXsZf_YyAJ2aF9w5em0jUfhULe0iX9jgOkLApPS92ey-ofS-BJOOoBBVgDM4IGxmlZyuX4_YT1O6hCqpWfhTl7jxuxK6RDQaBrkkHIUr8Td7k0v4I6lCyd26grVpVoU7oy3_tsrRmQ5QMVoFFlz2DpFqnnFN6xsREc15OH94MvNDPnPb8sXIBiehGTVn1n&__tn__=%2CO%2CP-R,10,0,positive,10
pfbid0DXn9u3F88JeajAop9v8NdBfBU7ZBUUfnmQ1Wi9N4eEDLgWnwqovkYFkK5uL6akmAl,NVIDIA AI,0,9,0,0,1,0,0,0,10,4,Want to avoid the common pitfalls of deploying an #edge AI solution?Read the #IT manager’s guide for successful deployment now: https://nvda.ws/3ikFmfT,2022-11-30T00:00:00,[],https://external.fcai19-7.fna.fbcdn.net/emg1/v/t13/6062570282756209758?url=https%3A%2F%2Fdeveloper-blogs.nvidia.com%2Fwp-content%2Fuploads%2F2022%2F11%2Fimage1-4.jpg&fb_obo=1&utld=nvidia.com&stp=c0.5000x0.5000f_dst-jpg_flffffff_p500x261_q75&ccb=13-1&oh=06_AbGjbFmwa2Lbms4tZ6ZT28x2crZsN14y2EXPFOXQscFntQ&oe=64E05815&_nc_sid=dbad39,https://www.facebook.com/NVIDIAAI/posts/pfbid0DXn9u3F88JeajAop9v8NdBfBU7ZBUUfnmQ1Wi9N4eEDLgWnwqovkYFkK5uL6akmAl?__cft__[0]=AZXEORDBixf12Ok-hioiFp5IZIpIP2lOeHouwPIc7WxLP-yPxaRCBRjJs9RnI2-6Wq_LRHMtmAz4CqOITfPFGG_vKAaLQMEj2tovbqSvuvMjYdKbJIGijnqD3EjGvkI-sO1MQ-s000kjg2BdoANw4rFCeZ5Lj7t4c4jQLpV5VIn_Lt1dsmQ7rZEaZL-Y82yQRgDm7YCnSziguVJltD4sjknV&__tn__=%2CO%2CP-R,10,0,positive,10
pfbid02sPZF6f3cVbxRTyZR8Btmwv7r1YTFvUd7QUpQ7sraHM6pztbXiExQC7ppjdZDQooVl,NVIDIA AI,0,10,0,0,2,0,0,0,12,0,"Next week, join us at Gartner #IT IOCS to learn how NVIDIA is transforming enterprises with industry-leading #AI platforms built on #NVIDIADGX systems and enter… See more",2022-11-30T00:00:00,[],https://scontent.fcai19-7.fna.fbcdn.net/v/t39.30808-6/316531070_1298522767590050_4728247215044906722_n.jpg?stp=dst-jpg_p526x296&_nc_cat=111&ccb=1-7&_nc_sid=9267fe&_nc_ohc=COzwNPf4g0oAX92TiWW&_nc_ht=scontent.fcai19-7.fna&oh=00_AfDYrC3ILc086kcdmMuDnDr-DQNipvvpUIGQeXNnus8-7w&oe=64E331A7,https://www.facebook.com/NVIDIAAI/posts/pfbid02sPZF6f3cVbxRTyZR8Btmwv7r1YTFvUd7QUpQ7sraHM6pztbXiExQC7ppjdZDQooVl?__cft__[0]=AZWU8zqnwZ-0RrcL3h25TjTS2rLLhSPSfcGWhqijw_bH-h_c3Zvg8fZxh781drUj_y7RQVFcCziOeFCTd_nsnFwLvScjSlOCIt4ehruZlBW1dUttoYT5EqCVX8Z58dR7XOMwJ84Nh5pNTBvlObFthVSpZ8phiNx7PvYtkmAcyH_J5b3yXIVT5d8IENCtPvPThAFfSKoYego3OEYljC8SyDY1LVx-gr7Pv0w0uuoFfAtYkjO_i1fNY4reuQqNuScO9uclp42aOqpWmm3URLh9evTB&__tn__=%2CO%2CP-R,12,0,positive,12
1085298512136417,NVIDIA AI,0,14,1,0,2,0,0,0,17,0,"#NVIDIAInception member Qubit Pharmaceuticals is identifying treatments for incurable diseases, while reducing the time and investment needed by adopting hybrid #quantumcomputing. https://nvda.ws/3u9aRMv",2022-11-30T00:00:00,[],https://scontent.fcai19-7.fna.fbcdn.net/v/t39.30808-6/317631254_1085298508803084_8509877220028813796_n.jpg?stp=dst-jpg_s960x960&_nc_cat=101&ccb=1-7&_nc_sid=9267fe&_nc_ohc=B34GR0qwMowAX_WCy86&_nc_ht=scontent.fcai19-7.fna&oh=00_AfDLslejgII3WB-AiCa8lNWF_3I5XlxwfvnEaYN1AFRPVw&oe=64E3170F,https://www.facebook.com/NVIDIAAI/photos/a.119492422050369/1085298512136417/?__cft__[0]=AZUB1hdQ3YXgUTuXBQga3iiJWzO_f_QTZotBbRt-puj714T_iutw1b7GgL6McLLHEKbrTfUNAB_K7kOxeYE2-ZHD2GtsLIeHasS9FTm_jDSzvuE2NotGkPtlw0do7CjJGmwFH4D6jX-cKA5cMuEdGDJeuufhhGZAaZtXOZqJ9C4VnxPfb1RudadPPDmpRKUVfbza6v-vNpqitxWEhzFjXuqt&__tn__=%2CO%2CP-R,17,0,positive,17
1084865628846372,NVIDIA AI,0,13,1,0,2,0,0,0,16,2,Check out this Wall Street Journal article that shares why #AI needs to be a retail #supplychain priority. https://nvda.ws/3VgH7ct,2022-11-30T00:00:00,[],https://scontent.fcai19-7.fna.fbcdn.net/v/t39.30808-6/317403190_1084865618846373_6265512674868267850_n.jpg?stp=dst-jpg_p526x296&_nc_cat=106&ccb=1-7&_nc_sid=9267fe&_nc_ohc=r9UuLuMRuw0AX-Gl4CN&_nc_ht=scontent.fcai19-7.fna&oh=00_AfB_GOZa-iOzsL6teHnjTUHe48wmwIbuyBdc3D2f34pJNg&oe=64E36A87,https://www.facebook.com/NVIDIAAI/photos/a.119492422050369/1084865628846372/?__cft__[0]=AZUk1RRgr1O8RkJW3TvjAooV1fPV9khxyJJjfRfcR3gUd_D0yEb7PK9FksnleDAgmEschF__MpTgcI_ZCdAf_0O87LGiSlGsxHslw5mfuDMY-hKgMSORHP42NmIzQJ9-v_14Xcedc9y634w3ypyMbfy7gR0fsIHwLPmZ6NJz_YxTRqE9grprDTSpX_S-xNleILlX3a_Thqgee3iNIo3n3lX4&__tn__=%2CO%2CP-R,16,0,positive,16
1084815555518046,NVIDIA AI,0,7,0,0,2,0,0,0,9,0,Learn about the free RAPIDS platform for accelerated data science and how #NVIDIAInception partners are doing to accelerate their business with #RAPIDS. Register now: https://nvda.ws/3XCJd8i,2022-11-29T00:00:00,[],https://scontent.fcai19-7.fna.fbcdn.net/v/t39.30808-6/317690490_1084815548851380_1600814511863775755_n.jpg?stp=dst-jpg_p526x296&_nc_cat=104&ccb=1-7&_nc_sid=9267fe&_nc_ohc=CXdAC1gsDIIAX80u1ik&_nc_ht=scontent.fcai19-7.fna&oh=00_AfDRlZ7h03lL2OPZ3QYxE_QMg3V96JDUywxjOhplCcoGgg&oe=64E32ADE,https://www.facebook.com/NVIDIAAI/photos/a.119492422050369/1084815555518046/?__cft__[0]=AZXzRnnd1uQkgQscK4jw--oJmyL5c8wjuAE-MoR48c490il5d0BFLKnCb3YhVxRAo9lZDAIgfkFuyw13nUbzH55e0CjlGP9_wnqIeXh7HNmQ0IQ0SPgJmC-fv446xgxiZln3_Yk9TbHuPoeNi0OVXZHLUEC541-2UYGLQf1DOGsGwGZKJYTR4Z-E_w7IoYOSur0DVgTnn8b1wIjM-b5cMAZa&__tn__=%2CO%2CP-R,9,0,positive,9
1084742388858696,NVIDIA AI,0,11,0,0,2,0,0,0,13,1,"Now students can design and develop models and apps for #deeplearning, #machinelearning, data analytics, and graph analytics from Windows 11, powered by NVIDIA GeForce RTX GPUs. Learn more: https://nvda.ws/3gxM81k",2022-11-29T00:00:00,[],https://scontent.fcai19-7.fna.fbcdn.net/v/t39.30808-6/317379741_1084742385525363_141269671622841934_n.jpg?stp=dst-jpg_p180x540&_nc_cat=104&ccb=1-7&_nc_sid=9267fe&_nc_ohc=8y6z7v3EisQAX9B5oFb&_nc_ht=scontent.fcai19-7.fna&oh=00_AfBMcfluH2IyMIEueu7Fe4pU-3smX4E__D5w509g8I4_GQ&oe=64E40E77,https://www.facebook.com/NVIDIAAI/photos/a.119492422050369/1084742388858696/?__cft__[0]=AZWKy7392-Jdx2GpN2-MUzVSa5FU_qomih0c-_R-A_1o5_2LPl3AKCi4T0onO8BN8LB18-cZ9RfhlrNq-vsL9-xJkgt-n7wOyaFRHH7QlpyXs-xUXGskD6Uz3S2qghj_hIhJwdrkJ5_1SgG4PNO1fq1XwiPZpY2iQfZjPeqvwj25_jipYXcpAPo041mvNMdPFBkuWsRJOt78-XJoTTzAoazU&__tn__=%2CO%2CP-R,13,0,positive,13
1084712572195011,NVIDIA AI,0,5,0,0,2,0,0,0,7,0,"Using #AI, insurers can identify risks, prevent fraud, and accelerate #insurance claims processing workflows. Learn more from Quantiphi and NVIDIA on December 1st at 8 AM PT. Register now: https://nvda.ws/3OsUgN4",2022-11-29T00:00:00,[],https://scontent.fcai19-7.fna.fbcdn.net/v/t39.30808-6/317087381_1084712568861678_5011203486472157851_n.jpg?stp=dst-jpg_p526x296&_nc_cat=103&ccb=1-7&_nc_sid=9267fe&_nc_ohc=ILbkg7fO8U8AX--9NCu&_nc_oc=AQmfXGe_-AT8MX0M4Gu5F6caBiMADw2a1aB65Tt0G1_JpT9IZu2OaXbIiPr8Wqq9_Og&_nc_ht=scontent.fcai19-7.fna&oh=00_AfBaVTz9bYBpIyrlLQ--eFtieNm8-rFEivMQyD4iG-iSWw&oe=64E344F5,https://www.facebook.com/NVIDIAAI/photos/a.119492422050369/1084712572195011/?__cft__[0]=AZW_UmjAS0UrSah4vsWUwwRHzK7fo2sJsxC8VM-ysWGSNfXTWzoMBx59FzZK3NP2uLSaM-PjP7pfecPMetcxQ0rufg2nOVG2v2QVnpbiD-pj9IOfdeMiLU7wtJNDJKck7_2GMQOybB3rNmIOCb96pHDy3s5VJwM-R-WzzFbvXXeYT714YHVYC6OmBlUL5t9GOYMvB6ZmTisSr5AOV6BLmN-B&__tn__=%2CO%2CP-R,7,0,positive,7
1084438992222369,NVIDIA AI,0,14,0,0,2,0,0,0,16,0,Curious to know how NVIDIA is supporting #startups across the globe? Join the #NVIDIAInception open house session and learn about NVIDIA Clara's latest features for the #healthcare industry. Register now: https://nvda.ws/3Vdf8us#developers #AI #NVIDIAClara,2022-11-29T00:00:00,[],https://scontent.fcai19-7.fna.fbcdn.net/v/t39.30808-6/316959888_1084438988889036_6909594970115330628_n.jpg?stp=dst-jpg_p526x296&_nc_cat=108&ccb=1-7&_nc_sid=9267fe&_nc_ohc=WPx-9LrN7xYAX-WJKpT&_nc_ht=scontent.fcai19-7.fna&oh=00_AfA-xoy3mk-chO2AWSagjF4aesvDlmuGZzBCUylkwr5xfg&oe=64E472E8,https://www.facebook.com/NVIDIAAI/photos/a.119492422050369/1084438992222369/?__cft__[0]=AZUZhGPYRIvQd0QRxUCl1bsaKeYao-FrlTAHuRiY9-dscvR1xHdCtQq3wc2T5GQgGF3wxS9YWyxxTEiKXB1fNnrTbg5flvdrUHifBK72QCMWmC93JXBdRV0B5_2MR-TJUUn3gOZQucceHfgECAdlyiZrKkCM4YjibmdPVbgXxbTSkeMm7hcmEsUPWGNvbY_dkDMTYy5C-UDnztLbKgIlz4j_&__tn__=%2CO%2CP-R,16,0,positive,16
pfbid02tnNZosBwKyFHzCjuDrCzRnSLxHqdeLz8pZEm8WDTaq84EiK9kFZNgTQKKcnwLPFql,NVIDIA AI,0,9,3,0,2,0,0,0,14,0,Mass General Brigham will be among the first to accelerate end-to-end AI model development and deployment in clinical workflows using #MONAI and #NuancePIN. #RSNA22 Read the press release: https://nvda.ws/3F6RgmA,2022-11-28T00:00:00,[],https://scontent.fcai19-7.fna.fbcdn.net/v/t39.30808-6/316254495_1084200372246231_5740725472993715065_n.jpg?stp=dst-jpg_s960x960&_nc_cat=107&ccb=1-7&_nc_sid=9267fe&_nc_ohc=7pzYmMwH4D8AX_NHfUO&_nc_ht=scontent.fcai19-7.fna&oh=00_AfDQzKd4zmjVTU_B_FBQyT9GCtrRJrMNWCQckf3v1P1nUg&oe=64E44209,https://www.facebook.com/NVIDIAAI/posts/pfbid02tnNZosBwKyFHzCjuDrCzRnSLxHqdeLz8pZEm8WDTaq84EiK9kFZNgTQKKcnwLPFql?__cft__[0]=AZXGp8MA-spNZu1VB600ocgi8SU9M6GtvVbFXfhmkvaN3aatp_wHIlE7jB84gQfhJ40TBKCNodDlfxd5mZlO8nT-9DfRHhv9qCGQDaKhmVgrxHi_j9TkMD0z7d9dndJrCIKP6A_pJ-oLZX8IRyQtAo4EQ3mr5lb2jHqKSd2e3bHEZqTk5GAgDaVG_vjBKq_Q86ZEh9s5tbeMiNv0hTarNIEgv4Yea6hME7Vpz24vp9HhV0Ch0yNPogAwz_p2aYL35_8&__tn__=%2CO%2CP-R,14,0,positive,14
pfbid0iEoBa9aBtNXGH4sYM2eX77f3vWyYnquFQXU4EYhfCHrn4jjFFMCFPGJvXnPKjMwvl,NVIDIA AI,0,8,0,0,1,0,0,0,9,0,Interested in quickly building medical #AI applications? Read this blog to learn how to turn trained models into #MONAI application packages for clinical deployment with a few lines of code in under 20 minutes. https://nvda.ws/3XIukRJ,2022-11-28T00:00:00,[],https://external.fcai19-7.fna.fbcdn.net/emg1/v/t13/8356462943856123336?url=https%3A%2F%2Fdeveloper-blogs.nvidia.com%2Fwp-content%2Fuploads%2F2022%2F11%2FMONAI-Tech-Blog-Image-1600x900-1.jpg&fb_obo=1&utld=nvidia.com&stp=c0.5000x0.5000f_dst-jpg_flffffff_p500x261_q75&ccb=13-1&oh=06_AbH9udx6NWbF5--d8eo2mLcZUQkvOT0I_PuauROQ4HvoeA&oe=64E0B828&_nc_sid=dbad39,https://www.facebook.com/NVIDIAAI/posts/pfbid0iEoBa9aBtNXGH4sYM2eX77f3vWyYnquFQXU4EYhfCHrn4jjFFMCFPGJvXnPKjMwvl?__cft__[0]=AZUnaC2cfGCLCpI6hAGSw5wxOVxD0UyV-7L-lnHqAVMflN9SlewFB_-EdFCR4XkzWueF03ijCMm0v-INWEkfZgIDYWYVYQYDq_ChYkwdGFqHRQDs-_BqabalHlLMFfLmYDpooMtFB6-bQASzOJs76xZM_yw1bajn_qNhpef7k-_rF3zG8akDBdZAChpVe9f8f9pAlESLDy-w7aJnhfMuiJrx&__tn__=%2CO%2CP-R,9,0,positive,9
pfbid0HTUxUqWKcd22qaibTye8tVFrw12D9Y4X4wEhAofxWfgu8YysPtU5a1cvxXDiVbAWl,NVIDIA AI,20,183,13,0,18,0,0,0,214,26,"NVIDIA partners with NHS Trust to deploy the MONAI-based AIDE platform across four of its hospitals, providing AI-enabled disease-detection tools to healthcare professionals. #MONAI #RSNA22 Learn More: https://nvda.ws/3XR7K9V",2022-11-28T00:00:00,[],https://scontent.fcai19-7.fna.fbcdn.net/v/t45.1600-4/316986198_6293503752558_3561080143300055533_n.jpg?stp=cp0_dst-jpg_q75_s526x296_spS444&_nc_cat=101&ccb=1-7&_nc_sid=67cdda&_nc_ohc=SHYDs8DbPzQAX9CRXv4&_nc_ht=scontent.fcai19-7.fna&oh=00_AfAqrJcdppDBnrePuVP6FZIBYclb_g6K91XIdvNSHYLS1g&oe=64E2F236,https://www.facebook.com/NVIDIAAI/posts/pfbid0HTUxUqWKcd22qaibTye8tVFrw12D9Y4X4wEhAofxWfgu8YysPtU5a1cvxXDiVbAWl?__cft__[0]=AZXwH8VUmEChM-GaqyPAIEUDHo2WtUui6GR0k1RV_vrgAAc-TX3Fo6BhmO9AenkCntg-iFxkyvCgw1lhisk80AUs2mHhJRbZa1ARMHFfQkq9teYsp7Js6gF3s2Y3HZnHNfi4IZ1eapCKmk2uvevkfzFODyStUggWqC1Ndw3yuiitFC5x7WnHuM-UzvY3gFPWUSen3pjkU-jq3KLg7uBZF0fe&__tn__=%2CO%2CP-R,234,0,positive,234
pfbid0z95MvSfp8XjzkPt2GuznLE8VNr3pq1cy4vS4eetCh8UmdgdpAUTHi3EDNRsTx5r2l,NVIDIA AI,10,137,9,0,11,0,0,0,157,13,Learn how members of the #medicalimaging community are adopting #MONAI Deploy by integrating AI models into clinical workflows and turning research breakthroughs into clinical impact. Read More: https://nvda.ws/3u8dqP6,2022-11-28T00:00:00,[],https://scontent.fcai19-7.fna.fbcdn.net/v/t45.1600-4/315502480_6293504149158_4219643991465677406_n.jpg?stp=cp0_dst-jpg_q75_s526x296_spS444&_nc_cat=103&ccb=1-7&_nc_sid=67cdda&_nc_ohc=9LePyb9QiG8AX8gLXep&_nc_ht=scontent.fcai19-7.fna&oh=00_AfBTI4n_dQU-LC1TVLocX-6g8YwoCbL5E3tQ8zBgyqhMsQ&oe=64E3B086,https://www.facebook.com/NVIDIAAI/posts/pfbid0z95MvSfp8XjzkPt2GuznLE8VNr3pq1cy4vS4eetCh8UmdgdpAUTHi3EDNRsTx5r2l?__cft__[0]=AZXInSlbak5N51AeigqG77SC-bM2mrFt8KqGpBmrcIr1N8WcjA7V25Etx2GM9u6TuaJ1p0pc0g8MUp-O4qKazaYLljwrg49ACv1odbm5TlQ6GfZxEtYsNAfdsBF81Mou4V3zOrTdZdtAAeYPvkz6_sHvitMeryaA_NmcnXz9VuITa3_79W0TRQjxbG_bJYy-VT3reTMjZ4wjCaTa5iR1kBur&__tn__=%2CO%2CP-R,167,0,positive,167
pfbid0F84ZoXdnSMXJj85CyrKgaPn96DZVbEf9JTWVNP2cZwcMqpQM6fa5Tjp1mF4AyrZhl,NVIDIA AI,0,14,0,0,1,0,0,0,15,1,AI is changing how enterprises manage #edge applications.Read this blog to learn the four fundamental differences between the way traditional enterprise software and #AI applications at the edge are designed and managed. https://nvda.ws/3Er9xJF,2022-11-23T00:00:00,[],https://external.fcai19-7.fna.fbcdn.net/emg1/v/t13/10489812689198668738?url=https%3A%2F%2Fdeveloper-blogs.nvidia.com%2Fwp-content%2Fuploads%2F2022%2F06%2FAI-infrastructure-edge-ai-v005.png&fb_obo=1&utld=nvidia.com&stp=c0.5000x0.5000f_dst-jpg_flffffff_p500x261_q75&ccb=13-1&oh=06_AbGOGQxU5SrST6CpCUQjg_MdVUu7StfDs5TgCzoofdcLPw&oe=64E01579&_nc_sid=dbad39,https://www.facebook.com/NVIDIAAI/posts/pfbid0F84ZoXdnSMXJj85CyrKgaPn96DZVbEf9JTWVNP2cZwcMqpQM6fa5Tjp1mF4AyrZhl?__cft__[0]=AZWgIstrJ70NmkHirhm9yk7XdTeASsY8DDl6V5XiD7GNleeZ5ficVk30eBAnT6ROyUKqCjKfs7Ij3NvChniDeC3cncsPjA9qLDJ8UIjzR67Y8tN3QwiKFT_h7J8CoolFqtVWNb6xPX0nsQkTt6lFt1pG-lh_x9XJPsu5XsCVJscXQIFGo_AEcO8-vxMXSy_MzmY9zIdOHoXdICogT-aE7uKD&__tn__=%2CO%2CP-R,15,0,positive,15
pfbid074RadhrqAAR1B8gdC6QPKWrmRbvrwBwVoAC2LTR2u3hxzocvQBurxxB43xHyK1oSl,NVIDIA AI,0,12,0,0,1,0,0,0,13,2,"Discover how by relying on data-driven insights, including #MachineLearning models and AI-powered medical devices, #smarthospital can enhance the work of healthcare professionals and hospital management, resulting in a better and faster care. https://nvda.ws/3XnRj4p",2022-11-23T00:00:00,[],https://external.fcai19-7.fna.fbcdn.net/emg1/v/t13/10944231121088749731?url=https%3A%2F%2Fblogs.nvidia.com%2Fwp-content%2Fuploads%2F2022%2F11%2FProximie-1.jpg&fb_obo=1&utld=nvidia.com&stp=c0.5000x0.5000f_dst-jpg_flffffff_p500x261_q75&ccb=13-1&oh=06_AbGP_eUu4K-QdT6gGez3JHjDcnfoT1KrGhLuEfmETSFtQQ&oe=64E03349&_nc_sid=dbad39,https://www.facebook.com/NVIDIAAI/posts/pfbid074RadhrqAAR1B8gdC6QPKWrmRbvrwBwVoAC2LTR2u3hxzocvQBurxxB43xHyK1oSl?__cft__[0]=AZX9jB8nz9rtsUyncWfKjLfz0RgQmXv_j8nlZ64oJha0MobUbbA-yMewEW6wTEG8wKkYpVlg2nFRYdDa0NC_t6igStiqnz2_qB02FfxqCko_YLk54MVengfTz-Uwv3ra8_UQN1pWl8HhJrMlQ0zgruJOlrG_JLgP1jwArv7NZhX7oIi98xI5yc1nmLMZJYLV-28qFYNzTlqvT7pkpjpFasEo&__tn__=%2CO%2CP-R,13,0,positive,13
1080618292604439,NVIDIA AI,0,28,2,0,0,0,0,0,30,6,"SMU recently upgraded its supercomputer, based on NVIDIA DGX SuperPOD™, to accelerate #HPC and #AI research in physics, chemistry, biology, and beyond. Watch the behind-the-scenes tour: https://nvda.ws/3AEAOY9",2022-11-23T00:00:00,[],https://scontent.fcai19-7.fna.fbcdn.net/v/t39.30808-6/316667782_1080618289271106_2148515182868030625_n.jpg?stp=dst-jpg_s960x960&_nc_cat=108&ccb=1-7&_nc_sid=9267fe&_nc_ohc=bBbZbA0MqqEAX_EzWYI&_nc_ht=scontent.fcai19-7.fna&oh=00_AfAhVMK8OG-yZSgsh9bWEdRWb1uB_L7EwYn-qz4Nx5DQRw&oe=64E470D0,https://www.facebook.com/NVIDIAAI/photos/a.119492422050369/1080618292604439/?__cft__[0]=AZUs2TtZe9kfMEpNHAPKWh7wZb6Hc7DCJTw5OQTq1z-bw4KMkyT0vsfOrmAb5r_a8MwH79GWORtRHjU0Uy2TbUemczAuF8HHmGg3Cd_l6oZfpnD9Cksr4o5gJkYBfUR0V8fLYo0LHd7ALxmGAOA3J7zjT9olXE8otSkgMY10etDdo-Ws1wseynD7aODH39F-tzNTvQSjv6Hkw4TH-GxsToeK&__tn__=%2CO%2CP-R,30,0,positive,30
pfbid02C3HSgYEZGLjPNyvpScoX8EoXzwQXfUwg5tbp3xSZ2wSnpt6QFUFdCnqWvL4Y9Rd8l,NVIDIA AI,0,17,0,0,1,0,0,0,18,2,"Imagine being able to have your regular car drive off to park itself! Seoul Robotics, a partner of #NVIDIAInception and #NVIDIAMetropolis, introduces their Level 5 Control Tower! Powered by NVIDIA Jetson AGX Orin, their system is capable of turning non-autonomous cars into self-driving vehicles! Learn more: https://nvda.ws/3Aq5KeJ",2022-11-23T00:00:00,[],https://external.fcai19-7.fna.fbcdn.net/emg1/v/t13/18403367335995968435?url=https%3A%2F%2Fblogs.nvidia.com%2Fwp-content%2Fuploads%2F2022%2F08%2Fseoul-robotics-feature-image.jpg&fb_obo=1&utld=nvidia.com&stp=c0.5000x0.5000f_dst-jpg_flffffff_p500x261_q75&ccb=13-1&oh=06_AbEgxu7aOlCC-RZmpY1WzLHUWWlDhaHhPTtOUhMsxAG-DQ&oe=64E02652&_nc_sid=dbad39,https://www.facebook.com/NVIDIAAI/posts/pfbid02C3HSgYEZGLjPNyvpScoX8EoXzwQXfUwg5tbp3xSZ2wSnpt6QFUFdCnqWvL4Y9Rd8l?__cft__[0]=AZUawjIdFBs-SJYGe6wLN5qV5RBZtOYN05PKPqwQ7bi_aMq2-VlQY_3y2jWgrgvBf1lc4yibpLCrpJDmotcLhylZeadssGxTetqtRAFQ-sI1qi9KVXGfo0F7C0dTRnr_xGItQH1XiuG-MxVDbDmwXNueigB9Lv_zrk4y3EDtbnO2jOU7YWdW49El7GXTOhlORv7mRbOn-v6bdSux6Lq7cDdV&__tn__=%2CO%2CP-R,18,0,positive,18
pfbid0h7i1RMkWacDAvFti265vBQPN7jm27CW3LP23KontE6UJzS2kQmfQJFcVijYUMhJcl,NVIDIA AI,3,9,0,0,1,0,0,0,10,1,"Congratulations for winning  Outstanding Paper at #NeurIPS2022 for MineDojo, a framework for generalist #AI agents. Linxi Fan, Guanzhi Wang, Yunfan Jiang, Ajay Mandlekar, Yuncong Yang, Haoyi Zhu, Andrew Tang, De-An Huang, Yuke Zhu, Anima Anandkumar https://blog.neurips.cc/.../announcing-the-neurips-2022.../",2022-11-22T00:00:00,['https://video.fcai19-7.fna.fbcdn.net/v/t42.1790-2/316626005_1261691944677833_5380958816247246420_n.mp4?_nc_cat=102&ccb=1-7&_nc_sid=985c63&efg=eyJybHIiOjUxNiwicmxhIjo1MTIsInZlbmNvZGVfdGFnIjoic3ZlX3NkIn0%3D&_nc_ohc=L85BT8rTIBEAX9yG58v&rl=516&vabr=287&_nc_ht=video.fcai19-7.fna&oh=00_AfBtfEoykhse2MIyupVSq8X5PYQKePbiGpZwokET_qFRAA&oe=64E2FC1F'],,https://www.facebook.com/NVIDIAAI/posts/pfbid0h7i1RMkWacDAvFti265vBQPN7jm27CW3LP23KontE6UJzS2kQmfQJFcVijYUMhJcl?__cft__[0]=AZW-u6DfXVD_8OYObrou5pKNUHZ3bNSEsN0rkfGmtSH4ke3TXFoMUHw-YlP7YQ7HuA7HhwjZ5YP_vPjyNcQrLMXvjfKJXH0xaloJfSNAlE3vuzWuqu9R2cFTgLaUmzR_4YgWHkcZ344paJ9b-k4pnN7UWSGyTJIzCaH33Ih48-S-1d_UUekM7iqn_vp-uThs1rZHQDg7tzKl4Epyy5C-lgf2o1FzVo9Dv1dZj9I07XKl8w&__tn__=%2CO%2CP-R,13,0,positive,13
pfbid02j1u9CdNwse7fGJN3vsLcV9T6puxTFgnm8jEZVRFfQ4XWwVDq5snTKUyGebJxWrucl,NVIDIA AI,0,18,1,0,1,0,0,0,20,2,"Minerva CQ, a member of #NVIDIAInception, is making customer service calls in #energy quicker and more efficient for agents and customers. Learn how the startup uses NVIDIA Riva for real-time dialogue suggestions, sentiment analysis, and optimal journey flows: https://nvda.ws/3TYGxP8",2022-11-22T00:00:00,[],https://external.fcai19-7.fna.fbcdn.net/emg1/v/t13/6027750067782188466?url=https%3A%2F%2Fblogs.nvidia.com%2Fwp-content%2Fuploads%2F2022%2F11%2Friva-minervacq-blog.jpg&fb_obo=1&utld=nvidia.com&stp=c0.5000x0.5000f_dst-jpg_flffffff_p500x261_q75&ccb=13-1&oh=06_AbE6mvoN4_XPAUCLfWKHuYq3I0dAN3KbIyWrj54MbGBkHw&oe=64E03EBA&_nc_sid=dbad39,https://www.facebook.com/NVIDIAAI/posts/pfbid02j1u9CdNwse7fGJN3vsLcV9T6puxTFgnm8jEZVRFfQ4XWwVDq5snTKUyGebJxWrucl?__cft__[0]=AZVXImd9wNLYv96OI-mBpPS3x7F1spK3EA9UBQgUUhkN-QFu9ZLKyOsQjSo0QY-w4r2MgaXEM3BEfDxu0MkF7X-FcP9FcLZpNpVwATRlrs0LvrvunPq3cDCkCnrb3tTlnEB_TwYEt_5xsMgSno0dnaxhoWcDqbqIj5IamYZxHXHyqs4ic8bClQx6f5g0WTvuJbEmWBWLcphwkQvpROoNVBOm&__tn__=%2CO%2CP-R,20,0,positive,20
pfbid0Ywje3nCdTRLxcqGZDTmoyjd945X8TohzWmhmPaRjcDdiqspmzEHyB4Wh6r2ZKF9Jl,NVIDIA AI,0,3,0,0,1,0,0,0,4,0,"NVIDIA Inception partner Activ Surgical Inc. looks to focus on developing surgical tools that improve patient care, increase safety, make surgeons more efficient, and reduce errors with AR and AI in robotic-assisted surgery. Read more: https://nvda.ws/3ViFnPt #nvidiainception",2022-11-21T00:00:00,[],https://external.fcai19-7.fna.fbcdn.net/emg1/v/t13/16666557287395708838?url=https%3A%2F%2Fthesiliconreview.com%2Fstory_image_upload%2Fus%2Fthesiliconreview-tom-calef-cto-activ-surgical-22.jpg&fb_obo=1&utld=thesiliconreview.com&stp=c0.5000x0.5000f_dst-jpg_flffffff_p139x139_q75&ccb=13-1&oh=06_AbFlNrrLwqtVDzyQZ5ylbScvi4gQw1FIr66lo-RRKQCyvQ&oe=64E0A273&_nc_sid=dbad39,https://www.facebook.com/NVIDIAAI/posts/pfbid0Ywje3nCdTRLxcqGZDTmoyjd945X8TohzWmhmPaRjcDdiqspmzEHyB4Wh6r2ZKF9Jl?__cft__[0]=AZUVn2pXzmVdUzA56dQoPm8PsyjUY-BpI4br_BYwmno3oLAUj0VfWSvbzRzxs3riFwlg5SD3dE9g378COhNxfiHfwXozxggwUNrvueHhSVgZuRIgv49eIS1vknobLvg9gcvMwPunyBq8YOahgHEoe-b6gnyvWhZMlk-nSPLKyHYsxVUi8fD-AS8JmdpLX3yTv2yc2c0EReaaarg4igPhh2NR&__tn__=%2CO%2CP-R,4,0,positive,4
1078056469527288,NVIDIA AI,0,15,1,0,0,0,0,0,16,9,An SMU-led research team has been awarded $2M from The Department of Energy to develop algorithms with a powerful NVIDIA SuperPOD™ amongst its supercomputing system in order to fuel sustainable energy efforts. Learn More: https://nvda.ws/3Eof4Ra,2022-11-18T00:00:00,[],https://scontent.fcai19-7.fna.fbcdn.net/v/t39.30808-6/316207050_1078056462860622_300630436455195995_n.png?stp=dst-png_p843x403&_nc_cat=110&ccb=1-7&_nc_sid=9267fe&_nc_ohc=pU_ZE5WFAmAAX_GjSiO&_nc_ht=scontent.fcai19-7.fna&oh=00_AfDdnTm-cCMeyBiEq03au_2qDDKAKiJYAJz3NmIoQyjOww&oe=64E361C7,https://www.facebook.com/NVIDIAAI/photos/a.119492422050369/1078056469527288/?__cft__[0]=AZWm4XQyOjOB92cf6jVESar1X8V8wIox1Ld5Q8lQzVchUEd8xV3uo6AsMLWnwRKvNYyigVJzFu8XkWiuREZk5IsBVgGJVBv2BiUWOhlcuifk0jLZduWueSyyX6qUwLrcrhN43wAwjJpRNy8kewFcWDOr_ASO-ZLFPVvS1lk1j4Op07AfnK_8ZcZHZpL99091ej_EBaHgcYktEtIYklP7onDp&__tn__=%2CO%2CP-R,16,0,positive,16
pfbid0X8EpG18LefJC182ocSvq5iMxqNrexVCEA6MNF92uYdshhsunf3g2rTfeDuE63Kebl,NVIDIA AI,0,14,0,0,1,0,0,0,15,0,"Now showing: a constantly transforming, real-time generative #AI art exhibit in the lobby of NYC Museum of Modern Art. ""Unsupervised” by Refik Anadol is created with AI, trained on thousands of artworks from Warhol to Pac-Man.https://nvda.ws/3XdZQ9Y",2022-11-18T00:00:00,[],https://external.fcai19-7.fna.fbcdn.net/emg1/v/t13/15926885572810294635?url=https%3A%2F%2Fimages.fastcompany.net%2Fimage%2Fupload%2Fw_1280%2Cf_auto%2Cq_auto%2Cfl_lossy%2Fwp-cms%2Fuploads%2F2022%2F11%2F28-90811669-refki-ai-art.jpg&fb_obo=1&utld=fastcompany.net&stp=c0.5000x0.5000f_dst-jpg_flffffff_p500x261_q75&ccb=13-1&oh=06_AbEjWXFgsXIjUQ-6W9QYZGICQIUAxWPv98WIGAPJv4wgbg&oe=64E02D70&_nc_sid=dbad39,https://www.facebook.com/NVIDIAAI/posts/pfbid0X8EpG18LefJC182ocSvq5iMxqNrexVCEA6MNF92uYdshhsunf3g2rTfeDuE63Kebl?__cft__[0]=AZVhRaEDWfTgxdnD2xIW6zZ-KkxDzf64jLOcbXa_wpfB_Gb_wOxNoXTT-jR8Y9POWBicTaNs25TFudNhoBoN69gEy359ZJaQgXWkaFJD0lVjwHKGkRHyr5BI4nlDSFYMvdeKXnmcCfzqdRLzyrk9jdfx37LRjs5HVbrLleQT_aHubNJhhe2AGZ9VFAzatbUR-S3aucD8LmIg6cuPXo24LjRg&__tn__=%2CO%2CP-R,15,0,positive,15
pfbid02nwbtuxMwgeyfVRivaC7qSpsFM2C2ePS9MXfrmbXNBkFjGjMCKfF3BsbU4MDb4GM7l,NVIDIA AI,0,18,1,0,1,0,0,0,20,3,"KDnuggets, in partnership with NVIDIA, is proud to announce an innovative contest for our readers and community contributors. Learn more: https://nvda.ws/3hWesKY",2022-11-18T00:00:00,[],https://external.fcai19-7.fna.fbcdn.net/emg1/v/t13/8660554717579451203?url=https%3A%2F%2Fwww.kdnuggets.com%2Fwp-content%2Fuploads%2Fnvidia-day-life-data-scientist.jpeg&fb_obo=1&utld=kdnuggets.com&stp=c0.5000x0.5000f_dst-jpg_flffffff_p500x261_q75&ccb=13-1&oh=06_AbG-wNcUbf_hqrNNqPuR0vqTAKzcDJ5icdlx6e8UZZrZZw&oe=64E029F9&_nc_sid=dbad39,https://www.facebook.com/NVIDIAAI/posts/pfbid02nwbtuxMwgeyfVRivaC7qSpsFM2C2ePS9MXfrmbXNBkFjGjMCKfF3BsbU4MDb4GM7l?__cft__[0]=AZXfPwUfPrgEyoDOXKNI8ODDh0GI1cc61ZtdnbH8uvtbalNRIge_yR0JOot6fguTe_9LMdHShg2CqMEQe46fXth-2ZBsM3v13kM5AqbprM2UKf6oCkVkPArI-glmPPyqQHKW2LynycNvlvL0uUiFYJKtTLsPiUIAnR87jxh5gsGGlI0hsQwX7YzH_7mNODiew0g0a6547KB8IuGJXD6p4H3V&__tn__=%2CO%2CP-R,20,0,positive,20
1077398192926449,NVIDIA AI,0,19,2,0,0,0,0,0,21,1,"Would you like to increase efficiency, streamline development, and achieve more cost-effective data operations in your AI solution? Join us on Dec. 8th to learn how the free RAPIDS platform for accelerated data science can help you get there. Register: https://nvda.ws/3EljhoK #nvidiainception #startups",2022-11-18T00:00:00,[],https://scontent.fcai19-7.fna.fbcdn.net/v/t39.30808-6/315950428_1077398182926450_7275533995102591335_n.jpg?stp=dst-jpg_p526x296&_nc_cat=103&ccb=1-7&_nc_sid=9267fe&_nc_ohc=VKaW0j0iNpYAX9jiDdf&_nc_ht=scontent.fcai19-7.fna&oh=00_AfCVRFZOTXKajJxvvAbfp4mR2QsTAix3lRJ4APBC-pvLYw&oe=64E2E051,https://www.facebook.com/NVIDIAAI/photos/a.119492422050369/1077398192926449/?__cft__[0]=AZX2ywllD1Cx3kS0SZTmaQN5Welhv0CSqWZPyDyFjfZwGoDoJDBSCqnK9ofRIzXe26SO_bocrepmW-qZ4x_PpaNvjG3oMuUSsSFG1BCnMONBSqiZdHpAMtWYxeErK3KZ1jzTCJyKe84WykHWJhMZGVDb0VsMy3xW21KAWIIbLpOZikXoBDBhiWy3ZDOPyL9z17mHl9uT4L_enWsYx3ZZ96Tl&__tn__=%2CO%2CP-R,21,0,positive,21
1077321116267490,NVIDIA AI,0,16,0,0,1,0,0,0,17,1,"Get free access to NVIDIA's hardware and software stacks, guided step-by-step labs, and support from NVIDIA #AI experts to accelerate the optimizations of your conversation-based AI solutions. In this free hands-on lab, you’ll experience real-time, out-of-the-box automatic speech recognition and text-to-speech APIs. #ASR #TTS #NVIDIARiva https://nvda.ws/3EaoU9p",2022-11-17T00:00:00,[],https://scontent.fcai19-7.fna.fbcdn.net/v/t39.30808-6/316084582_1077321109600824_631055440714665204_n.jpg?stp=dst-jpg_p526x296&_nc_cat=100&ccb=1-7&_nc_sid=9267fe&_nc_ohc=XaIKzSaICsAAX9MnwI7&_nc_ht=scontent.fcai19-7.fna&oh=00_AfCCFo_y8lwHwCxFkVqpwDVIoy_cnOuDid1NDuwNrVGU7A&oe=64E2B62C,https://www.facebook.com/NVIDIAAI/photos/a.119492422050369/1077321116267490/?__cft__[0]=AZWMDTNDz_bFEeyBLXtOyNXae05m1UlzfrSTCWdF8l71D_hNZbFOa1dXFKKirdS6ByLvOz0lupxyAaVNR88PIC2d-6IuYXM_KN17bT0NvPH4sj6YN33FusVIHqoLAIwsmXBakiZrLmbX5Vh_MCf5R5pwgBgy4fwItt_DGdncZD4zCmXOJZw2cjlKSlZNdQh-zHjJOdYtLNcGXlMvuRLY3F4S&__tn__=%2CO%2CP-R,17,0,positive,17
pfbid02hMaPZshj3ztTTC1s51yuTEQQGjvgNthhcB5drzHpvqeWkuJCXyMRNaAtTHBvarjLl,NVIDIA AI,5,25,3,0,2,0,0,0,30,2,Harness the incredible acceleration of NVIDIA #GPUs and learn how to write GPU-accelerated C++ code using only standard language features. Enroll now: https://nvda.ws/3Als494,2022-11-17T00:00:00,[],https://external.fcai19-7.fna.fbcdn.net/emg1/v/t13/14551162018880517811?url=https%3A%2F%2Fprod2-sprcdn-assets.sprinklr.com%2F50276%2F7e9af021-bae2-42bd-80aa-0f17facc5b2e-1715016399%2Fdli-social-workshops-gpu-accel.png&fb_obo=1&utld=sprinklr.com&stp=c0.5000x0.5000f_dst-jpg_flffffff_p500x261_q75&ccb=13-1&oh=06_AbHn5RWmIfBQSewBBANg_oh6wgMLJPrIOk1GlOgrcfzxug&oe=64E06B44&_nc_sid=dbad39,https://www.facebook.com/NVIDIAAI/posts/pfbid02hMaPZshj3ztTTC1s51yuTEQQGjvgNthhcB5drzHpvqeWkuJCXyMRNaAtTHBvarjLl?__cft__[0]=AZUUY5iXot05yHN8UNPDqUUER_BvQYtKdYCdeqStoT4trbNIcY0Rt38wv6p09_USlpnlrvL-nZAt2EetsNyeG0ItQm9pMizFMgfyLI-MYydDudAOsgT6t4d2yfjBSNVnDquhRwD4tKw2mdU5JOiuf07lj2bYfq21BVEZ6xHxw1cOSYjkWEIlS8wrOhmBWFTdcnOkNmIqJEmeswTkVFuvUZdy&__tn__=%2CO%2CP-R,35,0,positive,35
pfbid0322wVZ72vdzgEN8n3WDancPwqaLj7WFUFzxeM4FNN3qf9FuNviXPvGdyTpJbb1T2kl,NVIDIA AI,10,81,11,0,0,0,0,0,92,3,"We announced a multi-year collaboration with Microsoft to build one of#SC22most powerful AI supercomputers in the world, to help enterprises train, deploy and scale #AI, including large, state-of-the-art models. https://nvda.ws/3UGkgqI #Azure #NVIDIAonAzure #SC22",2022-11-16T00:00:00,[],https://scontent.fcai19-7.fna.fbcdn.net/v/t39.30808-6/315941663_10159426425948253_501727073385498190_n.jpg?stp=dst-jpg_p526x296&_nc_cat=106&ccb=1-7&_nc_sid=730e14&_nc_ohc=SqCUKLMpOxcAX_yqpmG&_nc_ht=scontent.fcai19-7.fna&oh=00_AfCL1fH3Kbc5JyMxWRVzpBfgPn8ywGFnynQRfohULgyonQ&oe=64E3E32D,https://www.facebook.com/NVIDIAAI/posts/pfbid0322wVZ72vdzgEN8n3WDancPwqaLj7WFUFzxeM4FNN3qf9FuNviXPvGdyTpJbb1T2kl?__cft__[0]=AZUn9eRIYoKYFEof4U1deXCbWwohYDsBF1pyHum4Ll9u2qv00-Xjei-gqLUwaOZCiZku6UVUxB0yRdBK2eg8OV-3Dxqdi51jy1fweGwOQ3Cgybju9ycVQe_0GZwO5TiBQJLHzS1XZ9tQu6FPgChTKogv3TNuXMXVRAPH2-4Yecq3jzLZa6mh-Wp6T7GpVUDV0gGqWDUVKGHbJLAbbZY0wdYteDhHlZNprnv8ukY6cY7op9P3EZjzC4BA21XspGiy27Q&__tn__=%2CO%2CP-R,102,0,positive,102
pfbid02w36b2TcAaoZdd83ke46mWUtDZHfh6QCNXw2oDrrMUdhNpkshrNYWftZxH8FaS9Rhl,NVIDIA AI,0,5,1,0,1,0,0,0,7,1,"This week on The #AI Podcast, Amos Berkovich covers how the WSC Sports AI cloud platform uses #deeplearning to turn in-game action into social media-ready highlights in real time. https://nvda.ws/3hHYxQs",2022-11-16T00:00:00,[],https://external.fcai19-7.fna.fbcdn.net/emg1/v/t13/17351559763415525192?url=https%3A%2F%2Fi1.sndcdn.com%2Fartworks-1WgLE99c7IKRHz1B-AypPsg-t500x500.jpg&fb_obo=1&utld=sndcdn.com&stp=c0.5000x0.5000f_dst-jpg_flffffff_p500x261_q75&ccb=13-1&oh=06_AbE7FTyhdQ062nCfLaEklzDDkFtmN4ghMyTcMZ64q6ppQQ&oe=64E05CF2&_nc_sid=dbad39,https://www.facebook.com/NVIDIAAI/posts/pfbid02w36b2TcAaoZdd83ke46mWUtDZHfh6QCNXw2oDrrMUdhNpkshrNYWftZxH8FaS9Rhl?__cft__[0]=AZWGZSiodZxLo64v5OvIIXECPDMn6vPhfoijDRlODAWh0LltHGlhfcBuW7la2p0oWeFj9BKICNk30mZuGdtKWskJquzupOfZvHA9IR3L0zuZ6iDsQpZRXs4sKgOV1uvfMPR8R4nt_PIfUiGfzEWMhahDBBJRufXE1h4Uobgqgt8QAIURRrAUkCO58uyMvVsmD6k9ou5YyMayG52uGfd1NTp5&__tn__=%2CO%2CP-R,7,0,positive,7
pfbid02Paxg3JGa2b6T6pkQCqsYzTQ7GdDbEMGeDCiTr7uddQ7WcEtbisczJLNatnQcu5c4l,NVIDIA AI,0,3,0,0,1,0,0,0,4,0,"NVIDIA has collaborated with #AWS to develop a #MONAI connector for HealthLake Imaging. MONAI is an open-source medical AI framework to develop and deploy models into AI applications, at scale.  https://nvda.ws/3AlQYpc",2022-11-16T00:00:00,[],https://external.fcai19-7.fna.fbcdn.net/emg1/v/t13/2978904358925616660?url=https%3A%2F%2Fd2908q01vomqb2.cloudfront.net%2Ff1f836cb4ea6efb2a0b1b99f41ad8b103eff4b59%2F2022%2F11%2F15%2Fnew-amazon-healthlake-capabilities.jpg&fb_obo=1&utld=cloudfront.net&stp=c0.5000x0.5000f_dst-jpg_flffffff_p500x261_q75&ccb=13-1&oh=06_AbH_tIYicL7LG5LFmNxQ69pipMnXiwHS1BWzD0f-4JOa2A&oe=64E04348&_nc_sid=dbad39,https://www.facebook.com/NVIDIAAI/posts/pfbid02Paxg3JGa2b6T6pkQCqsYzTQ7GdDbEMGeDCiTr7uddQ7WcEtbisczJLNatnQcu5c4l?__cft__[0]=AZVK3fryAcBTF3Qz1gsEKjobLCn_uaL2tHQZjPSfOH7Z0yrQ5UMmPQI4-op-N9VvtkQ3J6iwJWzUdOzQFn9NWOBaNtnkVSBHoN_HCZeTWIFhbKZ5BbcxDBEFun4BXSFodv_imv65tr_233CdUdOC9s5WWVM4EIlt5LPxSfYZ2SJRsZmDcJ-ugOpbKwXHQDFgMUt9kGOMJdEDFAhdNGzp1U2-&__tn__=%2CO%2CP-R,4,0,positive,4
pfbid02QNwLmPNb2gvXihCeTJ5xJzNVY6LpUqvRzUmbq2DSuKhHTg8aQ17AUf5txPm8bhpkl,NVIDIA AI,0,7,0,0,1,0,0,0,8,3,"To improve data center #sustainability, Penguin Solutions, NVIDIA, and Shell are collaborating to enhance energy efficiency, reduce emissions, and lower operating costs in #datacenters. Explore their work in the full video: https://nvda.ws/3V2b13V",2022-11-16T00:00:00,['blob:https://www.facebook.com/8437dc67-78d3-4293-bf05-73501a108c36'],https://scontent.fcai19-7.fna.fbcdn.net/v/t15.5256-10/315526310_860722408274869_903616880097703538_n.jpg?stp=dst-jpg_p180x540&_nc_cat=107&ccb=1-7&_nc_sid=ad6a45&_nc_ohc=mjsUCLCXRN0AX9fNFtP&_nc_ht=scontent.fcai19-7.fna&oh=00_AfBskxq7Ji7UyCd4DqOpz5jVioEkP0dHnH3j0lq5alxtaQ&oe=64E48BBF,https://www.facebook.com/NVIDIAAI/posts/pfbid02QNwLmPNb2gvXihCeTJ5xJzNVY6LpUqvRzUmbq2DSuKhHTg8aQ17AUf5txPm8bhpkl?__cft__[0]=AZUvDaxUMgfLTgUNGt-8qSJokLRONMpJfYDcFYhuvU4JaQm7w_yNGGj9M-dXEP7A5kn7-Nld0AItxvvlQmr8hCHTTOeNyGoJNSG8EOmjKIPcqD70GOVkcvrkXFsuAG9wMqmQDO_Lw2tTFJovEutiwvxdMIpNjlpAnXW3Hbzqwk_FyzqH5x2astdrs_K0D0eHqdNnQUJd0IwvsqHz8OpktX-fy_IbgNHXUDxVtgZWd7c5oQ&__tn__=%2CO%2CP-R,8,0,positive,8
1075921623074106,NVIDIA AI,0,10,0,0,1,0,0,0,11,2,"Insurance fraud in the US is a $300 billion per year problem. Learn how Quantiphi and NVIDIA are using #AI and #ML for document digitization to identify risks, prevent fraud, and accelerate claims processing. Register today: https://nvda.ws/3X72deI",2022-11-16T00:00:00,[],https://scontent.fcai19-7.fna.fbcdn.net/v/t39.30808-6/315643886_1075921619740773_1415037152321250801_n.jpg?stp=dst-jpg_p526x296&_nc_cat=105&ccb=1-7&_nc_sid=9267fe&_nc_ohc=geCagWeqERsAX9CT48o&_nc_oc=AQn8SetD4H6VQlKhmSCJoWlL31qcPfrBCREzNFhLCNp8SKA5sJd1WYouuKDCnrZcBPg&_nc_ht=scontent.fcai19-7.fna&oh=00_AfDWdyUWPbfe4qVzE9iVhqXdhdImSZcebYMeAl6PxTFCdg&oe=64E45C85,https://www.facebook.com/NVIDIAAI/photos/a.119492422050369/1075921623074106/?__cft__[0]=AZUm5zB8rDw2ke_Isnkm1L2nSu6aSWk8Cizm4VxHvYSKqsOs0X1E01YVFD2zbU5RW9mDw3T7nix42tVX4-So_pFlm9c72gZ6c36kBzWjerOE157eLF0M2V4eCikhni9mPXNkRZWrX2QY3QE_zJfh6ZwBvSfo17IIoJbZRK1NTPaQORp6NavZpX5FUKVJP__DqBLuGqYIpLzT6ZAdHp6Wg_Hi&__tn__=%2CO%2CP-R,11,0,positive,11
1075827273083541,NVIDIA AI,0,9,0,0,1,0,0,0,10,1,"Last chance to register! Find out how to use #machinelearning to optimize yield curve estimation of U.S. Treasuries. Hear from Markus Pelger, Assistant Professor of Management Science & Engineering at Stanford University, on November 16 at 9 AM PT: https://nvda.ws/3TGcNGx",2022-11-15T00:00:00,[],https://scontent.fcai19-7.fna.fbcdn.net/v/t39.30808-6/315253957_1075827266416875_4416631147091437584_n.jpg?stp=dst-jpg_p526x296&_nc_cat=108&ccb=1-7&_nc_sid=9267fe&_nc_ohc=TsIYjdld7N8AX-lA58J&_nc_ht=scontent.fcai19-7.fna&oh=00_AfD_UR_bxMoN7U2KrCOZMf_wKoGmuuBHa3MjaoodCi5sXg&oe=64E2C6FD,https://www.facebook.com/NVIDIAAI/photos/a.119492422050369/1075827273083541/?__cft__[0]=AZXXOs_rPp0OEv2YKInyeWoiS3tzhFpG_toAXB4eFaPkJ1BZpxpJ9yWNaeCj99O543xmHOUltbOHMrPmx3cArfLYLwoEo1m_QLxJOlyD02I_nn8Q7Y6DzH0ftxwEuyXYEgbAHsDKlxpgyQhfTSKEMrV3MN8wUqB_dpIdaP4f25nA1e3PJiXnuMKBQfpan5iUoebKAQsAQPYilaDhlmwOdgXf&__tn__=%2CO%2CP-R,10,0,positive,10
pfbid02NL7mi7rtodss8hrDQJL73JShBTgZ462UwyRuCPLRTatyWWHpTBFFMzJyLnJDwnTul,NVIDIA AI,0,7,0,0,1,0,0,0,8,0,"Check out our demos and virtual theater to see how NVIDIA technologies are changing the ways that developers, scientists, and researchers across industries are solving problems. #SC22 https://nvda.ws/3tv1aHT",2022-11-15T00:00:00,[],https://scontent.fcai19-7.fna.fbcdn.net/v/t39.30808-6/315777668_1289217735187220_5598848810546629568_n.jpg?stp=dst-jpg_p180x540&_nc_cat=104&ccb=1-7&_nc_sid=9267fe&_nc_ohc=oR5mReubSKIAX_fC6tE&_nc_ht=scontent.fcai19-7.fna&oh=00_AfAkIXZeo9D139cZ0qiGL4x0rsyMy91XBNQYnC8y2idA8g&oe=64E37CF4,https://www.facebook.com/NVIDIAAI/posts/pfbid02NL7mi7rtodss8hrDQJL73JShBTgZ462UwyRuCPLRTatyWWHpTBFFMzJyLnJDwnTul?__cft__[0]=AZWempPU9X_-E7e0nGGdhmXvjALQDvXRpB5niZOpkgJ1aL7BxyVizsyIA9As0x18auXAo2-7DTNbL9LfKREMHdyyHGfxAcyR4mxQEJPAmm3h83uZkZwAKGOaFn7bmMad8mkkzIFHhCztog_YpFFhgMrU41pSDk5B6hmCg4yja8-PRpTxFZHLqveF0LK7ck8u0i9Z1YjSXXZBsrC0YaxkADIlMPXFmZHTePmv6hW0CTzcg6kC8okl0B4pb9hSO-lvcV3bIJylHP0KwN2Ctn8WOgt_&__tn__=%2CO%2CP-R,8,0,positive,8
pfbid0m9XUa2ztNsr3KicFFjQvKbntStHdKQ9gpMf2DzQ7wxjZb1zjbPAfDfvKqzTZoYC1l,NVIDIA AI,0,6,0,0,1,0,0,0,7,1,"At SC22, NVIDIA and NetApp talk about the latest joint AI infrastructure offerings for flexible AI deployments including NVIDIA DGX SuperPOD powered by GPU-accelerated NVIDIA DGX Systems with AMD EPYC™ CPUs:  https://wp.me/p3RLHQ-nxX",2022-11-15T00:00:00,[],https://external.fcai19-7.fna.fbcdn.net/emg1/v/t13/27257891462960611?url=https%3A%2F%2Finsidehpc.com%2Fwp-content%2Fuploads%2F2022%2F11%2FSC22-Nvidia-NetApp-feature-image.png&fb_obo=1&utld=insidehpc.com&stp=c0.5000x0.5000f_dst-jpg_flffffff_p500x261_q75&ccb=13-1&oh=06_AbFjLL4V92_Guwdoqj7LQnHJciYPxuRrZmutlqXalCDkVQ&oe=64E036B0&_nc_sid=dbad39,https://www.facebook.com/NVIDIAAI/posts/pfbid0m9XUa2ztNsr3KicFFjQvKbntStHdKQ9gpMf2DzQ7wxjZb1zjbPAfDfvKqzTZoYC1l?__cft__[0]=AZWN-FpE0QoBCzd8BMIBDeSLCg2Ar2IKKnTDvvYFyh9Q933bYy2aCFJ0eHebjNE2HiyLMQXXBKwP2PLwNweOBdEWNgRaop3Vf0_4KfE_6nTCl1Rj7IXCFYDM9SezzU711NOEd0BQvyTEezN2kX_Gr5RdFCCEKW1KgdRfi6xoQQ4ThzSEXv1R4u38-bJztjVWXT6aVzU9K44cDmeaS6pKLok6&__tn__=%2CO%2CP-R,7,0,positive,7
pfbid02EhVHmUHEHLAdNRvg8LPJtDdBvxLvQzrcZbjJNrihKTS8yjEGVRgA7jdgZ8RJ3Vo6l,NVIDIA AI,0,12,0,0,1,0,0,0,13,0,"Nuance Communications, Inc. and NVIDIA announced today a partnership to bring #AI based diagnostic tools directly into the hands of clinical radiologists, enabling the delivery of improved patient care at lower costs. Read the press release: https://nvda.ws/3GggNdO",2022-11-14T00:00:00,[],https://external.fcai19-7.fna.fbcdn.net/emg1/v/t13/11462509213916971788?url=https%3A%2F%2Fmma.prnewswire.com%2Fmedia%2F1156940%2FNuance_Communications_Logo.jpg%3Fp%3Dfacebook&fb_obo=1&utld=prnewswire.com&stp=c0.5000x0.5000f_dst-jpg_flffffff_p500x261_q75&ccb=13-1&oh=06_AbEtiTd722WU-e9s33f6M7sUuKQNFCdDGh4AXZR7Aggcgg&oe=64E0B0F6&_nc_sid=dbad39,https://www.facebook.com/NVIDIAAI/posts/pfbid02EhVHmUHEHLAdNRvg8LPJtDdBvxLvQzrcZbjJNrihKTS8yjEGVRgA7jdgZ8RJ3Vo6l?__cft__[0]=AZXXiSZ-rxVR5I6nyPZteSGB0DxmgMuISBBY8U7R4MPCuHEgXMr5n52iFr0IP_NQPudKyIH9EBaRhPbrfqaCvZe5uHE4POV-gR7jZaLlGA4LFe7OgOplAyGNGTp79OstMIVyF6hq2E8qPbXoFiODaEBoGIhVtdWAhLQ6B7fTohhXUETNo9_zTMa3GShQ_rYB0K9TaUmnpDm-dy1vK9FukohJ&__tn__=%2CO%2CP-R,13,0,positive,13
pfbid028RP7Vmzd6oaoFbrR8ofFTZ7BJzzCzdfq8xz8xek1rpBa9ZaU72HF6ZwnVtYVPuj8l,NVIDIA AI,0,9,1,0,1,0,0,0,11,1,"Our #HPC platform combines #edge computing and #AI to enable secure access, data migration, and real-time, streaming processing at the edge. Learn more. #SC22 https://nvda.ws/3GfgVKQ",2022-11-14T00:00:00,[],https://scontent.fcai19-7.fna.fbcdn.net/v/t39.30808-6/315225668_1288568201918840_2141415319568227749_n.jpg?stp=dst-jpg_s960x960&_nc_cat=102&ccb=1-7&_nc_sid=9267fe&_nc_ohc=92XfTAjCwdcAX_ZYWjp&_nc_ht=scontent.fcai19-7.fna&oh=00_AfAebmW4j0prAKq1uR5NoiOUsUaJ6OAXQyJjuKNgAQBcWw&oe=64E49C6E,https://www.facebook.com/NVIDIAAI/posts/pfbid028RP7Vmzd6oaoFbrR8ofFTZ7BJzzCzdfq8xz8xek1rpBa9ZaU72HF6ZwnVtYVPuj8l?__cft__[0]=AZWl7wlUcIK0f2hmQ4EodhWE_giSK25Fd1utVm47OY_VBcvotkGf66V8_OCiIw0j24PNSDYB248nWHt4YwzgQfh4vOnu2x7ymoMn3941jD0QYR-GVekc9dx_fID-A7yqMhHsdhXWI5vAYPonEg6llCyOkKSreKgL6eR4tSGBnT3updu2v4PCHY0RnW8aIDcm5wT_rG-aUhKca0O1TGVAPIfQv4UZQpCK-GXGCrjPj25YqNb5p_gAaOPiCePoCnn4Q8NVLU7wnGct0beELCPWq0R1&__tn__=%2CO%2CP-R,11,0,positive,11
1075233679809567,NVIDIA AI,0,15,0,0,1,0,0,0,16,2,Discover why leading retailers like PepsiCo and Lowe’s are harnessing the power of #AI to drive measurable results for their #supplychain operations. https://nvda.ws/3A70ZGA,2022-11-14T00:00:00,[],https://scontent.fcai19-7.fna.fbcdn.net/v/t39.30808-6/315749869_1075233676476234_2610478157346226118_n.jpg?stp=dst-jpg_p526x296&_nc_cat=103&ccb=1-7&_nc_sid=9267fe&_nc_ohc=R6cZvckkacsAX83LB_w&_nc_ht=scontent.fcai19-7.fna&oh=00_AfDLio7U3YHODi1qmiv0mTovmReSwUAkkdZt0VocO0mfIA&oe=64E436D6,https://www.facebook.com/NVIDIAAI/photos/a.119492422050369/1075233679809567/?__cft__[0]=AZVeHnEyXp_zsf6wKtvuKFbjf_cWC6YPLyRuI2zTPylx7jjQdlVQgqyZS6bptd5D34jwAFtuRJRYrGRExpLcI608bWrnfeoVDz96AQzc5auRmpoE2euchOiaroRaZRgVos9IA24YOdskmgfGPpSQJTN7_BEtE35dqgvr3T9pbHxjE7yfpNwFdwlUjZMdAd8YTLVHqYWpw68fTvMZCJDlXehM&__tn__=%2CO%2CP-R,16,0,positive,16
1075207509812184,NVIDIA AI,0,12,0,0,1,0,0,0,13,2,Learn how to create an end-to-end hardware-accelerated industrial inspection pipeline to automate defect detection in this DLI instructor-led workshop. Register now for the 1/18/23 workshop: https://nvda.ws/3UaDBjq,2022-11-14T00:00:00,[],https://scontent.fcai19-7.fna.fbcdn.net/v/t39.30808-6/315724326_1075207506478851_6927917080725927420_n.jpg?stp=dst-jpg_p180x540&_nc_cat=103&ccb=1-7&_nc_sid=9267fe&_nc_ohc=dvmaVQ0p65QAX931Vl5&_nc_ht=scontent.fcai19-7.fna&oh=00_AfCo77pTn7vXR5idj4lTM_LRk0QV0jjAmpyX06RSpGT1YQ&oe=64E364F9,https://www.facebook.com/NVIDIAAI/photos/a.119492422050369/1075207509812184/?__cft__[0]=AZV0U-d__Qw3hMIrCJnn1uJNFYMCV5Xanb1HY0Deuf10GAv0j2boWMZiL2JjDayDOR1WewgBKyJY3mPtyWcOB3j0f3jGD9L_IqADFxxpg7w-rorgrf5Rinki2F1vTtSn2FVc8zkRnNB_hZhsYWmaP7Gx9FeEtfqdiQBX7_HQJEqf46aoM8mz23bF7cGstHn6JqGT6ZoP3iXLsA_toVi6_bSf&__tn__=%2CO%2CP-R,13,0,positive,13
pfbid07dQWEunmXajucSdsyqakgV4pT2PZAq9AmR8U2WYkV1yYkRkBpboWExywFyAE7dMql,NVIDIA AI,0,2,0,0,1,0,0,0,3,1,"Gordon Bell finalist applies #LLMs to track genetic mutations and predict COVID variants of concern, as well as any other disease with enough #genomic data. #SC22  https://nvda.ws/3GfdYcX",2022-11-14T00:00:00,[],https://external.fcai19-7.fna.fbcdn.net/emg1/v/t13/18093985633500348060?url=https%3A%2F%2Fblogs.nvidia.com%2Fwp-content%2Fuploads%2F2022%2F11%2FNVIDIA-Blog-Cover.png&fb_obo=1&utld=nvidia.com&stp=c0.5000x0.5000f_dst-jpg_flffffff_p500x261_q75&ccb=13-1&oh=06_AbEtPYaMp60DwzpoZ54LPnTVHHMXrb1rO7uHZVueWCtq7Q&oe=64E03C09&_nc_sid=dbad39,https://www.facebook.com/NVIDIAAI/posts/pfbid07dQWEunmXajucSdsyqakgV4pT2PZAq9AmR8U2WYkV1yYkRkBpboWExywFyAE7dMql?__cft__[0]=AZXO3CFpvFADurOnXemfXzDMInuzLMd2gcsyqazubykm2GuQ3ylJzWeOxQ-3ZuabGq0LUnhd0plNhgIWCGJCzXvenQj7uLKaBigj84axBMNFUzPk82Oj5ATOBp8f3jj2cNywtR_QQwa4ro-HE0iP5TK8Xdo0_jR2JNZ0e9U0FEGYDFfrCbCxt8_cFw1nZDtDoBu0YvCM8dwbknWo5_AXTCCa&__tn__=%2CO%2CP-R,3,0,positive,3
1072728700060065,NVIDIA AI,0,18,1,0,1,0,0,0,20,2,"Learn how to construct, train, and evaluate a GPT model using NVIDIA NeMo with Megatron on Jupyter Notebooks in a new free, hands-on lab from NVIDIA LaunchPad. Get started: https://nvda.ws/3tjbSRJ",2022-11-11T00:00:00,[],https://scontent.fcai19-7.fna.fbcdn.net/v/t39.30808-6/315224228_1072728693393399_1789092859132208514_n.jpg?stp=dst-jpg_p526x296&_nc_cat=100&ccb=1-7&_nc_sid=9267fe&_nc_ohc=0ePo9WFEz3kAX9WnrKL&_nc_ht=scontent.fcai19-7.fna&oh=00_AfA5I60-y-8Idod08DtHJLdPCsnG4jNTBS3U_eMMLQWmnQ&oe=64E2B93B,https://www.facebook.com/NVIDIAAI/photos/a.119492422050369/1072728700060065/?__cft__[0]=AZWk51KadAQ-AdVlrxaWJPiQiNmI_kM9fKLTvg6l-zlBDZO8Pr46WBWCJv7yzGBqpHvguIcZOj_BT0-v7VWN2O0nBqm5dDe3PndZWJuMYDWqRvpYYf3Q66JEcyQMWO4K6vBRCOr5zAZryxKky3gk8LR2mMqbMp3CKGE9mgXhkLKq0_ilAkeN4dOhZZC-vMMR1gt5sZ8CE6Gu20AYaJLcKxyT&__tn__=%2CO%2CP-R,20,0,positive,20
pfbid0k63MVAisYfXcdiMsvAJz9L3QzfBVPDy11EF42kN2TaTd1i24Wn36dxvxibUgFnfxl,NVIDIA AI,0,8,0,0,1,0,0,0,9,0,"Explore the state of #AI in radiology workflows, scanners, and reporting, and learn how NVIDIA is helping medical centers around the world build AI-powered enterprise ecosystems. #RSNA22  https://nvda.ws/3DOyrCC",2022-11-11T00:00:00,[],https://external.fcai19-7.fna.fbcdn.net/emg1/v/t13/5847195088274774546?url=https%3A%2F%2Fwww.nvidia.com%2Fcontent%2Fdam%2Fen-zz%2FSolutions%2Fevents%2Frsna2022%2Frsna22-nvidia-og.jpg&fb_obo=1&utld=nvidia.com&stp=c0.5000x0.5000f_dst-jpg_flffffff_p500x261_q75&ccb=13-1&oh=06_AbEH7TvJ7j0kTMEa3JHRsKwPuSANQrXXJ7l1FPFKQ3m91Q&oe=64E0B4CC&_nc_sid=dbad39,https://www.facebook.com/NVIDIAAI/posts/pfbid0k63MVAisYfXcdiMsvAJz9L3QzfBVPDy11EF42kN2TaTd1i24Wn36dxvxibUgFnfxl?__cft__[0]=AZWrabMNvtLdFSTR4mloYYGVPkd8-pBZLXgciVM8xKEKFqWeX1t9d7Sza-mKwp3D_AmzsHmSc85C8je3a2hF193VqqQ88Gbhyu-K-Uz-kegv1TH32XVOaG-RWX0d0OCKNlQjaZLuK_bFF2Lo6ZpMZZVXdIVPJnM4tIOSy5jJ1zFY7fDrnEv6JjfNK9AdEMYuOmncgPWHfWSBBtUaoskcUJSA&__tn__=%2CO%2CP-R,9,0,positive,9
pfbid02pfXhcdapyvXePZ4mhgCbu77oYHnvDEZBoCJM7fRzo2FYDVkxgfzqcE2YDkng7Xk1l,NVIDIA AI,0,14,0,0,1,0,0,0,15,0,"Our GPUs interpret data from the NASA's James Webb Space Telescope so that all of humanity can see outer space as never before. And to help researchers explore the vast chemical space of drug discovery, we built the #AI-powered BioNeMo cloud service. Learn more about us: https://nvda.ws/3fpGa1L #NVIDIAstory",2022-11-10T00:00:00,['blob:https://www.facebook.com/ff26e2da-0b30-49b6-9a36-f6c9da03302f'],https://scontent.fcai19-7.fna.fbcdn.net/v/t15.5256-10/314467383_501450045202498_2890294168405369223_n.jpg?stp=dst-jpg_p960x960&_nc_cat=102&ccb=1-7&_nc_sid=ad6a45&_nc_ohc=triLlRCUdRMAX_bdSZJ&_nc_ht=scontent.fcai19-7.fna&oh=00_AfCQ0K2rWclhWtlu4J285ZpkTV6HeBSA_UTOBYgsktHkzQ&oe=64E4701C,https://www.facebook.com/NVIDIAAI/posts/pfbid02pfXhcdapyvXePZ4mhgCbu77oYHnvDEZBoCJM7fRzo2FYDVkxgfzqcE2YDkng7Xk1l?__cft__[0]=AZWvXpaDTFrc3XUa1XKCOTLB2rQqwA6KkOnu1qbGifp8LOm6HnoDMllwD9-RmzAAF950B6dTw-EvMbl3WHC5z-3DlGH5X02FqxzmpuH8doiwM64bicTqQ99xGh3T3yKCj1xxQ77PV73vYL4uoxVxeL6eUUGl8ol7ZlhM-perjXLttN-F-NAWL_UDcAAv5dT5Qt33kTb2wts45Qx2Di8mw0N7ak7qkXRAiEXW40xOl4sVa2KR-JxSBjWQMfF35BPXRDs&__tn__=%2CO%2CP-R,15,0,positive,15
pfbid02bJTxR4bCW8UELxzh1bvbFKPqDShs78LGML4jy8ATAFmp4McSsGWgNozfy6aWVMCkl,NVIDIA AI,4,39,0,0,0,0,0,0,39,1,We’re honored TIME recognized NVIDIA #InstantNeRF as one of the  Best Inventions of 2022. Learn more: https://nvda.ws/3EjPzloThank you to our NeRF community for exploring this new technology to create 3D scenes instantly from 2D photos. ,2022-11-10T00:00:00,[],https://scontent.fcai19-7.fna.fbcdn.net/v/t39.30808-6/314708456_525820906070580_1182243183077178496_n.jpg?stp=dst-jpg_p526x296&_nc_cat=102&ccb=1-7&_nc_sid=730e14&_nc_ohc=I7mjmxo7fKkAX_r75Y9&_nc_ht=scontent.fcai19-7.fna&oh=00_AfC0EfbGUG_yvRS5YCMXZ065DUzvw49h-LA_sQXuZegc4w&oe=64E326DD,https://www.facebook.com/NVIDIAAI/posts/pfbid02bJTxR4bCW8UELxzh1bvbFKPqDShs78LGML4jy8ATAFmp4McSsGWgNozfy6aWVMCkl?__cft__[0]=AZXfhRNrBbhXMpVU29gg-P3LeCbb3Lx6Gi8qJNR8dVufCFM4M11Jr49QCxRmEHFI1nrb6fwjzIj6k9H7H9MlD_xaHUA_4scREKHJws9Tc3hgeCAWZVyGdASH1Ir8aWHC5V-ZTgTP_DEi_hpaT-4mIxzSR3brUvIuSIXUxfYAEYTU9_8owFVoxdGPO-yWDVQNTyuZch499bV3MpgGHe0kjuf2XlI5-ckEx_vZVrc3XTNCh4rf-rFLgCKqJgLZcWX6npk&__tn__=%2CO%2CP-R,43,0,positive,43
1072605366739065,NVIDIA AI,0,7,0,0,1,0,0,0,8,1,Why should data practitioners learn storytelling with data? A good storyteller knows how to draw in an audience and make them care about the subject matter. Learn the framework for data-driven storytelling to better communicate with customers and company stakeholders: https://nvda.ws/3NT1dGZ,2022-11-10T00:00:00,[],https://scontent.fcai19-7.fna.fbcdn.net/v/t39.30808-6/313430560_1072605363405732_5616804544938268945_n.jpg?stp=dst-jpg_p180x540&_nc_cat=107&ccb=1-7&_nc_sid=9267fe&_nc_ohc=-1OK3pHvi3QAX-li76H&_nc_ht=scontent.fcai19-7.fna&oh=00_AfCXU-TURVFc2kxMnb5d7SOpH84TyO04F6qiUeWihlMFTg&oe=64E35914,https://www.facebook.com/NVIDIAAI/photos/a.119492422050369/1072605366739065/?__cft__[0]=AZVAlVRuW5X21kXBT1b9xNPNQZBnOs5yCUUPt85pWD6AkTxAJsqStl7ij2qxgGBEuNwOpRSG-t3Kkf7J93kHIrJP6IZlSb0rK5VmUlbADl2Ue8ln54fIRF5P1vt0fF0-tPF-1bitI27l6v1F16eoDasZC0vVHNnODT0kFc-GLItLBD0_nB-uobcUqP5Aa7crRAzGEvM6-67LK4cIDuv3G2NS&__tn__=%2CO%2CP-R,8,0,positive,8
pfbid0M5buZXybxXAkbgwAEVS2yqQ6Y488WsG6prJDubpYu5mMEySarMnVLi4RnNJJX2rel,NVIDIA AI,0,17,0,0,1,0,0,0,18,0,NVIDIA Metropolis and #NVIDIAInception partner Covision Quality have created #visionAI software using NVIDIA #TAOToolkit capable of reducing false-negative rates in manufacturing defect detection by up to 90%. Learn more: https://nvda.ws/3UJ0Uko,2022-11-09T00:00:00,[],https://external.fcai19-7.fna.fbcdn.net/emg1/v/t13/12894680990447147683?url=https%3A%2F%2Fblogs.nvidia.com%2Fwp-content%2Fuploads%2F2022%2F08%2Fcovision-still.jpg&fb_obo=1&utld=nvidia.com&stp=c0.5000x0.5000f_dst-jpg_flffffff_p500x261_q75&ccb=13-1&oh=06_AbGk-4Nl8gFGQZIpcTLhxik8Mce-VSLVLhcE10pxZmReGQ&oe=64E03AD2&_nc_sid=dbad39,https://www.facebook.com/NVIDIAAI/posts/pfbid0M5buZXybxXAkbgwAEVS2yqQ6Y488WsG6prJDubpYu5mMEySarMnVLi4RnNJJX2rel?__cft__[0]=AZVK5qU-pu8co1AoTuOeCJKw1e7nO-D2iIVCJzHIZQuFZevJPZZyEzY8Tqd8z4NW1O8O_aCLlZ89P6cNy9b8MVxKk0Ru8fbGAorVXKPf4zLb5wq33tn-Ta2vmBwX-GVIYViSsRmyspyS0bCoupdYY9HhWm--1Z-d4qLKhFWovyCaOhzU9metmVuMrm6NlwAlTOtARbJj0shLi7-0_AbSmjop&__tn__=%2CO%2CP-R,18,0,positive,18
pfbid0UDcomrBDQeM8mf8bn6h9JihLtBgyDfmFxtZXCU3UifntYLizEA5cchnmR5FHmEfXl,NVIDIA AI,0,7,0,0,1,0,0,0,8,2,"Just announced at #BigCompute22, NVIDIA teams with Rescale to bring the full stack of NVIDIA AI software to every major cloud service provider. NVIDIA #AI will bring new capabilities to Rescale’s #HPC-as-a-service offering. Learn more: https://nvda.ws/3fNBEdT",2022-11-09T00:00:00,['blob:https://www.facebook.com/8b6aba40-e51e-4c1c-9825-e43ba2d327cd'],https://scontent.fcai19-7.fna.fbcdn.net/v/t15.5256-10/315211120_1592701614495622_9080954236588722666_n.jpg?stp=dst-jpg_p180x540&_nc_cat=101&ccb=1-7&_nc_sid=ad6a45&_nc_ohc=YyBUc0f3nzsAX9w4bvM&_nc_ht=scontent.fcai19-7.fna&oh=00_AfDCUuAOiaTXP1gJl2ie5P-VncVZH8IK1O8MC2x013QNpg&oe=64E390FF,https://www.facebook.com/NVIDIAAI/posts/pfbid0UDcomrBDQeM8mf8bn6h9JihLtBgyDfmFxtZXCU3UifntYLizEA5cchnmR5FHmEfXl?__cft__[0]=AZUhjUMZayYHJIfvCmjyK1WI8ONUZdQi_-iWQPuY9P3TL1l7Vr1Fg9Myki0t6mSP8EKN73Qm5yL_PPjNfmJm33QPA1zj3s3APxUGIx8vCbsyRBBOGCwWVVOfGz9qFt6w6Z719clfJbfGloPqTu_-ASclMJw-IOFFcxfAXqPN9G9gRs-1thb6Hb5Q7o_aQHzEISnVhjMmD-zouy1VNiK8sSt4gxdYWCWPemI2kuGQj-y62U8vNtYhkXjp7jiGxVU9DG4&__tn__=%2CO%2CP-R,8,0,positive,8
pfbid0KbmG7UPr6mzHViBHAo7bGyt5ZC3JA1BKteEFjobiGKLPHKdXi3w1sikk1oVkyHFDl,NVIDIA AI,0,2,0,0,1,0,0,0,3,1,"What's new in NGC?From services and SDKs to newly released AI frameworks, developers and data scientists can now readily access large language models in the #NGC catalog. https://nvda.ws/3TmHRv0",2022-11-09T00:00:00,[],https://external.fcai19-7.fna.fbcdn.net/emg1/v/t13/7629439398320478609?url=https%3A%2F%2Fdeveloper-blogs.nvidia.com%2Fwp-content%2Fuploads%2F2022%2F10%2Fnvidia-large-language-model-services.png&fb_obo=1&utld=nvidia.com&stp=c0.5000x0.5000f_dst-jpg_flffffff_p500x261_q75&ccb=13-1&oh=06_AbFFu5duDzUc-nD8-yXnR_lAz0VN82pfTQjHcoEVPPEoPg&oe=64E01AE6&_nc_sid=dbad39,https://www.facebook.com/NVIDIAAI/posts/pfbid0KbmG7UPr6mzHViBHAo7bGyt5ZC3JA1BKteEFjobiGKLPHKdXi3w1sikk1oVkyHFDl?__cft__[0]=AZW4JT8nViOcanSTgqetO8fQoFwgTaLTHH-KLoAiXVBQwS5hzXDETdhgnrh35lKJdwHQE2dzFBLGapJwPIQ4haPheCgCnLeDh1lnARdX3rOOP0fGcGHc174z3XwYPTFqZ8XSJJe2w8v5beWmZHirrL09VxuHUnYYXIr71XatZ3mtt8nSW0Qprs3hA1uQP1JdYuA-Wm6NeklFXnAiCYUQcXoH&__tn__=%2CO%2CP-R,3,0,positive,3
1071999423466326,NVIDIA AI,0,7,0,0,1,0,0,0,8,2,Check out our AI podcast and discover how a team of researchers has proposed harnessing high-flying AI-equipped drones powered to track the endangered black rhino through the wilds of Namibia: https://nvda.ws/3ThsT9y,2022-11-09T00:00:00,[],https://scontent.fcai19-7.fna.fbcdn.net/v/t39.30808-6/313921805_1071999420132993_2715208116613652394_n.jpg?stp=dst-jpg_p180x540&_nc_cat=102&ccb=1-7&_nc_sid=9267fe&_nc_ohc=cXoTNP5Cm1MAX-w-JRI&_nc_ht=scontent.fcai19-7.fna&oh=00_AfABjTrc59q5qjTe8vdR20zBpuiwmB9fp17znZg06AHpkw&oe=64E43936,https://www.facebook.com/NVIDIAAI/photos/a.119492422050369/1071999423466326/?__cft__[0]=AZVNiCpJibcXNeRg_KER7PoFqRSdruRQC8B60YgLRX0KdWfxnODwSR_1v9IEdeVieaqMBsgsTEMIgl3rxmTiinL5J9AHfNBsK3o-AU_R5_RtorUzc0YnDv41kBxXEvTRVpn-ulIm6_vA7QvbfaFgiUxjziXGJzDzQj3YSsp6iNTZEKbagGHz9V4KGOBDLdUfvAG-BVzzLQ8RqXH04hF6mT0R&__tn__=%2CO%2CP-R,8,0,positive,8
pfbid02x8DkHbquBVADd9r9aniXENbwagxpyJYjm5PP3pzkyDXoVunFDrmezrEbkiyeip4bl,NVIDIA AI,0,7,0,0,1,0,0,0,8,1,Join NVIDIA at #SC22 in this session on performance tuning with Roofline Model on #GPUs and #CPUs. Learn more: https://nvda.ws/3UkgSRT,2022-11-09T00:00:00,[],https://external.fcai19-7.fna.fbcdn.net/emg1/v/t13/7451376984629781293?url=https%3A%2F%2Fsc22.supercomputing.org%2Fwp-content%2Fuploads%2F2021%2F11%2Fsc22_OGimage.png&fb_obo=1&utld=supercomputing.org&stp=c0.5000x0.5000f_dst-jpg_flffffff_p500x261_q75&ccb=13-1&oh=06_AbFV4oLSTiNSeQm9KX6nwOoItkJ2m2Uaz7TWacxjYRbUqQ&oe=64E04C5C&_nc_sid=dbad39,https://www.facebook.com/NVIDIAAI/posts/pfbid02x8DkHbquBVADd9r9aniXENbwagxpyJYjm5PP3pzkyDXoVunFDrmezrEbkiyeip4bl?__cft__[0]=AZVfuRtepbYYdjQrsBUxGtAT36K_xXvSOuDoKAIeiPc--YHqDOdZqxyADN7tXO4qazcH6d7XmqCLudegAnevmGV4rHowDGjBY0eq5Fi8s4Aa5swMLlABFO8IWgAKwabBzdDtNBaM_OCL-fvNTl43PGq3P8LKjFEloR5ClYGSvQKt3IfKttGDVZiuncailxrSTOkhH_GTazfwzJ2eFcXMscbb&__tn__=%2CO%2CP-R,8,0,positive,8
1071469256852676,NVIDIA AI,0,6,0,0,1,0,0,0,7,1,NVIDIA Partner Network Elite Cloud Service Provider CoreWeave is among the first to offer cloud instances with NVIDIA HGX H100 #supercomputing. Read the announcement: https://nvda.ws/3fIEUHy,2022-11-09T00:00:00,[],https://scontent.fcai19-7.fna.fbcdn.net/v/t39.30808-6/314139166_1071469253519343_8202073669472904624_n.png?stp=dst-png_p526x296&_nc_cat=106&ccb=1-7&_nc_sid=9267fe&_nc_ohc=Cmha7masiPgAX8Uw3K8&_nc_ht=scontent.fcai19-7.fna&oh=00_AfCqZoYdn7ufpR7DuPWKiWdXxW_5f6PTen8C5IIOS9yzUw&oe=64E4086B,https://www.facebook.com/NVIDIAAI/photos/a.119492422050369/1071469256852676/?__cft__[0]=AZXq8Ij_46airSbdk27M4cbSdlODcY_J0bW7Y_JVqJJqpB8dAz401Z0-DG_uikiUS9D26ci7wB9zPeKnz1O00FlA6OC1xBP75vsw_TtMB0kqSSsj_JKOlk14l5HgWq-bOkJcy3xUg0eWQLYAsUKSd_TgvvPumbdASLXz52dvdmSGkvgl7COgtUYjBsWiGOGj4cgl-ko7kfjU9usVMbiAgKwB&__tn__=%2CO%2CP-R,7,0,positive,7
1071380906861511,NVIDIA AI,0,6,0,0,1,0,0,0,7,1,Storytelling with data is an essential skill for data practitioners. Get tips on how to improve your data storytelling skills to better present datasets to non-technical: https://nvda.ws/3fLXa2s,2022-11-08T00:00:00,[],https://scontent.fcai19-7.fna.fbcdn.net/v/t39.30808-6/315163573_1071380903528178_7669870737782107100_n.jpg?stp=dst-jpg_p180x540&_nc_cat=110&ccb=1-7&_nc_sid=9267fe&_nc_ohc=VhjP2V-W8uAAX_pAKkz&_nc_ht=scontent.fcai19-7.fna&oh=00_AfBRWlNHJhj4vtUHbSUcivQfRx4TrtLoTlHCsngMXRMVZg&oe=64E3A5B6,https://www.facebook.com/NVIDIAAI/photos/a.119492422050369/1071380906861511/?__cft__[0]=AZVcUB7wIY0x8seMn6rVKDzUz_4NoPYabpOi57glwbXPyVY-R_0ZdWWbdv-x6S4oa4mjIZWcw9TPahXrwSeHHmjlKITbLxf9N3CQeG-8yrcuwSxvx1RCqm4BvEFBXW-zpwAEF7qn6guLKaO_Qvz16CnktOmlyrS-iMEBGrAZ9_uFh6Ox_NKIEV3O5bBRrf1auLHCuShADa3CuTU64ZZ5w7a0&__tn__=%2CO%2CP-R,7,0,positive,7
1070982900234645,NVIDIA AI,0,9,2,0,1,0,0,0,12,1,Curious to know how @NVIDIA is supporting #innovative #tech #startups across the globe? Join the open house session to explore NVIDIA Inception. Register now: https://nvda.ws/3WwoAKs#developers #metropolis #innovation #nvidiainception,2022-11-08T00:00:00,[],https://scontent.fcai19-7.fna.fbcdn.net/v/t39.30808-6/314378382_1070982890234646_2569207995106411812_n.jpg?stp=dst-jpg_p180x540&_nc_cat=105&ccb=1-7&_nc_sid=9267fe&_nc_ohc=1Q8hlLV9TB4AX8srUK4&_nc_ht=scontent.fcai19-7.fna&oh=00_AfACi7rCfcFymXN1FglvRQUqBNtDxLsqR9ncijuhmVgecg&oe=64E447A0,https://www.facebook.com/NVIDIAAI/photos/a.119492422050369/1070982900234645/?__cft__[0]=AZXEi9Uo-6WEgvzcqc3WZq1Dpi2qEQHZQ2dJBonnj6e3nlhP1y_kOf92ke6XAtdU91dUZp8BQer5vrPUnypYmERU38UMVFzm8SKBBN_C_Ws6mzqJcHiOePasWKeIXsw2UH8Nj9rKURd2LCqwYn-J1MEFxTCv4m-ocO77pVenrTC2W9coX7KwUSW_WC7uw8qjdESgW4jDyb1O7L36nhU5wB3j&__tn__=%2CO%2CP-R,12,0,positive,12
1070825770250358,NVIDIA AI,0,13,0,0,1,0,0,0,14,6,Learn how to implement multiple AI-based approaches to solve a specific use case of identifying network intrusions for telecommunications. Register now for the 11/16 workshop: https://nvda.ws/3U5bdiP,2022-11-08T00:00:00,[],https://scontent.fcai19-7.fna.fbcdn.net/v/t39.30808-6/314701639_1070825766917025_8456944975785908994_n.jpg?stp=dst-jpg_p180x540&_nc_cat=100&ccb=1-7&_nc_sid=9267fe&_nc_ohc=0POCYJhXa3gAX9SBnP6&_nc_ht=scontent.fcai19-7.fna&oh=00_AfD3vEL8djhkvPpqVL0WDtOBlpcMr3WKCBI6vW1udKgnpA&oe=64E3285A,https://www.facebook.com/NVIDIAAI/photos/a.119492422050369/1070825770250358/?__cft__[0]=AZVbLnPIGxrPGPs9DLB6SpOUQIUiqYrZg5ohciCjzxiADuyt5b-82Cj3D7FNd26gqiD6xbduk7Aq4mLLmKfeVLvmNu8yY-YX0j9ez6z8Ok9s7ZZaTXJjkgaBCes1Dz5L-lYh6oH7UEAoQfwJoa3iShpyIv29RH_GHq0xEmrhSgAPTFXpNAkmTFTtfuhIabV_r5TNHvCTwMqygkV2Mue4fDbz&__tn__=%2CO%2CP-R,14,0,positive,14
1070806316918970,NVIDIA AI,0,5,0,0,1,0,0,0,6,2,Financial institutions can use a new #machinelearning method to optimize yield curve estimation from U.S. Treasury securities. Learn more from Stanford University and NVIDIA in a webinar on November 16: https://nvda.ws/3DPPlRm,2022-11-07T00:00:00,[],https://scontent.fcai19-7.fna.fbcdn.net/v/t39.30808-6/314904363_1070806310252304_4942233362436962171_n.jpg?stp=dst-jpg_p180x540&_nc_cat=103&ccb=1-7&_nc_sid=9267fe&_nc_ohc=hv2jGiZef6UAX_vrmEX&_nc_ht=scontent.fcai19-7.fna&oh=00_AfAm0kOVvU8UA-0pZG5XQUJSzzBRVWvuoMK3xb8OZNX31g&oe=64E38B08,https://www.facebook.com/NVIDIAAI/photos/a.119492422050369/1070806316918970/?__cft__[0]=AZW2HVxuQAqzR0cmkvMLfQ8Spa8NwWtEL4Y-WqsSHibIY2AW48Va6u_a0seHtCiBszbBDBEw5qrLl1ZDnZOmsmLPmE1kn1eWyM-aYXZhv6OjCqZKDGOq5Xfxy4JyEG7JRv9s2kcebR0XlD9Lx4iWTHpEzojDMAbJIcFNx69Cd7SWcdH020tCc2GFRglC65O8tkN5n4gmdO2uDQ-QjxFiB5TA&__tn__=%2CO%2CP-R,6,0,positive,6
1070780816921520,NVIDIA AI,0,14,2,0,1,0,0,0,17,6,"Join the NVIDIA Triton and TensorRT community and stay up-to-date on the most recent product releases, bug fixes, news, and more. https://nvda.ws/3cP6uRw",2022-11-07T00:00:00,[],https://scontent.fcai19-7.fna.fbcdn.net/v/t39.30808-6/314739254_1070780806921521_4874411015013916161_n.jpg?stp=dst-jpg_p526x296&_nc_cat=105&ccb=1-7&_nc_sid=9267fe&_nc_ohc=buznKY3CiR8AX_ZSBtF&_nc_ht=scontent.fcai19-7.fna&oh=00_AfCTTQIA1LMubj-DCE6gO7iviH9nGYC6VKp7WN-dcIk-6Q&oe=64E333FC,https://www.facebook.com/NVIDIAAI/photos/a.119492422050369/1070780816921520/?__cft__[0]=AZXSfOjONcJmgJX4I7uO_7vutsXqeweyVDSdgiSMI7afuHOo__vM4ufKsNsIEWdibXDeHaBIM0sfRKeOgK9TlPLz6SEskQWIkwgkgD4LCVSoOc3HyZalYTcoECNV6Y3ZwvANLD_tzQlI90UVaaRpU92xSlEByFle-20pqNu7qU47xc_7xlvAuA3t16iUnOFZThZUwGLZdu6QMRBtKXKt4OaH&__tn__=%2CO%2CP-R,17,0,positive,17
pfbid024WE2hTnVvtUqnkMu4U4go7sWEkKKmJHLoQK7wV8iM6CH89r7cHzRy6LJGr9LtkQrl,NVIDIA AI,0,6,0,0,1,0,0,0,7,1,"At #BigCompute22, Timothy Costa, Director of #HPC and Quantum Computing Product at NVIDIA, will present his talk: Accelerating Science with Innovation in HPC Software. Be sure to tune in on November 9th at 12:45 PM PST. Register today: https://nvda.ws/3fJOzNP",2022-11-07T00:00:00,[],https://scontent.fcai19-7.fna.fbcdn.net/v/t39.30808-6/314050383_1283659775743016_1169516622490016496_n.png?stp=dst-png_s960x960&_nc_cat=111&ccb=1-7&_nc_sid=9267fe&_nc_ohc=jl4r6cddYfwAX8O83Ue&_nc_ht=scontent.fcai19-7.fna&oh=00_AfCQG15zzNDFeDQaKKUBUZxgxhWjPWVu26Nmaq9a9Fn7CA&oe=64E41613,https://www.facebook.com/NVIDIAAI/posts/pfbid024WE2hTnVvtUqnkMu4U4go7sWEkKKmJHLoQK7wV8iM6CH89r7cHzRy6LJGr9LtkQrl?__cft__[0]=AZXxkdMvGHrDDlzUBqYJ9j48ZAZKU1mtCWU67pYc0hzKFFF4yIdMqjjLQs8LS5f0zXk8yD3RcMDV4MWSOq-LHFurWS67vKqcuqU1b7X35x70noNoyYWTvRtcAJYJNJetuC0HfCavHp7s1zAzx1HBSBfOcifn0xxMwW7GE8ImhRp_M-ORAUw5PtdLOs9IWzVywVrDuEoqw9eNfdYK8AfKtkTJPz55wNci7aihJdtg4QvKUBQjkfzqeAofq4_QhJ5wwY_NJFGsjCjkXfnZYsICgUs8&__tn__=%2CO%2CP-R,7,0,positive,7
pfbid029sUSFq95wnLK3sfE2kxs5vVAMdBjLpUpzu7wkm57AFXcTUBM2CtkLvKcjPNL4S31l,NVIDIA AI,0,11,0,0,2,0,0,0,13,1,Large language models are powering some of the world’s most advanced AI applications today. Check out this blog to learn how to deploy public #LLMs using NVIDIA NeMo Megatron which includes NVIDIA Triton for #inference requests. https://nvda.ws/3t6kzi6,2022-11-07T00:00:00,[],https://external.fcai19-7.fna.fbcdn.net/emg1/v/t13/13600024094116998552?url=https%3A%2F%2Fdeveloper-blogs.nvidia.com%2Fwp-content%2Fuploads%2F2022%2F11%2Fnemo-deploy-public-llms-featured.jpg&fb_obo=1&utld=nvidia.com&stp=c0.5000x0.5000f_dst-jpg_flffffff_p500x261_q75&ccb=13-1&oh=06_AbFX_iuA1nYUC9M_7wnw4rKJtalpANN1BqMGt8CPMRbSjw&oe=64E04F1A&_nc_sid=dbad39,https://www.facebook.com/NVIDIAAI/posts/pfbid029sUSFq95wnLK3sfE2kxs5vVAMdBjLpUpzu7wkm57AFXcTUBM2CtkLvKcjPNL4S31l?__cft__[0]=AZUvo4PPVrEVjDV8cLr_4zcFd2qOe5c1Yoonpbr-Od6exJxHs3qTBjaU8_ESoghIbVbus4gCPZ_citD2UYNrff7UenWB4IT2NWBqaYkM4GVWMC1qdk3K3I1TCB9R-lpCF6Lu6AKn-9bkgmAytzMUWWWJVtK-hYF8ucupoVi4rLvjHct8gKA1evuvTX8X_oX-fJ3DgMkO_zq23NskWJTh6X9_&__tn__=%2CO%2CP-R,13,0,positive,13
1070728153593453,NVIDIA AI,0,10,0,0,1,0,0,0,11,0,"2 days until showtime! Join our Retail Edge Computing 101 webinar to learn the fundamentals of retail edge computing, how solutions integrate with your current infrastructure, and which applications to deploy at the edge versus in the cloud. Join us at https://nvda.ws/3W6Jjo0",2022-11-07T00:00:00,[],https://scontent.fcai19-7.fna.fbcdn.net/v/t39.30808-6/313428559_1070728146926787_7408024239325369192_n.jpg?stp=dst-jpg_p526x296&_nc_cat=111&ccb=1-7&_nc_sid=9267fe&_nc_ohc=Nq5mNOkAzqsAX_A8oWM&_nc_ht=scontent.fcai19-7.fna&oh=00_AfAZyKqvXDvGi-NCx17v8wmW-oEzRPNTLuf2Dtmwf8VE8g&oe=64E2D446,https://www.facebook.com/NVIDIAAI/photos/a.119492422050369/1070728153593453/?__cft__[0]=AZXs6erXYzCGTFHV6fNfUQ-n42bcZRTodcIe0NGI4UcB3Kb-F78oJfeWkHJmvmujfi4m3vu0dXa74MeALo1hVAAoja6Jl1BGSO1iqhqTrvUDWOQIlKN25Uwx9yB7HC8rlynrUoiEW6Yd7nPkGPlUqXc-bM1dnvQbDKM1hpIMerLYljxrXkX5DXFfonbO-WJpZndQrao1gNb5S7GQda5qOIcO&__tn__=%2CO%2CP-R,11,0,positive,11
1068852837114318,NVIDIA AI,0,8,0,0,1,0,0,0,9,1,"What's new in NGC? From services and SDKs to newly released AI frameworks, developers and data scientists can now readily access large language models in NGC catalog. Get the full rundown in the new blog post: https://nvda.ws/3E1ds0J",2022-11-04T00:00:00,[],https://scontent.fcai19-7.fna.fbcdn.net/v/t39.30808-6/313412695_1068852830447652_6611241080206591976_n.jpg?stp=dst-jpg_p180x540&_nc_cat=108&ccb=1-7&_nc_sid=9267fe&_nc_ohc=O7DK894zBt8AX9nySy6&_nc_ht=scontent.fcai19-7.fna&oh=00_AfDjjbqA9RBySicC6dMNUQCtgP-92GUo2qUOGRCfC8qeBw&oe=64E2C58C,https://www.facebook.com/NVIDIAAI/photos/a.119492422050369/1068852837114318/?__cft__[0]=AZXQNUEK90l_kH7FwGX3vmuJeCse-78PFBo82MrdN1JEretNPPg4y0iD8-AtTo20FZ53YT9wGjXchffvPEwOeNFKvMy9lR9XK1ILrmIvVuK-I-xAZy6EglLMRltrKH773j1TIjlWKTGsdcPmUy4g61l1yFeTw8dgXwJvP2SkYuDBeAInsqvpFTcaUwdVtWgi8hvuWcrsmmS8D3lkiTy7szyV&__tn__=%2CO%2CP-R,9,0,positive,9
1068801650452770,NVIDIA AI,0,8,2,0,1,0,0,0,11,1,Successful use and growth of AI in an organization needs an understanding of all the facets of #AI #inference. Explore real-world use cases and common pitfalls that will help your team optimize AI model deployment. Download the E-Book. https://nvda.ws/3Du3zIG,2022-11-04T00:00:00,[],https://scontent.fcai19-7.fna.fbcdn.net/v/t39.30808-6/313270609_1068801647119437_7855486861174706594_n.jpg?stp=dst-jpg_p526x296&_nc_cat=100&ccb=1-7&_nc_sid=9267fe&_nc_ohc=qr1t3NoryugAX9YydzP&_nc_ht=scontent.fcai19-7.fna&oh=00_AfCvD63lQFzEZR9mQuuPiMetPwjey1G6jD-rEUYvbR5_Fw&oe=64E384C7,https://www.facebook.com/NVIDIAAI/photos/a.119492422050369/1068801650452770/?__cft__[0]=AZXtvBi2WXlVjvThTx9uF9XUPZ5lcwjoaPnzskEGaj4vMayAO_CM9iJXuO1Doi3rq0xxHNa5Eyh7mx4qlZ2VYXYPGMNgUYhRIHNXpBTQCF9ZEtXY1mdcvhqX0tTsX9dRbvWJMzHN60CWjDbv7_35NsdvZ21SWsCqVRDjBbQrKgBRe1voWF9Otnl7KOCJa1SeBKqH4k-7wCwFacZYn5C4WnK-&__tn__=%2CO%2CP-R,11,0,positive,11
1068741093792159,NVIDIA AI,0,6,1,0,1,0,0,0,8,1,"How do you protect data sovereignty, reduce cloud costs, and future-proof your infrastructure investments? On Nov.10, top experts—including NVIDIA's VP of Enterprise Computing, Manuvir Das—weigh in on how you do all that in the real world. #MLOps: https://nvda.ws/3UsyvyV",2022-11-04T00:00:00,[],https://scontent.fcai19-7.fna.fbcdn.net/v/t39.30808-6/314063132_1068741087125493_1463809850694055516_n.jpg?stp=dst-jpg_s960x960&_nc_cat=102&ccb=1-7&_nc_sid=9267fe&_nc_ohc=a7mO7lP9alYAX-SnnZk&_nc_ht=scontent.fcai19-7.fna&oh=00_AfCE8378bfVPD7Py_-LNReeaz3hu0zhsl4Rr30HSS6rAgg&oe=64E40192,https://www.facebook.com/NVIDIAAI/photos/a.119492422050369/1068741093792159/?__cft__[0]=AZVzyqGt6THuWKPsIIr5xAjEcrzVLtI3G_o37LqC4ghKPaxAZt235Gt4aEbzXS09sIU_Ln8WhFZm1c2ubOqJM_uUIoHJynVTD63cXtZHNiSftWInTS2n2bjllf5bd4SMuQ-wgVAJa6uLWrUHcbnXtoxe1vIhHkeLk-ZTdt7yMRnuQWwRuki4r_i9aIJVset5Wprdbt0g6PU8RRDb58lFDHGV&__tn__=%2CO%2CP-R,8,0,positive,8
pfbid03mR67Eq1SYsaaFB9JwiVgC69sq5uPvpqAtePzgMpmD9k6vN72eAaWyUA7TSFuM13l,NVIDIA AI,0,5,0,0,1,0,0,0,6,0,"Many organizations are using Clara Parabricks for fast human #genome and exome analysis. Learn about two recent research papers highlighting its speed, accuracy, and cost savings for de novo and pathogen workflows. https://nvda.ws/3fA2ZjA",2022-11-04T00:00:00,[],https://external.fcai19-7.fna.fbcdn.net/emg1/v/t13/2755495449868677247?url=https%3A%2F%2Fdeveloper-blogs.nvidia.com%2Fwp-content%2Fuploads%2F2022%2F11%2Fimage3.jpg&fb_obo=1&utld=nvidia.com&stp=c0.5000x0.5000f_dst-jpg_flffffff_p500x261_q75&ccb=13-1&oh=06_AbEb1kpCFfFQqk53OVtA57MLM0ANqThfZWaIsg8vb9HGIA&oe=64E05D6A&_nc_sid=dbad39,https://www.facebook.com/NVIDIAAI/posts/pfbid03mR67Eq1SYsaaFB9JwiVgC69sq5uPvpqAtePzgMpmD9k6vN72eAaWyUA7TSFuM13l?__cft__[0]=AZUfNyOMbmHtRq0I3anNe7nlhW8UjPkAbC1D4CpfyEFmcrNn0zh1pNe-INM_d5wqLprrd-nj3ov5eoVEEGi10qdtuDC2YGA6xRQ6ZgFhSe9NOppedEvfg1dOXhevLcdHoTjCoJWYGAwiaN5_J_efT2TYO3YY8vGKGEJxu1GEUVwXhUwUmL8ztbBbFMfNSi5HCsT0SaTxsh09otLeDlbNRNfs&__tn__=%2CO%2CP-R,6,0,positive,6
1068226673843601,NVIDIA AI,0,23,0,0,0,0,0,0,23,4,"Understand what works, what doesn’t, and why in #CUDA programming.Gain a new perspective to tackle your next optimization problem from this on demand session for beginner to veteran developers. https://nvda.ws/3TRMXjU",2022-11-03T00:00:00,[],https://scontent.fcai19-7.fna.fbcdn.net/v/t39.30808-6/312602215_1068226667176935_6698178418963373539_n.jpg?stp=dst-jpg_p526x296&_nc_cat=107&ccb=1-7&_nc_sid=9267fe&_nc_ohc=AWukVjtLH9gAX_5Zq-s&_nc_ht=scontent.fcai19-7.fna&oh=00_AfDRh5NQ5R8gU-WAQhcs-rhRyuBjZvHlVJZt5H7Xfl_v7A&oe=64E2D39D,https://www.facebook.com/NVIDIAAI/photos/a.119492422050369/1068226673843601/?__cft__[0]=AZWqX56FJGqlzSgV7HXgnMbzEMA7B3LAbZ0YCHxjzGvwvqCr1GwpMccox3XyczDvgn1hDRpfJvz0L1F9azXgZ9EhCGZ6DFUZoORKoFNvDZcY9E0llA-g8gcUryI5amQkem-YB1XuKGje8IEIQ46UuY2Zsw2UuYBmH3lPziSbgLjPTlJld7Afrez2g59lUppZx86kovRZ2JV9UABABF1a2Tcd&__tn__=%2CO%2CP-R,23,0,positive,23
pfbid02wMSjLWQJYo5ePrbEmzg9pFsRwgV2cRea4HL33aaPVRcEeNc1UMLbUeqDgmabNyFwl,NVIDIA AI,0,26,3,0,0,0,0,0,29,1,Big Compute 2022 is less than a week away! Join us on November 9th and be sure to tune into the Keynote featuring NVIDIA CEO Jensen Huang and Rescale CEO Joris Poort. Register today! https://nvda.ws/3DYgQJX,2022-11-03T00:00:00,[],https://scontent.fcai19-7.fna.fbcdn.net/v/t39.30808-6/312441470_1280729319369395_8296100234875687312_n.jpg?stp=dst-jpg_p526x296&_nc_cat=105&ccb=1-7&_nc_sid=9267fe&_nc_ohc=O8xvOQUsTcYAX_pB04O&_nc_ht=scontent.fcai19-7.fna&oh=00_AfChYkYqdtihogz1zXe6ZgQ1AggaL1W11WTvZF3HDzk1tw&oe=64E40E29,https://www.facebook.com/NVIDIAAI/posts/pfbid02wMSjLWQJYo5ePrbEmzg9pFsRwgV2cRea4HL33aaPVRcEeNc1UMLbUeqDgmabNyFwl?__cft__[0]=AZUR6n82NOH28ubdw3JGRHmKLb1SD5F2jaZc3_06Xf4BVindVEa2BNi88OcyrEARXkl-uEDa0TCF2BGupusxSMO2JFmDd9Y4dWToNU-gky7JEJ7b4YmopAnSe6q-FVn16Ex49X3WX6qQurNmynnR86_XAIpSL7God_sD4CRkiVKkpcJwcVS04NS8-LbiQAqDRKg04cruaYigZjbafSqsocJnOEqOaaZwPlYT68XxlWbBg_jALTWhQxv-v7e-8YK5EcoHeQ1Hwc3GUPuSP-ENelEA&__tn__=%2CO%2CP-R,29,0,positive,29
pfbid0nXU8Dd71nd7CG56NAPJBeQSxV834GNAw1xv2gRVyJh5neEjULASTwQCW7LvgsZMHl,NVIDIA AI,0,23,0,0,0,0,0,0,23,0,"#NVIDIAInception premier partner, Skycatch, Inc., builds computer vision software and NVIDIA Omniverse-powered #DigitalTwins to make sites more safe, efficient, and sustainable. https://nvda.ws/3T4wSGu",2022-11-03T00:00:00,[],https://external.fcai19-7.fna.fbcdn.net/emg1/v/t13/13425561063711547070?url=https%3A%2F%2Fblogs.nvidia.com%2Fwp-content%2Fuploads%2F2022%2F11%2Fskycatch.jpg&fb_obo=1&utld=nvidia.com&stp=c0.5000x0.5000f_dst-jpg_flffffff_p500x261_q75&ccb=13-1&oh=06_AbFI0x37ZUKvAacgL63a4k39F70bQ0bU7E_ncVbNjmumQQ&oe=64E037AB&_nc_sid=dbad39,https://www.facebook.com/NVIDIAAI/posts/pfbid0nXU8Dd71nd7CG56NAPJBeQSxV834GNAw1xv2gRVyJh5neEjULASTwQCW7LvgsZMHl?__cft__[0]=AZWzD5cUNpA-q9I0BLl2E-8EVtPZPeG0jaKxW3a6DtxIvM01nvbYtx8GK0EWczL8rNub1eAj6iQ-tZeLYNu8PtpI0DpMYTRBaJqb8AaXvNFW5z_nfD7DOj33ZtTGPnMG0l817Kqfs-WkpgJvihTgpZn_-tUzROgKZ7SyxRhhrrgkAMjwPBQraV5wJlh3aq9tvm2UKxaVKBFR8AHbI5juczy0&__tn__=%2CO%2CP-R,23,0,positive,23
pfbid0iH6BBAnMYSkkKfndF6sn2mRjdtU17bG4kJk1Wi3Ex2LKMomBGzV2NVU58E37dQQ3l,NVIDIA AI,0,6,1,0,1,0,0,0,8,0,"By harnessing the power of the NVIDIA Jetson AGX Orin, #NVIDIAInception partner Cartken created delivery robots leveraging the Jetson Orin’s capability to handle multiple sensors, cameras, and more. https://nvda.ws/3U3SQe1",2022-11-03T00:00:00,[],https://external.fcai19-7.fna.fbcdn.net/emg1/v/t13/17231768668706912349?url=https%3A%2F%2Fblogs.nvidia.com%2Fwp-content%2Fuploads%2F2022%2F10%2FCartken.png&fb_obo=1&utld=nvidia.com&stp=c0.5000x0.5000f_dst-jpg_flffffff_p500x261_q75&ccb=13-1&oh=06_AbEVJCLOQ6WCb31oeuicp_WciTPo9tYGuLLf4xYUAd_rwQ&oe=64E04171&_nc_sid=dbad39,https://www.facebook.com/NVIDIAAI/posts/pfbid0iH6BBAnMYSkkKfndF6sn2mRjdtU17bG4kJk1Wi3Ex2LKMomBGzV2NVU58E37dQQ3l?__cft__[0]=AZUDuM3v40QyA67Rngm9MqFj13dilfhVf2YN4FFGt4Z21Xbo8EMBP3difbLPLvgH3DjfJ1If2fjTK7MBDiLBffGAJ0rrAgkLJrulnKJFEgqA7ErQSeqJJr_-Q1ctKzbJ2cHfpQt_djgRE7C3_yq5wchr-bseLA9Yels0ls1o_FKV4Vpo2kR-mfvYo9ZqbJ9l2lsGHyUdJDHt0KRz1rvirYZ_&__tn__=%2CO%2CP-R,8,0,positive,8
1068155963850672,NVIDIA AI,0,15,1,0,2,0,0,0,18,0,"Join the NVIDIA Triton and NVIDIA TensorRT community to stay up-to-date on the most recent product releases, bug fixes, news, and more. https://nvda.ws/3cP6uRw",2022-11-03T00:00:00,[],https://scontent.fcai19-7.fna.fbcdn.net/v/t39.30808-6/312716590_1068155957184006_5819494681094297058_n.jpg?stp=dst-jpg_p526x296&_nc_cat=102&ccb=1-7&_nc_sid=9267fe&_nc_ohc=3QgmS9wliXwAX-gehH2&_nc_ht=scontent.fcai19-7.fna&oh=00_AfDr-pdC5CXkY50D9784U6tSZ_lRr-G-Q_eI3EGex5CHWQ&oe=64E2FFCD,https://www.facebook.com/NVIDIAAI/photos/a.119492422050369/1068155963850672/?__cft__[0]=AZUlOfO-3kV3hAqnm9-qlCMXK-5ukF8pDISXBVF0PkkfYvI_22a-fcoxG9uYFyNOSJy5P_i4g3Q47J0ossrdVgpdvAvfJCPGUvufPnI7h2XDFH_mlUEiy6X8RwUttVayeSqK6RqHrIyyYJzJMRvRSgmI2cYPtGkV3G6brtbly6NpDmTgk1zWgAuflDDPRd9ej4fg81MwxpSvuNVKHTk8ba7A&__tn__=%2CO%2CP-R,18,0,positive,18
1067744770558458,NVIDIA AI,0,11,0,0,1,0,0,0,12,1,Join the open house session and learn from experts about #NVIDIA #Metropolis Register now for the 11/17 webinar: https://nvda.ws/3DVv7qJ#developers #startups #AI #innovation #nvidiainception,2022-11-03T00:00:00,[],https://scontent.fcai19-7.fna.fbcdn.net/v/t39.30808-6/313168231_1067744767225125_8913099771313192051_n.jpg?stp=dst-jpg_p180x540&_nc_cat=103&ccb=1-7&_nc_sid=9267fe&_nc_ohc=2Jw4zSZp0ToAX82ktSU&_nc_ht=scontent.fcai19-7.fna&oh=00_AfC8GPaCgFA40hJRiw5NReWXiT6ei-HtT6mOnoLH3fCxvQ&oe=64E3F3C9,https://www.facebook.com/NVIDIAAI/photos/a.119492422050369/1067744770558458/?__cft__[0]=AZUFxbq7QkpkDVDjcu6URCRtOyeHn8PYbk6OXqVmRHArdopXS__FSD-rMqIvzrRiECzHL2r89AmC-0I5LvAt2HiHAl7j3ThF0IUdbj-egk-_vfiyQVvzGqNEwm7EJeDoFEaYc4TPA5Qw90Sk2IY2zkBvsaRgTZvl8RkaW5GEsb7-1oTAy6jueZh6bj_qtGG6Qf5_nNxELd8j34qnfDDUKajo&__tn__=%2CO%2CP-R,12,0,positive,12
1067560713910197,NVIDIA AI,0,5,1,0,1,0,0,0,7,0,Detecting cyber-threats in near real-time has never been more important. Register for NVIDIA's upcoming webinar to hear from Booz Allen Hamilton on the latest approaches to securing sensitive data and how federal agencies can get started today. Sign up now: https://nvda.ws/3U8aE7g,2022-11-03T00:00:00,[],https://scontent.fcai19-7.fna.fbcdn.net/v/t39.30808-6/313417279_1067560710576864_1455542260152024185_n.jpg?stp=dst-jpg_p526x296&_nc_cat=105&ccb=1-7&_nc_sid=9267fe&_nc_ohc=IK2c-JpnAxEAX95C50R&_nc_ht=scontent.fcai19-7.fna&oh=00_AfC3SocMR6u-mCeFd6Ud22NK1Ioq_pqJwYu6WyD9x9FZbw&oe=64E33BB1,https://www.facebook.com/NVIDIAAI/photos/a.119492422050369/1067560713910197/?__cft__[0]=AZWfxdds32w6bBZOT1BCjREjLM4382dxBVcdBgFHgXSpvRJrMU3uuX9CRYBrgLIUnZOjlFIO22VE2_PRI4T2GTS6VArKfoW8FtVKCG5ZUhwzboAkzszJTlIm0bY0WiVLPfQO8-r2THpeB8nxmGSW65zQbo0GJX6xpKxgJpMhe9qqzoB1JPx5sWcKyp_xL2BzkjLGb88kBSN-GYuFz77HlFKG&__tn__=%2CO%2CP-R,7,0,positive,7
1067517367247865,NVIDIA AI,0,12,4,0,1,0,0,0,17,2,"With a mix of real, simulated, and synthetic images, University of Wollongong UOW  researchers reveal their unique process of building a visual dataset for training computer vision models that can detect hydraulic structure blockages: https://nvda.ws/3WtZnQT",2022-11-02T00:00:00,[],https://scontent.fcai19-7.fna.fbcdn.net/v/t39.30808-6/312871437_1067517363914532_3035804612637140005_n.jpg?stp=dst-jpg_p180x540&_nc_cat=102&ccb=1-7&_nc_sid=9267fe&_nc_ohc=8VokRliBeMkAX-SKrot&_nc_ht=scontent.fcai19-7.fna&oh=00_AfCAncBB-AgKrEJn_40WZA_UEyXxXwKItMFe-IHLL-XMwA&oe=64E37321,https://www.facebook.com/NVIDIAAI/photos/a.119492422050369/1067517367247865/?__cft__[0]=AZUHiBAhbjZkXt-WQ8RW1GEN2-G5kHKlDnJ_Z6r5N3s1Mzwn6Z0ETRrsGI4j908tP0aCpRiEAU_MsT3Jtu88MvGqwdN7Tr1kn4PbLW0HxL_sqIgrZotNxrsLEyZFBpcvQ--1OztgXBkbQbM0jis4jY8paO2pRXmEZvCvvH-vg5lsVoLr4hMQIMB1YUfncq3xuSdy34m4_eJ29ZnwKZjJZt1_&__tn__=%2CO%2CP-R,17,0,positive,17
1067445300588405,NVIDIA AI,0,8,0,0,1,0,0,0,9,1,"At #NetAppINSIGHT 2022, explore the latest on AI infrastructure solutions powered by NVIDIA DGX BasePOD built on NVIDIA DGX systems with AMD EPYC CPUs: https://nvda.ws/3h1Sl5w",2022-11-02T00:00:00,[],https://scontent.fcai19-7.fna.fbcdn.net/v/t39.30808-6/313433121_1067445297255072_1187433939863895966_n.png?stp=dst-png_s960x960&_nc_cat=109&ccb=1-7&_nc_sid=9267fe&_nc_ohc=YcGYhF15QRQAX8fK1OZ&_nc_oc=AQmalSFQPwvxar11m5ATidjhdYUW8EwBiTwgQaIk06x_azNJ_VihlnNvhjqJYs46Y2g&_nc_ht=scontent.fcai19-7.fna&oh=00_AfCfxQh_etv_kfj3z8IABrQomxXPgGbsU8CCWzLVS7-XmA&oe=64E3FD48,https://www.facebook.com/NVIDIAAI/photos/a.119492422050369/1067445300588405/?__cft__[0]=AZVuhaeFcbnz67tCCpY7U8DsK1hSNeRR_EoI9ihbvnfhcxW9YSYnuuOBMEON2d-bL8-CDuotGVYTnk7o-HQu8us0Ac5KjjO1LOFcOlny_JFtu3M1Njho3ZW2PsxulHwZt1YTcHcWjWQ8_VIrIEEB0rktei-ef5dNnGSI4TQ3cM1Mo3oSrtphcrNu0Qj_yn7NAHVuVO4EvnrI8H0cDmnLaA_v&__tn__=%2CO%2CP-R,9,0,positive,9
pfbid028qdJUmYbCP9urtYkjDQrHAZW4J7pLmF2Rt2PBKeLA1FbsHvWgLm59X2fPcUgiNzyl,NVIDIA AI,0,16,2,0,1,0,0,0,19,1,"With NVIDIA Isaac simulation technology, #robots can earn a PhD in the blink of an eye. And with NVIDIA DRIVE Sim, autonomous vehicles can drive millions of miles in a wide range of simulated scenarios so they navigate safely. Learn more: https://nvda.ws/3fpGa1L #NVIDIAstory",2022-11-02T00:00:00,['blob:https://www.facebook.com/32e63b3b-ffb2-4c4a-aa0b-d12c4f0d2beb'],https://scontent.fcai19-7.fna.fbcdn.net/v/t15.5256-10/311958858_953483248946248_1698048184042885619_n.jpg?stp=dst-jpg_p960x960&_nc_cat=102&ccb=1-7&_nc_sid=ad6a45&_nc_ohc=i4Fu_sFgg7YAX9koomw&_nc_ht=scontent.fcai19-7.fna&oh=00_AfCF4RWxscnZh-GSxBM1PVNtDVJiogw_EtF5jK165K2GOA&oe=64E3970C,https://www.facebook.com/NVIDIAAI/posts/pfbid028qdJUmYbCP9urtYkjDQrHAZW4J7pLmF2Rt2PBKeLA1FbsHvWgLm59X2fPcUgiNzyl?__cft__[0]=AZVCkH6I86Kl6OO8wRdIXFtr-N-x4yTeCd68maym6UPqwahRj149e7Yme2N_JfltqEseF0pluVzhnwdXXkV-MCWlctEjGu3bnkN5BhwAVUngk1oBFLjUJ2qbrmf2dlNJJM2-Ajm8gOmMf04GPf9HhYYgbHrDq4hBXfU69dMbaRph_Qh-WnaX53RD_U1kdxZTPXtXeXpqlssKD9u_nRu9YVUrhCmmgqKVplUnFtFMAx0U6EL8dRqoECaSOKqpBTGKznc&__tn__=%2CO%2CP-R,19,0,positive,19
1067383917261210,NVIDIA AI,0,4,0,0,1,0,0,0,5,0,"Join NVIDIAs Justin Boitano at RedHat #Open5G2022 to learn about accelerated #5G, cloud, and #edge transformations.Register now: https://nvda.ws/3TWaFM1",2022-11-02T00:00:00,[],https://scontent.fcai19-7.fna.fbcdn.net/v/t39.30808-6/313419017_1067383910594544_8276280883126745929_n.png?stp=dst-png_s960x960&_nc_cat=101&ccb=1-7&_nc_sid=9267fe&_nc_ohc=YBC5cGtduT8AX_OwKRC&_nc_ht=scontent.fcai19-7.fna&oh=00_AfCRNuG1JQHovtE0c_cjYfyyd3XQ5j9Dw_eKVOahkn-Ibg&oe=64E343B0,https://www.facebook.com/NVIDIAAI/photos/a.119492422050369/1067383917261210/?__cft__[0]=AZV85WGhle2sXcLjh9daIvTlFzQFUFRx8TLyd3PGP1ITIqDGzkcPtkdVGJWe5dMjyThz9Z5tJOtqT4DcjwkyIflc6pNUecknq2be8fZpV8UseF1ppXQ2LOvx1y09NlVpQ89rTfH_OdWjNJMqqpZ-TnjjZJE0VJlEh9_kU0quHsmwAVT2tJ13ercs6GItPIipAUEmGpUyMlR4a5gWQpJtOnwD&__tn__=%2CO%2CP-R,5,0,positive,5
pfbid09vCsjMYiRXB9rrZVMmTXutVQtFTFyfgHMHFhQR3pJuVZroaSfmCSm881G69Gnt4ml,NVIDIA AI,0,5,0,0,1,0,0,0,6,0,See how AT&T is supercharging their field dispatch capabilities by leveraging the cuOpt solver on the GPU: https://nvda.ws/3Uk8i5v,2022-11-01T00:00:00,[],https://external.fcai19-7.fna.fbcdn.net/emg1/v/t13/7825953214866327400?url=https%3A%2F%2Fcdnsecakmi.kaltura.com%2Fp%2F2935771%2Fthumbnail%2Fentry_id%2F1_g45842p9%2Fwidth%2F1200&fb_obo=1&utld=kaltura.com&stp=c0.5000x0.5000f_dst-jpg_flffffff_p500x261_q75&ccb=13-1&oh=06_AbH3AJ9UgGVCHEJx-icmwMOBYXbdstc870sQdHdGsz0QhA&oe=64E01616&_nc_sid=dbad39,https://www.facebook.com/NVIDIAAI/posts/pfbid09vCsjMYiRXB9rrZVMmTXutVQtFTFyfgHMHFhQR3pJuVZroaSfmCSm881G69Gnt4ml?__cft__[0]=AZUk6AK4oJWyBpi4ILy7xXzEr_2iUh-R91l6h2fIwFwl_lejKwXS_nGjl0hL9FZQ3KmhBdPmdG_ie6nkl_LF-FDaFAK9L5vjOSnAt83RkGoEuiXg5yfFrskuFUPgfRsW41vekuM_0qAja4-5ZjQwf7lR_BrUxs_EaSVvVnG1FeZUu5GsRvsaT_STLsx7uGxcWXc84V4n7Nu66pB855XNxP79&__tn__=%2CO%2CP-R,6,0,positive,6
1066822720650663,NVIDIA AI,0,12,4,0,1,0,0,0,17,4,"What is new with #CUDA? Learn about the latest additions to the CUDA platform, Language and Toolkit, and what the new Hopper GPU architecture brings to CUDA. Presented by a CUDA architect, this engineer-focused session covers all the latest developments as well as looking ahead to where CUDA will go in the next year.  https://nvda.ws/3h4kqt7",2022-11-01T00:00:00,[],https://scontent.fcai19-7.fna.fbcdn.net/v/t39.30808-6/313416549_1066822717317330_2589197972885898123_n.jpg?stp=dst-jpg_p526x296&_nc_cat=100&ccb=1-7&_nc_sid=9267fe&_nc_ohc=pxqIFHL-FCgAX9MOMue&_nc_ht=scontent.fcai19-7.fna&oh=00_AfD2PTui4X35ZYgZt3-8JK2e046yaqJ50DlZEk2bT8bajg&oe=64E312CE,https://www.facebook.com/NVIDIAAI/photos/a.119492422050369/1066822720650663/?__cft__[0]=AZXtNdrcHKLbfYCmkDWuL8TJZHvberfGfykPf_avuJkN3ioEG-qc21JhnGTirC-85fnLzyR63scrDABwNnKP_j84dRHzmRyqqEB5CD-c0gcVGCzkTLhctPCbYw5O_OLtsF21hI4RCMCEKL8sNbKVn_qZZoW94RmsBOiY4MbqINl8x6cMtitnxmSrnhwUMueUbambxFziIBMSi4c2t-LR-e54&__tn__=%2CO%2CP-R,17,0,positive,17
1066793963986872,NVIDIA AI,0,6,0,0,1,0,0,0,7,1,"Join Fox Sports, NCS, and NVIDIA at the Speech AI in Industry Panel hosted by Dr.Ahmad Bazzi Register Free: https://nvda.ws/3WowA03",2022-11-01T00:00:00,[],https://scontent.fcai19-7.fna.fbcdn.net/v/t39.30808-6/313359501_1066793960653539_5846575328523679194_n.jpg?stp=dst-jpg_p180x540&_nc_cat=108&ccb=1-7&_nc_sid=9267fe&_nc_ohc=uml1nc2rV3IAX_q1p4f&_nc_ht=scontent.fcai19-7.fna&oh=00_AfDvAaVue9MvG-xiE1YhdFYGQcqiE2brVWJ8I9p3IarfdA&oe=64E372B4,https://www.facebook.com/NVIDIAAI/photos/a.119492422050369/1066793963986872/?__cft__[0]=AZX_EBnjaALqCoNgUeNtS8HqajCa-gWll0E4zJfNeleukd3CF9C48LI0TN3QEGsBOBShU5LJFJ6Af75k1LCmPwbCctw63yNB2sWEH7K3ejqO0y8B2cJwnrCuu-YH4gX1EPLeSMssXWpo8GleBubIStABGhbGb8J2Jg6Cd1C9HT_KVZupFAi82hs-26VRKEKwHW0LRW9ns4JQ9MkcTsMm4cNm&__tn__=%2CO%2CP-R,7,0,positive,7
pfbid021AGVQHjfJjAD3Q6xRrjNaB9hzc3hAVjz6DVJZ7khGfVQ8SDhYhE5MG1wwwxrHTKFl,NVIDIA AI,0,6,0,0,1,0,0,0,7,0,Join us virtually on November 9th at Big Compute 2022 and listen to the Keynote featuring NVIDIA CEO Jensen Huang and Rescale CEO Joris Poort. Register now: https://nvda.ws/3gVB5yM,2022-10-31T00:00:00,[],https://scontent.fcai19-7.fna.fbcdn.net/v/t39.30808-6/313857215_1278772596231734_8051223893112705635_n.png?stp=dst-png_s960x960&_nc_cat=110&ccb=1-7&_nc_sid=9267fe&_nc_ohc=IbSmDUGLiUMAX-gtrMx&_nc_ht=scontent.fcai19-7.fna&oh=00_AfDL6L7G_cLhvsL1a9FIdH6f36HEvH9QUgnJ82wPGsk79A&oe=64E2D942,https://www.facebook.com/NVIDIAAI/posts/pfbid021AGVQHjfJjAD3Q6xRrjNaB9hzc3hAVjz6DVJZ7khGfVQ8SDhYhE5MG1wwwxrHTKFl?__cft__[0]=AZU50BfGp6LYQYfFZoyEHIzqI0yx9iHryOHPQFrLldXiCFpRYWNMTXBJieHXkYRNRaoL9jXjzJO-TLBdnpFJ4fSlzPo8RCWORuBoQu6s8bM7qaDjKiVQcnqrkGOkFl03Luh3-hhNBj7PcWODYWcKOp7uyd3t-UePncLfW-05-TbkWIx5CO6zId88q8J721U5LVergwkZ-uyszjDTZUEzaC0pv7DwBns-4Maqy_b4Nc7NFRmHILwRwXctWIAE5HFRltVL1SHcGv1lqaYdGkyQZoS5&__tn__=%2CO%2CP-R,7,0,positive,7
1066227170710218,NVIDIA AI,0,20,3,0,0,0,0,0,23,0,"Learn how #AI, IoT, and edge computing are revolutionizing the retail industry. Join our Retail Edge Computing 101 webinar on November 9. https://nvda.ws/3gMgTiB",2022-10-31T00:00:00,[],https://scontent.fcai19-7.fna.fbcdn.net/v/t39.30808-6/313960540_1066227157376886_5953150161954770564_n.jpg?stp=dst-jpg_p526x296&_nc_cat=110&ccb=1-7&_nc_sid=9267fe&_nc_ohc=iVgQb3ap9V8AX90mnXp&_nc_ht=scontent.fcai19-7.fna&oh=00_AfAL68nsIfyVpsmQBZzWNPuAWo5htu9bxCg2ZSKdb5dzEg&oe=64E3389E,https://www.facebook.com/NVIDIAAI/photos/a.119492422050369/1066227170710218/?__cft__[0]=AZUvCcA0yXeVmuy8-tW8MkOug18p1_ZLVQ-iwGMdQ3wgTccQDABJCRFOlROZKtSjcsVUnUGlgCp7fHYAkbR5NC9Ah-gu2QeGzUq_4tGuPaeNoZetQJxCdO3iP9I-OK0_UxvMRQHocR53evpKrqT_gtU4tQlm25TRtMNneYMu4sT-iBkqTml3R2rDEhgttoji7snxo3DljKQ7a30ticWMjqHP&__tn__=%2CO%2CP-R,23,0,positive,23
1066175557382046,NVIDIA AI,0,8,0,0,1,0,0,0,9,0,"Last chance to register for the free NVIDIA Speech AI Summit. Here's the schedule at a glance with talks from Google, Meta, Mozilla Common Voice, https://nvda.ws/3UdNLQ4 and a great panel discussion hosted by Dr. Ahmad Bazzi. Register Free: https://nvda.ws/3U6YCuM",2022-10-31T00:00:00,[],https://scontent.fcai19-7.fna.fbcdn.net/v/t39.30808-6/313887320_1066175550715380_6579615602635583584_n.png?stp=dst-png_p180x540&_nc_cat=108&ccb=1-7&_nc_sid=9267fe&_nc_ohc=29x7SPw7nNsAX8Tbxrc&_nc_ht=scontent.fcai19-7.fna&oh=00_AfBoVwx5kOtsSBJaKHGVnO5pWmpTLEpGskCSwgSlt4laCw&oe=64E34F58,https://www.facebook.com/NVIDIAAI/photos/a.119492422050369/1066175557382046/?__cft__[0]=AZX2JwmYGPxHHxnzEoLZEVHu_08jDDXibCVkEuAzaI-PCe6PfyO15OwwZ0UrPsjVg3f9YEB5OKLh_PkRHTEm749-nfAwmiZz8SuPtW3smVIhfqp0hP0YoG5waavPeoYwozMZ2-EBg8bQzlI9uVH8yYdJJ9ftqlu4kkY-l4mSUtnwPazlo05KqHCN38HDmAAT58DsllIqc5K6yeqXJPQLU1GQ&__tn__=%2CO%2CP-R,9,0,positive,9
pfbid02p9poVWJ8U1KHkhdJFmgvJ3JA6Air76WpCiqaGGvH8rpKeQCQmRp3HsKSQ21n9bvHl,NVIDIA AI,0,11,1,0,1,0,0,0,13,1,New cuOpt 22.10 release strengthens the route optimization Improvements in Quality-of-Results for pickup-and-delivery and job priority support to the cuOpt server. Check out the release documentation for highlights: https://github.com/NVIDIA/cuOpt-Resources/discussions/9...,2022-10-31T00:00:00,[],https://scontent.fcai19-7.fna.fbcdn.net/v/t39.30808-6/313433564_1066153310717604_497667080501285061_n.png?stp=dst-png_s720x720&_nc_cat=102&ccb=1-7&_nc_sid=730e14&_nc_ohc=DR0zQm1oeU0AX-LbXfB&_nc_ht=scontent.fcai19-7.fna&oh=00_AfDwp1oPIketrdVdFbzRBzZ9E8s8iINYeyRTDGnLmR49Lg&oe=64E3752A,https://www.facebook.com/NVIDIAAI/posts/pfbid02p9poVWJ8U1KHkhdJFmgvJ3JA6Air76WpCiqaGGvH8rpKeQCQmRp3HsKSQ21n9bvHl?__cft__[0]=AZWJLxsPiQ0Wyo_nQQQLtgWQK0Tp69TYUGqupebqSFsWctxoAgnCCODVKboznDRClQk8b0x-oZNV3kdmKQRG3zznaKPEl7hheCVh_SFqqX9ebIiiQX7PYYM6VczxYHJXoIfjAO7BhDkc-8m_HnYFLtH-PFIBqF2NJdG9ru3k7ufPJbIOungVwjFJAYUfHwtOeiJ4saS--QNHejntiDvqcet3&__tn__=%2CO%2CP-R,13,0,positive,13
pfbid02Pg6P2pjyfM3wx1xg8W8C9MGY4RqRmFPmLqRptZfrJ3roo6yEBoEG6qfNsXQ6T1C9l,NVIDIA AI,0,7,0,0,1,0,0,0,8,0,"Missed a Deep Learning Institute training session at #GTC22? Now you can watch on-demand two-hour sessions on topics such as deep learning, accelerated computing, and more. Watch now: https://nvda.ws/3Nj8krT",2022-10-31T00:00:00,[],https://external.fcai19-7.fna.fbcdn.net/emg1/v/t13/2835765152253665312?url=https%3A%2F%2Fprod2-sprcdn-assets.sprinklr.com%2F50276%2F8b0333f2-6b6d-4395-9e78-7cd1b5eebec3-1432877503%2Fgtc22-fall-best-of-gtc-social-.jpg&fb_obo=1&utld=sprinklr.com&stp=c0.5000x0.5000f_dst-jpg_flffffff_p500x261_q75&ccb=13-1&oh=06_AbFuqc4hb90WGrh9sltRH74C3OHo3653oI1C5dXlaiG5bA&oe=64E08DA1&_nc_sid=dbad39,https://www.facebook.com/NVIDIAAI/posts/pfbid02Pg6P2pjyfM3wx1xg8W8C9MGY4RqRmFPmLqRptZfrJ3roo6yEBoEG6qfNsXQ6T1C9l?__cft__[0]=AZWdsuG0Ax1iZ12tzMnRbfmwOPSpCZUo0DmLlPok8SW_n65NlT9_GXADwg2B33NNHNNO4bD2FmgCDyUzxq8o6RA4UTAbl8tVdkhbv8DB5C4n5-Wm5pNP-6y8zaJUg2AfrX1lJ07aAXPe3rbeUSrdrchUsoK4qC11T9MQV2FxJdqsgcYDHKwfoMP_aL21oV3pPxhuyx5huJy3Ppup_9RRrjAs&__tn__=%2CO%2CP-R,8,0,positive,8
1064220330910902,NVIDIA AI,0,13,1,0,1,0,0,0,15,4,ICYMI: NVIDIA's #MSIgnite sessions are available on-demand.Go check them out: https://nvda.ws/3g94Ewy#AI #MicrosoftCloud #AzureML #NVIDIATAO #NVIDIAOmniverse #DRIVESim,2022-10-29T00:00:00,[],https://scontent.fcai19-7.fna.fbcdn.net/v/t39.30808-6/313029453_1064220324244236_4116316852502097476_n.jpg?stp=dst-jpg_s960x960&_nc_cat=110&ccb=1-7&_nc_sid=9267fe&_nc_ohc=Y1j0_BTwMA8AX9G_qbb&_nc_ht=scontent.fcai19-7.fna&oh=00_AfDy46SO8n8KYY3UCiGNuUR-Wuhu3LRx9dqy-vGnaBNPHw&oe=64E2C719,https://www.facebook.com/NVIDIAAI/photos/a.119492422050369/1064220330910902/?__cft__[0]=AZXeTUO9EF5k-H9_lKg3B5mloP0uZtflfXWBdIj_8Ca2gIwxuM29wzhprBE3etjQ2Rd86frdpl8rcYml3yHJCltVGgsO-uBYZedliQaMVHbvb7jKSUCzwY90wy44HnJsgGM67bpEGiwrF78Zx4a_sovbFTQfvdSTYCUdmH5JmtJuRFCByXISRJ4x-eq2IiH2-u6OkT4Ye6yLvB03rcob_vii&__tn__=%2CO%2CP-R,15,0,positive,15
pfbid0cAA54VtpLv2AokdN2oxrntLyaGyqCdBgqdVcbZQLiBXcgTbCjRd8LQaQQPmDjVKKl,NVIDIA AI,0,11,0,0,1,0,0,0,12,0,NVIDIA's Jason Recla talks about how NVIDIA uses #AI to address #cybersecurity challenges on the Application Security Podcast. Security Weekly Watch it now!,2022-10-28T00:00:00,[],https://external.fcai19-7.fna.fbcdn.net/emg1/v/t13/1790554647452120297?url=https%3A%2F%2Fi.ytimg.com%2Fvi%2Fpg2r_O6T-lw%2Fmaxresdefault.jpg&fb_obo=1&utld=ytimg.com&stp=c0.5000x0.5000f_dst-jpg_flffffff_p500x261_q75&ccb=13-1&oh=06_AbHpAvkgMoKGTSeT1bRwEPsNpjQYHhERu38jaR5SJun9hg&oe=64E08EEF&_nc_sid=dbad39,https://www.facebook.com/NVIDIAAI/posts/pfbid0cAA54VtpLv2AokdN2oxrntLyaGyqCdBgqdVcbZQLiBXcgTbCjRd8LQaQQPmDjVKKl?__cft__[0]=AZUm16mA7airyC_z6OWGE2RSZEkYkhoF1PUTSoWMn2FA8_WZS217QqgudB8ovHYfNP0Ymb9xon8mmiiACYDxBsQ8xf39HOvEKq7tv8BW2Z_Q298LpKhWcsrbAxLPx16-r15GFSt3gT_BT4-ywVOIQPN0R0gqgQCCiW2DJ7TcM5-NXjOdFDytyRuiFjMdkxrTYizEm1LEFcAVlffAlP04omDB&__tn__=%2CO%2CP-R,12,0,positive,12
pfbid023HnUnjys8Zp9MZwwUWEVcMo7jMLptbcWdPSeLdBh6RJfDgaRV8rKGkHcKDPE9FnGl,NVIDIA AI,0,3,0,0,1,0,0,0,4,0,Reminder: Our #Retail Edge Computing 101 webinar is coming up on November 9.Register now to learn how #edge solutions integrate with your current #infrastructure and more. Sign up: https://nvda.ws/3yt53zV,2022-10-28T00:00:00,[],https://external.fcai19-7.fna.fbcdn.net/emg1/v/t13/10558957190259254097?url=https%3A%2F%2Fprod2-sprcdn-assets.sprinklr.com%2F50276%2F88c98372-23b2-4a5d-b3b7-f96ebe36405a-68451076%2Fsocial-edge-ai-computing-101-w.png&fb_obo=1&utld=sprinklr.com&stp=c0.5000x0.5000f_dst-jpg_flffffff_p500x261_q75&ccb=13-1&oh=06_AbGcfgcXHOKfQfvrMYw7K5-e5eeGDpH8ZiCQiFnf5sSDMA&oe=64E043E2&_nc_sid=dbad39,https://www.facebook.com/NVIDIAAI/posts/pfbid023HnUnjys8Zp9MZwwUWEVcMo7jMLptbcWdPSeLdBh6RJfDgaRV8rKGkHcKDPE9FnGl?__cft__[0]=AZUjJ7LgGVCmIzVx65MTHSPKEhSuVnRHv_kNbhsqE6i7_Iq23e6kJVzdzpEWPZ1JfMMVoPqzwE8wvH50VeIrvxiuetlGK8O_ePaFFAZXPDco3iDLJTdRSSJWdXFIg00n4rPdZKzEclgLrco4ptbz74KMLN-oxripgQhfxTSvwik12DUeXMxExhITcT_dWUyeSZj725IjlNHDHW6jDPLhhPTf&__tn__=%2CO%2CP-R,4,0,positive,4
pfbid02gThejcCn5PBTVYgjmM4Kof7GMmzMQN8ziRquFdzdToYbbELKbx16MfLgTddXfpVml,NVIDIA AI,0,6,0,0,1,0,0,0,7,0,Did you know that #GPU acceleration can provide 20x speedups for ETL pipelines and complex analytics queries? Thanks to Cloudera and NVIDIA it can. Check out the on-demand webinar to learn more.: https://nvda.ws/3Dh8z1X,2022-10-28T00:00:00,[],https://external.fcai19-7.fna.fbcdn.net/emg1/v/t13/13241044136935876694?url=https%3A%2F%2Fwww.cloudera.com%2Fcontent%2Fdam%2Fwww%2Fmarketing%2Fimages%2Fbanners%2Fl01-nvidia-webinar.png&fb_obo=1&utld=cloudera.com&stp=c0.5000x0.5000f_dst-jpg_flffffff_p500x261_q75&ccb=13-1&oh=06_AbGF7mZTKp8HcBKX9fRgnF67FhSZIfAUr7fQDuzk4EdNoA&oe=64E0824F&_nc_sid=dbad39,https://www.facebook.com/NVIDIAAI/posts/pfbid02gThejcCn5PBTVYgjmM4Kof7GMmzMQN8ziRquFdzdToYbbELKbx16MfLgTddXfpVml?__cft__[0]=AZVTpZ00awkR8WNPYUgZiXB1uZPjGBy7UiImJKNoxoJkkdu5od6zqLhJzhNEGGQ_vpqdsn-KMsN9QVXMbxHC1FQ9XzB0uaiENNxVhOfdqge1dAw2vSTVVlwhJ19zGbOITdbF1OCnV3FbAsGdX4iekQw1ZhV4Jq-0hCphMY1XMPVSIpZAo3bIiYUvocNBMR575y-sT_NoPC7gkCUgGrbm3z5D&__tn__=%2CO%2CP-R,7,0,positive,7
1064048847594717,NVIDIA AI,0,5,0,0,1,0,0,0,6,1,"Cybersecurity is one of the greatest challenges facing the public and private sectors and the number of overall attacks is now up to 2,200 per day. Learn why Bartley Richardson is emphasizing #AI-based solutions to capture and analyze data that agencies don’t even know they have. https://nvda.ws/3szJgn5",2022-10-28T00:00:00,[],https://scontent.fcai19-7.fna.fbcdn.net/v/t39.30808-6/313395652_1064048840928051_5656675440838746392_n.jpg?stp=dst-jpg_p180x540&_nc_cat=105&ccb=1-7&_nc_sid=9267fe&_nc_ohc=hyx-zaFNW0IAX8zc5hh&_nc_ht=scontent.fcai19-7.fna&oh=00_AfDpVoPyMvhALyv1x0lrKHEUJr3h-6KtjO5GY4lyyUDuUw&oe=64E3FDC8,https://www.facebook.com/NVIDIAAI/photos/a.119492422050369/1064048847594717/?__cft__[0]=AZU8ScLBGhYxB-9Or5p4H2CTk51zKWEHupXtFs2fw093TPeMYXYxeEv4HG0E-Peq3YKcU0z3TgBWFr1Pdt87JgG-fOUs2iEUWsc0DmHQ8u_meggIVk_iEQqOXkl0DouvE0kD_MaFgGUCrWrK0i-qnhaS3Szq6N69GF4Qnb3-ut_znQ6lQWh2HgEp-ZIwr1iUfA0YYKb6cHj4UPabQTILz3XW&__tn__=%2CO%2CP-R,6,0,positive,6
1064005474265721,NVIDIA AI,0,6,0,0,1,0,0,0,7,1,"Financial trading firms are using #AI to analyze real-time market conditions and optimize split-second decisions. Learn how to reduce backtesting time, accelerate risk calculations, and generate better signals in this technical brief: https://nvda.ws/3DhKzMe",2022-10-28T00:00:00,[],https://scontent.fcai19-7.fna.fbcdn.net/v/t39.30808-6/313289863_1064005470932388_385791599754222189_n.jpg?stp=dst-jpg_p526x296&_nc_cat=106&ccb=1-7&_nc_sid=9267fe&_nc_ohc=xHQ7oyArdAwAX_HH7n1&_nc_ht=scontent.fcai19-7.fna&oh=00_AfC7N1NfgaLe9FymRA8h_m4vtH3Yex_cw2IvyXmyZVNLEg&oe=64E2B662,https://www.facebook.com/NVIDIAAI/photos/a.119492422050369/1064005474265721/?__cft__[0]=AZXY9zRphlXGiS4hHWm4XCyyEd3OnX73CpZJGs4ffVLorpQFcPuAKnMklEPVkYcRyV7Z69eiVpUZxSIqHbYujqAE40FejCjoJLGpJHxlir2OYHjLf4504Dx_fLVXDue2HaYmEeJZNQyporL-aVngwUIArGE_GZPbY_3dV8SCUoUX6kJky52toYjkjPCZ2lL9SnylJtLaktelH6BwbiYc6gET&__tn__=%2CO%2CP-R,7,0,positive,7
pfbid02cnxf2oyocUGCLhbp29yHBYPKJNoooE1wnxtzX9HyzmxNP6PBCwZ9iCkEDnqYm3QZl,NVIDIA AI,0,8,0,0,1,0,0,0,9,1,"Vision AI software from #NVIDIAMetropolis member Searidge Technologies is helping the aviation industry to enhance air-traffic control, improve airline efficiency, and bolster airplane safety at airports worldwide. Learn more > https://nvda.ws/3TgEplW",2022-10-28T00:00:00,[],https://external.fcai19-7.fna.fbcdn.net/emg1/v/t13/6630822140333987934?url=https%3A%2F%2Fblogs.nvidia.com%2Fwp-content%2Fuploads%2F2022%2F10%2Fsearidge-still.jpg&fb_obo=1&utld=nvidia.com&stp=c0.5000x0.5000f_dst-jpg_flffffff_p500x261_q75&ccb=13-1&oh=06_AbFgNs_FYNgWNcLof4UdSMz8YqyRRFyL1lf5CnrI0zf4Aw&oe=64E01FE5&_nc_sid=dbad39,https://www.facebook.com/NVIDIAAI/posts/pfbid02cnxf2oyocUGCLhbp29yHBYPKJNoooE1wnxtzX9HyzmxNP6PBCwZ9iCkEDnqYm3QZl?__cft__[0]=AZUa0lH6cF5W13nMORa3ElGOB2abF7RQTkzx31ZxU2hfXGks9GfJmS6tkhYGPX7gYz6jeFKUfDq4RVTGgSrSY0JUGvQsu2vC9ZP3Mbxmsss4yyNnvRm5598KhwsIqK7iLKx7VFPd1iswUgfE54Ct1-lYAqfuPRIbYy_PvVEw2BRaqB8lPnoajIdZPe0JoaotzPq4tQ1I740NcZY33hugpsr9&__tn__=%2CO%2CP-R,9,0,positive,9
1063336574332611,NVIDIA AI,0,13,0,0,2,0,0,0,15,2,"Join Stanford University and NVIDIA to learn how to better estimate the yield curve from U.S. Treasury securities with a robust, flexible and easy-to-implement method. Register free for our webinar on November 16: https://nvda.ws/3D8eh6j",2022-10-27T00:00:00,[],https://scontent.fcai19-7.fna.fbcdn.net/v/t39.30808-6/312847749_1063336570999278_9110180374080491129_n.jpg?stp=dst-jpg_p526x296&_nc_cat=102&ccb=1-7&_nc_sid=9267fe&_nc_ohc=xSMOQZRyv50AX89T_VY&_nc_oc=AQmC_-efd3ZCglBVHAghwf16FO1T5jfosw7apFGhn5I_T674LtNB2pEP2Fx7jaRFugU&_nc_ht=scontent.fcai19-7.fna&oh=00_AfABJftubapWg4qDI5ID2xrAMaFG37jBa52EoLQ8M9-6Sg&oe=64E31E18,https://www.facebook.com/NVIDIAAI/photos/a.119492422050369/1063336574332611/?__cft__[0]=AZXZeoCc9wLhKJGnO9tT4PmsHnHOscT0FSItlgPMOYcvpGQa6ICedt0QczqzDwMV3o1oWyNHXI9Yld-ae4m1Ej6-uPj2sm86KWOLaXvjohfTqO68_OfxQB7cg-T8gVGcEJavIfXmgGwDxxr9YGtcYoM6zAUDPSafyPAr9R6GObSctfMsNjwJBw-D8I-nNAlP8qAycSHuc8n1V1i9J3YcehIp&__tn__=%2CO%2CP-R,15,0,positive,15
1062944564371812,NVIDIA AI,0,8,0,0,1,0,0,0,9,3,"Don’t miss the #NVIDIAInception webinar session to learn about how the industrial metaverse platform #NVIDIAOmniverse enables teams to collaborate in real-time on photo real digital models, and build extensions and connectors with greater ease than ever while boosting productivity. Register now: https://nvda.ws/3VZpDlG",2022-10-27T00:00:00,[],https://scontent.fcai19-7.fna.fbcdn.net/v/t39.30808-6/312878885_1062944561038479_7040219071468442320_n.jpg?stp=dst-jpg_p180x540&_nc_cat=107&ccb=1-7&_nc_sid=9267fe&_nc_ohc=7l6jqwh7HfcAX-aCs_r&_nc_ht=scontent.fcai19-7.fna&oh=00_AfCMeEqSNrK5YpexVxP9Jx4IXLQcZ8lkAPCXtXUsmNvqgQ&oe=64E3E494,https://www.facebook.com/NVIDIAAI/photos/a.119492422050369/1062944564371812/?__cft__[0]=AZX0V_g95TMW5a_lhQIIei9ZkYzuzC05ksCDeoJvCmysiMvAd3LBhfDoCyx9kIYSoLSmBQiZbw4NmrKpS323gyPE1HXWF34kCEfgnw4I84N-wFysmjmibfuuoCd9IVLuKk_AgweqS-4LJbsctNOIfx3PuuGtzXc78cHxb7F-K6lHIse5yM59CLIavUbZL7oLDfeDXHqWG8EFxzNe1egLSnEa&__tn__=%2CO%2CP-R,9,0,positive,9
1062804681052467,NVIDIA AI,0,14,1,0,2,0,0,0,17,5,"New to graph neural networks? Get an introduction to GNNs and how they apply #AI to improve fraud detection, drug discovery, recommender systems, and more. https://nvda.ws/3TGryKi",2022-10-26T00:00:00,[],https://scontent.fcai19-7.fna.fbcdn.net/v/t39.30808-6/313195624_1062804677719134_2188058270447896477_n.jpg?stp=dst-jpg_p526x296&_nc_cat=107&ccb=1-7&_nc_sid=9267fe&_nc_ohc=ok7ZJilCl7MAX9lrFZk&_nc_ht=scontent.fcai19-7.fna&oh=00_AfCVO1cWh4Vy0F8RZnUpM5AQ-0hXK8BF16gP2SWFc3eFpw&oe=64E3BD98,https://www.facebook.com/NVIDIAAI/photos/a.119492422050369/1062804681052467/?__cft__[0]=AZVSrR_xP0j6iUplpYOjID3vJBZDNFxp9d-411V8DjuOy5bLBoW5m48dJKSbgMlq2TgwVp8CGqRvwK9ovUthD9udUZhvRpgfQkPEZCXrPqlWmYSIGBqx3riRymAce2L3mdVOKQRDhZ07hjJRzRIwgKxqWUT94Ds2TnqjS7aezfTSVm00bUx0OrnpG4CrhPjWuXOp64It0yImlWzvQNNiW8YM&__tn__=%2CO%2CP-R,17,0,positive,17
pfbid0G751dKc93ggfot4eeYFuHZYFa7h2RTDBvLzqahS4XDYhy5svtEHkV1QMohNku5BTl,NVIDIA AI,0,9,0,0,1,0,0,0,10,1,"Google Cloud has adopted #MONAI into their medical imaging suite, providing radiologists and pathologists with critical and compelling tools for simplifying the development and adoption of #AI into their clinical practice. https://nvda.ws/3N7sbdp",2022-10-26T00:00:00,[],https://external.fcai19-7.fna.fbcdn.net/emg1/v/t13/535004335410510156?url=https%3A%2F%2Fdeveloper-blogs.nvidia.com%2Fwp-content%2Fuploads%2F2022%2F10%2FGoogle-Cloud-Medical-Imaging.jpg&fb_obo=1&utld=nvidia.com&stp=c0.5000x0.5000f_dst-jpg_flffffff_p500x261_q75&ccb=13-1&oh=06_AbHeiyNOACVouMJuGsrpI30Ss9Tg5vDXpq2HcAL_IUa95w&oe=64E0AEA5&_nc_sid=dbad39,https://www.facebook.com/NVIDIAAI/posts/pfbid0G751dKc93ggfot4eeYFuHZYFa7h2RTDBvLzqahS4XDYhy5svtEHkV1QMohNku5BTl?__cft__[0]=AZVqMF1C62MI-BiFEEJ1fBc_-c1pxC17JHBLj_sC13u7K-P3idcORP42iSIWbvAi_YCJI2RGZy6a7t2_70LEQ24w06DEQCrF_0-mkTn5kjDjKxQQayh_BILZ-45XEVusBM6-RrTG20HvaMSW2t9csqrTksZlQS4rsa8IWBtt4I51WYjbB0IE_Mdr3ww84n9V1OtDUqi3WiUfj57Ge1HTuW3f&__tn__=%2CO%2CP-R,10,0,positive,10
1062687077730894,NVIDIA AI,0,8,0,0,1,0,0,0,9,1,"Without a keyboard or mouse, users in VR games often struggle with navigating their virtual environment. How can XR developers design a more natural experience, while improving accessibility? The answer is simple: by adding #speechrecognition and #texttospeech capabilities. https://nvda.ws/3gnVg8d",2022-10-26T00:00:00,[],https://scontent.fcai19-7.fna.fbcdn.net/v/t39.30808-6/311886453_1062687071064228_3745015421319671147_n.jpg?stp=dst-jpg_p180x540&_nc_cat=109&ccb=1-7&_nc_sid=9267fe&_nc_ohc=ZaTMeNuz9Z8AX-FhsjF&_nc_ht=scontent.fcai19-7.fna&oh=00_AfCKCsPxjQxx4XaLjvdlPBPy3hLkihwEECoM354NffHiQg&oe=64E3B850,https://www.facebook.com/NVIDIAAI/photos/a.119492422050369/1062687077730894/?__cft__[0]=AZVPmOOUQpPGPF5foHpupq3v-hMtzxVdK3bamq0WdV-1j9Dr8DkGJiwBRAN07g4fyTTvrT0U15Ve2e4VHRK-RMyw1uo3tkzliOhmpmg-6Nmgwt64t-sIbuGR41EPCNmwEXtjOUu3Dag_U8mL_oi7O0bqZGyr7LwkqslO9_TFVDPWsW3EfPXrGydRCptoVlAY8FjM4Q0G1fAYnZupnsGcdUps&__tn__=%2CO%2CP-R,9,0,positive,9
1062317784434490,NVIDIA AI,0,12,0,0,1,0,0,0,13,1,Join us to discover how #NVIDIAInception can help your #startup build its solutions and grow faster. Register now: https://nvda.ws/3TRw48B #developers #metropolis #innovation,2022-10-26T00:00:00,[],https://scontent.fcai19-7.fna.fbcdn.net/v/t39.30808-6/313034522_1062317781101157_3292651351753132620_n.jpg?stp=dst-jpg_p180x540&_nc_cat=102&ccb=1-7&_nc_sid=9267fe&_nc_ohc=64ru_nTSPu8AX8p1z4U&_nc_ht=scontent.fcai19-7.fna&oh=00_AfDCRcboqEleb5XGLmWlCi0uBGqJiIZZvtzfycbhzuIpAA&oe=64E37AE7,https://www.facebook.com/NVIDIAAI/photos/a.119492422050369/1062317784434490/?__cft__[0]=AZVy2p48GbGJQbp2u0MXiY497gVMc2L-OiKS8WvZYR6ojArXthuCQWztQw06L5ugsL2wgojAZbwJyYm9584xoUgM5FlMXLOCwvDuDhoMEZQ_jbacaWO0sYwGQpBHq8ObElHUMZDtVLjsHKqtO4hEK3uPB6q37XY05kUkhXMkMz2Vtt6HPOyXzmIBAF4sOZmMK-MpCdc324-rEBmc_G4voSPi&__tn__=%2CO%2CP-R,13,0,positive,13
pfbid0G1PdinMrmgc3JENGZAPL2W3GPd7JQexXR2CS3bCEiiPPnRSr8gi9AAL8rBMkDUbzl,NVIDIA AI,0,7,0,0,1,0,0,0,8,3,"Learn how #AI, IoT, and edge computing are revolutionizing the retail industry. Join our Retail Edge Computing 101 webinar on November 9.Register now: https://nvda.ws/3yt53zV",2022-10-26T00:00:00,[],https://external.fcai19-7.fna.fbcdn.net/emg1/v/t13/7820886717135310518?url=https%3A%2F%2Fprod2-sprcdn-assets.sprinklr.com%2F50276%2F43b4069c-306a-4f3d-a326-edf70465c675-941707544%2Fsocial-edge-ai-computing-101-w.png&fb_obo=1&utld=sprinklr.com&stp=c0.5000x0.5000f_dst-jpg_flffffff_p500x261_q75&ccb=13-1&oh=06_AbGOp4b331eYJm_MPUjggWV4aUST8DIRqo-YFkPqGFm7zw&oe=64E0A840&_nc_sid=dbad39,https://www.facebook.com/NVIDIAAI/posts/pfbid0G1PdinMrmgc3JENGZAPL2W3GPd7JQexXR2CS3bCEiiPPnRSr8gi9AAL8rBMkDUbzl?__cft__[0]=AZXzv3Qdruqgax_KSX5Q9Azd3A7-XXiwnQdHnOSKjNtz6QRxjkHbhE9ocIHT-btlArczlzkQ-E1NIbb0XUGPdHVHwcgXG8rS8vieJ6PBPa9IHKd5ka0r8qi9-m9RW4l6fvIA12kBUnjfGcjFMjGPDgJwql5t-1YvkdSCULfHnG2ybbzmYLErWD96CgRG5sTLG_AjCRdqBuHvsOw3ARNXFmkE&__tn__=%2CO%2CP-R,8,0,positive,8
1062181384448130,NVIDIA AI,0,7,0,0,1,0,0,0,8,1,Successful use and growth of AI in an organization needs an understanding of all the facets of AI inference. Explore real-world use cases and common pitfalls that will help you prepare your teams to optimize your own AI model deployments. Download the E-Book. https://nvda.ws/3Du3zIG,2022-10-26T00:00:00,[],https://scontent.fcai19-7.fna.fbcdn.net/v/t39.30808-6/313169815_1062181381114797_3944107651334765312_n.jpg?stp=dst-jpg_s960x960&_nc_cat=111&ccb=1-7&_nc_sid=9267fe&_nc_ohc=cbgqAZzCosEAX91-oEs&_nc_ht=scontent.fcai19-7.fna&oh=00_AfDtDzGZmhWTiMfi7fz5V01G7lbbqSIuWDND4wtlC5XZvg&oe=64E2DFAE,https://www.facebook.com/NVIDIAAI/photos/a.119492422050369/1062181384448130/?__cft__[0]=AZV0sXZMi_Bu82ZAW2QMfyEs_Zd6OF1meaDbDKeFICOdYAeeIcVHM4JYzC_9JF1j9a61FpS68KAD_-r20RveHJhNrV7xm995IMR9pV83E5C_XHHE0UOA8CRlv0rFtBU8rnC2KNWsS7kxzRBo8KVMm21rr0MNr2l6YsLUzFEPs3PniYneee4MdS_HFOcx6nx0_HkoHQKxpw4QTa_2nps87Bsg&__tn__=%2CO%2CP-R,8,0,positive,8
pfbid02GNo5HHPXJRpsYrMdxy73ZJPkEn4LVeuEP3XnUh2mwMZyasrwthRk1DnrfiU7yKGVl,NVIDIA AI,0,14,0,0,1,0,0,0,15,3,"Powered by NVIDIA Triton, Amazon Web Services  customers can maximize their AI performance and minimize #inference costs by using Amazon SageMaker Multi-model Endpoint (MME) to deploy thousands of deep learning or machine learning models on NVIDIA GPUs. https://nvda.ws/3zdePXi",2022-10-25T00:00:00,[],https://external.fcai19-7.fna.fbcdn.net/emg1/v/t13/13712401965918164892?url=https%3A%2F%2Fdeveloper-blogs.nvidia.com%2Fwp-content%2Fuploads%2F2022%2F10%2Finference-visual-aws-and-triton-lp-header-graphic-2505150-v5.jpg&fb_obo=1&utld=nvidia.com&stp=c0.5000x0.5000f_dst-jpg_flffffff_p500x261_q75&ccb=13-1&oh=06_AbHCs2y5H-yjQh-m9Zk20oudoqE4ttphCU3JoijBCTZLCw&oe=64E06533&_nc_sid=dbad39,https://www.facebook.com/NVIDIAAI/posts/pfbid02GNo5HHPXJRpsYrMdxy73ZJPkEn4LVeuEP3XnUh2mwMZyasrwthRk1DnrfiU7yKGVl?__cft__[0]=AZXsyo1u_EH3qM_GW7rlmsAx6KUx1uWhq_8_Tensp3aFVpVYux6wDA0qNL0SfwGEivgaVM6Q0j_gGNtJL5njTPp-wMm5wml3PNBzRXcGBYT8cKh_smt8PCRrX_B7g1_3YRPstGA3ee3T9Ttzgp9LXCF2_yhJ9HCn5TaxlhvrmCNjVXS5t8Jo-87Y5EB9-oa1ICs2Sw8Yr4iuia88DIUe1zmY&__tn__=%2CO%2CP-R,15,0,positive,15
1062112121121723,NVIDIA AI,0,10,0,0,1,0,0,0,11,3,"Tomorrow at 10:58 a.m. PT, hear from Jessica Dunn, SVP and Senior Data Scientist at Bank of America to learn how her team built a Data Science Organization, so data scientists could learn, experiment, and start #AI projects.Explore Jessica's session: https://nvda.ws/3CSULuy",2022-10-25T00:00:00,[],https://scontent.fcai19-7.fna.fbcdn.net/v/t39.30808-6/313027301_1062112117788390_3073621860151138025_n.jpg?stp=dst-jpg_p526x296&_nc_cat=107&ccb=1-7&_nc_sid=9267fe&_nc_ohc=PH297ey0-6UAX9m3tVM&_nc_ht=scontent.fcai19-7.fna&oh=00_AfDVjTZZTqWZZV7svGC7CiEGbIj8YotGQWHJHyZrsjo3eA&oe=64E3A793,https://www.facebook.com/NVIDIAAI/photos/a.119492422050369/1062112121121723/?__cft__[0]=AZXVfM5gmu2dy1f3iCoUbj1ntBpoUkQT6xBGYLg48PMHfc03TYcPUh1yQSkbAhWUuw2NKJ8wL1adUO34_gsb-aW4XTzPnIb2YaIKW54D08z21v5JyTKZV_P8q-z5bQvxVItuhI_B6mHPG9vfEatuNICs48IARZpmKjJqlKou6e49pUAI2TgKrDvEZKcmKfoTKKckO-BGO4jOjMSRpWsfOUPn&__tn__=%2CO%2CP-R,11,0,positive,11
1061487367850865,NVIDIA AI,0,9,0,0,1,0,0,0,10,0,"5 innovative fintechs. 7 minutes to demo. 1 AI and Product Innovation Zone. Check out the startups featured in the Product and AI Innovation Zone, powered by Amazon Web Services and NVIDIA: https://nvda.ws/3VOeZyk",2022-10-24T00:00:00,[],https://scontent.fcai19-7.fna.fbcdn.net/v/t39.30808-6/312808962_1061487364517532_3884174530858995173_n.jpg?stp=dst-jpg_p526x296&_nc_cat=107&ccb=1-7&_nc_sid=9267fe&_nc_ohc=UpFDRORIoXUAX9a3rXN&_nc_ht=scontent.fcai19-7.fna&oh=00_AfDNbFTqxwmSfI3JgTfLiPEYEvJdvRg35jc2OJlq5s_bDQ&oe=64E3EA93,https://www.facebook.com/NVIDIAAI/photos/a.119492422050369/1061487367850865/?__cft__[0]=AZVW01Jog29hQTiq5zfefhmZPZNmAy3Gp-ClQgjkVZu9V7SYea9LDVs-fq4f6ESYfPrZ-8HSoyikV2Swqe1HsfAQn3MB4xMUC_JeYutQb_YnPGJY9h68Fq01_meMFhlquSIgqj2TRyMofD50gh3xfcBZzTXB2bq20aD5-rlGK_--FGdvTBS7VTHVTqt0SB5wTEpuzfdNar1O_Zd7FqaNcXeH&__tn__=%2CO%2CP-R,10,0,positive,10
1061404274525841,NVIDIA AI,0,5,0,0,1,0,0,0,6,1,Banks are looking to improve customer experience using personalized recommendation engines and #AI-powered digital avatars.Learn more in this fireside chat with Quantiphi and NVIDIA  on October 25 at 10:30 AM PT: https://nvda.ws/3F6BqJ3,2022-10-24T00:00:00,[],https://scontent.fcai19-7.fna.fbcdn.net/v/t39.30808-6/312930754_1061404261192509_4793870228570055023_n.jpg?stp=dst-jpg_p180x540&_nc_cat=104&ccb=1-7&_nc_sid=9267fe&_nc_ohc=QtucOYNCSAQAX97Dm4g&_nc_ht=scontent.fcai19-7.fna&oh=00_AfDPjGXcm3vn9wm9X1PSfHTKPUfsFzMaR0sqptlBAw1ClA&oe=64E37D1F,https://www.facebook.com/NVIDIAAI/photos/a.119492422050369/1061404274525841/?__cft__[0]=AZWZDyyYUjwvT1x2g3zTcXBXQ-kZ4FUTcr5RfwACw5n_4eqHU8gGPDlMpGEvUMSgrIWh0nRRlXxb08eJgHaNyW5nE3wjzCya9eGsJeMZdmzHnGzX3-jVJRwMZP8gRHdL2SXKBl8W9dYkbvtTjYYWV2cQR_nUi9necBTu9CfIBZZs75fwMpbhhn35spXV9Durg0syAl_UHHGrxTxRcK44ET6E&__tn__=%2CO%2CP-R,6,0,positive,6
1061404281192507,NVIDIA AI,0,11,0,0,1,0,0,0,12,2,"Don't miss this how-to webinar with NVIDIA and AWS to learn more about #AI-driven physics challenges. Find out more about the Modulus framework used to create physics-based neural networks and digital twin models for complex, non-linear, multi-physics systems. See you tomorrow at 11 AM PST! https://nvda.ws/3Cq6gJJ",2022-10-24T00:00:00,[],https://scontent.fcai19-7.fna.fbcdn.net/v/t39.30808-6/312662357_1061404271192508_5471508470205906151_n.jpg?stp=dst-jpg_p180x540&_nc_cat=106&ccb=1-7&_nc_sid=9267fe&_nc_ohc=TF4IloNp-E8AX-FMPUw&_nc_ht=scontent.fcai19-7.fna&oh=00_AfCUeJuHXt9VqnIKFAM5If1iYUIL3uBMiv4ZuO6LcMGYdA&oe=64E37B93,https://www.facebook.com/NVIDIAAI/photos/a.119492422050369/1061404281192507/?__cft__[0]=AZWANE3iumf_8lBVVn-sWOau3NS-Q9CvCgQzDReATTat4X1skfJinoxr1MBdRKZOvyR3AxcDsn_hNKyr1ghu0Ub5J95hM46JfoUuTPT6tPt6fb_HOGH6usvjn9dB-Qswe6zkrBSknRo4HdI3KVS0K6MCAam5mxXAnPVBUlY8TrahhjVCz9Fgxnf5wbnkRVAEsmDRI1mFI7FPcoDelccQvRKd&__tn__=%2CO%2CP-R,12,0,positive,12
pfbid0Dq9KCVtPaKPuzmdWko5tHERa5L2gLGdcxaKK24cRKU75MdiJVpfyR79Mc2bwmh6nl,NVIDIA AI,0,9,0,0,1,0,0,0,10,0,Watch the Oracle #CloudWorld fireside chat with our CEO Jensen Huang and Oracle’s CEO Safra Catz to learn how the combination of Oracle’s powerful infrastructure with NVIDIA’s expertise in #AI will serve enterprises across industries.,2022-10-24T00:00:00,[],https://external.fcai19-7.fna.fbcdn.net/emg1/v/t13/6423249445197122084?url=https%3A%2F%2Fi.ytimg.com%2Fvi%2FMJAD7jViVrg%2Fhqdefault.jpg&fb_obo=1&utld=ytimg.com&stp=c0.5000x0.5000f_dst-jpg_flffffff_p480x250_q75&ccb=13-1&oh=06_AbHHW0q7F4mCUXCIOfIquOnbBQ69HJ6wrEBj381TFQTLBA&oe=64E066E7&_nc_sid=dbad39,https://www.facebook.com/NVIDIAAI/posts/pfbid0Dq9KCVtPaKPuzmdWko5tHERa5L2gLGdcxaKK24cRKU75MdiJVpfyR79Mc2bwmh6nl?__cft__[0]=AZUNhSTFSTJ5WH19-BlrhEOlmDcMX_Dy564I3NH5R0hin7nh11XU6QCySufgZV9Sw9GI_Rmrt-eoiYuVSzH-DkmMvk05jUaTZ-UJ7cEG8zdS2MHT7VZ-lO-YPlBhVBtbbQ0QDTljo7Xgn1zmx7Nba96-f09qXonH61Yf2aU9syHvEYtVnQsDHLER4TOCnD3qGT3xKBb8iZ6jfm3xjHd0U5DPbMD1XD2xDEpX5CU7_pXSTHhxAfMmVBtXwid4YsgJbm4&__tn__=%2CO%2CP-R,10,0,positive,10
1061338247865777,NVIDIA AI,0,13,0,0,1,0,0,0,14,3,Already developing in an AWS environment? Follow a 4-step tutorial and launch an AI virtual assistant on your web browser using Riva SDK – no prior experience needed: https://nvda.ws/3gsNry6#AI #deeplearning #datascience #NVIDIA #SpeechAI,2022-10-24T00:00:00,[],https://scontent.fcai19-7.fna.fbcdn.net/v/t39.30808-6/312818080_1061338244532444_144529806657518653_n.jpg?stp=dst-jpg_p180x540&_nc_cat=103&ccb=1-7&_nc_sid=9267fe&_nc_ohc=3UJ1r_eIVMkAX-pqvbZ&_nc_ht=scontent.fcai19-7.fna&oh=00_AfCPkVB0INX9a8FuvkabEQy73SM7m76T1Fq7CP1Fkh5IFw&oe=64E40E21,https://www.facebook.com/NVIDIAAI/photos/a.119492422050369/1061338247865777/?__cft__[0]=AZXjyALMVO-IQl9wnZ1aLrD8YKjaPrFBc5lBDF-5MnYItueKp5oUWwkNOSNM_0jZEFA0gv5eOSyaLHDZDbtju01xZlJHv63Ox-oBomzbwwo-iWpC0Pw0x43tsdKDus-jOsO7pouVKESIzwK5k0YtxfBhkTW8eqFZUd_i568LHCmqtzD65rD3xm-QgCYIrsLOuYgnTbtSl9zuYx7tlz1xUygi&__tn__=%2CO%2CP-R,14,0,positive,14
1060560731276862,NVIDIA AI,0,12,0,0,1,0,0,0,13,2,"Money20/20 starts today! Explore our featured session with Bank of America, fintech collaborations, influencer activations, and helpful resources: https://nvda.ws/3TlnAGN",2022-10-23T00:00:00,[],https://scontent.fcai19-7.fna.fbcdn.net/v/t39.30808-6/312717402_1060560724610196_4695185405820553950_n.jpg?stp=dst-jpg_p526x296&_nc_cat=103&ccb=1-7&_nc_sid=9267fe&_nc_ohc=GjMA3Xbu0jcAX_YNTWu&_nc_ht=scontent.fcai19-7.fna&oh=00_AfAtjScSPgEkFV5de8W73kIhruUk2fU-dSlvWoSx1wYpnA&oe=64E3E9BF,https://www.facebook.com/NVIDIAAI/photos/a.119492422050369/1060560731276862/?__cft__[0]=AZVTOCKbwVyhRHR1eaXpJO8tuzNGWDpJo8FZ7UTZUoWZ-bukI4ZDfPCeTvgOiqlpXpeIHwCiDsPeUc1gBAIhrUEwvnr3atwpemzDwkU0w-8xvzyY4xEt0s5gMvcLwu39yYpvxadBKJVIPSYQYP9odZY8XhQvtiOoiwwI_i-xNRgwG4tC_7BR30rGGGzyC8S6mhHanCJro6F9Kfz9ZJTPVUCh&__tn__=%2CO%2CP-R,13,0,positive,13
1059964444669824,NVIDIA AI,0,21,0,0,0,0,0,0,21,7,Hear some of the leading healthcare #Al startups speak on their use of the #NVIDIA & Microsoft healthcare solutions to develop intelligent applications unique to their workflows and accelerate scientific research. https://nvda.ws/3C8dGTv,2022-10-22T00:00:00,[],https://scontent.fcai19-7.fna.fbcdn.net/v/t39.30808-6/312407278_1059964441336491_3483936456179404009_n.jpg?stp=dst-jpg_s960x960&_nc_cat=108&ccb=1-7&_nc_sid=9267fe&_nc_ohc=I7mICEGad0cAX8VQNUd&_nc_ht=scontent.fcai19-7.fna&oh=00_AfBnbsEq0E41gQErHeJLZGFbElXCoYN3wDnUT4RAYlZvlw&oe=64E3EBE6,https://www.facebook.com/NVIDIAAI/photos/a.119492422050369/1059964444669824/?__cft__[0]=AZU45qMd1Tlv2XyEZe9H20NUFrg__ITxY_4GVLLtWKm3GGcR9ezZ3U_9LlMCU5o6-h3081CD5nRg8jT_2qwfbVboAb70dNE0DreHiJt598p_8Wzb9iIXS2rareGQHfVGGRmQbQonnRCiTQrIzU6ZYA9CVsEyj9rfQphCbpKecnVdxJqh7LBrjm9YkRL7Vw61pK6xfOfoTlNkRnGjA3FJ3TFc&__tn__=%2CO%2CP-R,21,0,positive,21
1059262424740026,NVIDIA AI,0,11,0,0,1,0,0,0,12,1,Learn how RAPIDS libcudf accelerates data science with optimized string processing algorithms. Dive into the techniques to write your own custom string transformations: https://nvda.ws/3sjGlyJ,2022-10-21T00:00:00,[],https://scontent.fcai19-7.fna.fbcdn.net/v/t39.30808-6/312563851_1059262408073361_8619256959022224142_n.png?_nc_cat=102&ccb=1-7&_nc_sid=9267fe&_nc_ohc=uuSmV2HHgXoAX9GleUJ&_nc_ht=scontent.fcai19-7.fna&oh=00_AfCcUMmwx_R9CdCvHRTyf5ZUnaZQLCdr_wfX8koLYEDBMw&oe=64E37363,https://www.facebook.com/NVIDIAAI/photos/a.119492422050369/1059262424740026/?__cft__[0]=AZWMh7CWA8tH9ftb3N2KKSkeEzF8Jgp-EMhvNE_P79MRyhjRebeHPQ194UL9nRS_nQvGFj4mysp0EZvBB5cI58qkDJGqc-R-vqTjVVlYZL9_Hj1Uuaxv9uSIIXaDq65rj33p_BXOnF1-rgHwWFByklWAfttf9gTwbAm-G6Ld5ZJHvIViD0ERfz2iGW-9TscCuSpknlKuc2YgNP-cz1-KOBAv&__tn__=%2CO%2CP-R,12,0,positive,12
1058698134796455,NVIDIA AI,0,10,0,0,1,0,0,0,11,5,"Missed last week's #MSIgnite? Catch up on the NVIDIA sessions, available on-demand.  Watch now! https://nvda.ws/3EEMHA5#AI #MicrosoftCloud #AzureML #NVIDIATAO #NVIDIAOmniverse #DRIVESim",2022-10-21T00:00:00,[],https://scontent.fcai19-7.fna.fbcdn.net/v/t39.30808-6/312446203_1058698131463122_4747714252180981749_n.jpg?stp=dst-jpg_s960x960&_nc_cat=103&ccb=1-7&_nc_sid=9267fe&_nc_ohc=YAG0WDRowaoAX8rMqqf&_nc_ht=scontent.fcai19-7.fna&oh=00_AfB6hH4x3yaUvTCZ20-OnQCVkbd5SYCrpvegkjKHZTUNQw&oe=64E336AC,https://www.facebook.com/NVIDIAAI/photos/a.119492422050369/1058698134796455/?__cft__[0]=AZVTNf9lHGealXmfX-hqQHWJDGVW-5YCvhYiZjzvICJp4k1KH0GJPD8PZeOnv4Xz5JsEtyf1JEmk4gEa_VTbB55UHD9jBZQMmqq6-uDpUpiAOdKBdb2bhDEXBSOumpTFKVLmsBNjpGf5ucekhGKEOXFiJD_L5T-Y7w55Xgq5gWjcStvmZFuXAIVTtIXYqruAO3EUfdiVJ67MV0L0poKiarjs&__tn__=%2CO%2CP-R,11,0,positive,11
pfbid0Lidk4d4siNM4JpmKhYSsyoi72So69o5q1g9ys2vx1YjTrurM9WWpWgaHhjcxJBgvl,NVIDIA AI,0,12,0,0,1,0,0,0,13,1,"Learn how natural language processing (NLP) can be leveraged in #cybersecurity workflows to assist in breach protection, identification, and scale and scope analysis. #IT",2022-10-20T00:00:00,[],https://external.fcai19-7.fna.fbcdn.net/emg1/v/t13/635599381906092984?url=https%3A%2F%2Fdeveloper-blogs.nvidia.com%2Fwp-content%2Fuploads%2F2022%2F10%2Fnlp-and-cybersecurity-security-tech-blog-phishing-1920x1080-1.jpg&fb_obo=1&utld=nvidia.com&stp=c0.5000x0.5000f_dst-jpg_flffffff_p500x261_q75&ccb=13-1&oh=06_AbFTk76fKXZpTLMz4rNLUAS5TrYesJ0oTvuuYjFFKAI1Aw&oe=64E0A91F&_nc_sid=dbad39,https://www.facebook.com/NVIDIAAI/posts/pfbid0Lidk4d4siNM4JpmKhYSsyoi72So69o5q1g9ys2vx1YjTrurM9WWpWgaHhjcxJBgvl?__cft__[0]=AZWs6_hFR8i_MEKxtfnVYW_WIXUaQwIh2WCD4nwIMYbXa5VRvmGgMnV9ZFlbwrS8aIUbEnNAOwsNdzBAY7E_hLSwNr2hytZY2wAAnImVIS9KrTWRR7cJwlTutr1qxOFA6XEtgRuRbqicJDx1nuiyuJtt6Qr2H_uZ8g1Xz4NtOv2DJ_vZgTUyd3AMIRhbPbfxbJH6MTAfwABmyfHQi-JIWOmd&__tn__=%2CO%2CP-R,13,0,positive,13
pfbid02umVKadGy2LCEgJTBq4CAz3c1pUofVhyn1JRhBWo7ByW4dfAZAJrR73NBQTa4Cxvfl,NVIDIA AI,0,10,0,0,1,0,0,0,11,3,Mozilla Common Voice and NVIDIA collaborated to build an automatic #speechrecognition model for the Kinyarwanda language using NVIDIA NeMo pretrained models. #AIModels Learn more: https://nvda.ws/3svFuLz,2022-10-20T00:00:00,[],https://external.fcai19-7.fna.fbcdn.net/emg1/v/t13/15012094113263814804?url=https%3A%2F%2Fdeveloper-blogs.nvidia.com%2Fwp-content%2Fuploads%2F2022%2F10%2Fimage1-5.png&fb_obo=1&utld=nvidia.com&stp=c0.5000x0.5000f_dst-jpg_flffffff_p500x261_q75&ccb=13-1&oh=06_AbFazvM1gg0htzaeP5_AxHBcSfz4ZpZxSrM8c9s-jjdJcA&oe=64E052D6&_nc_sid=dbad39,https://www.facebook.com/NVIDIAAI/posts/pfbid02umVKadGy2LCEgJTBq4CAz3c1pUofVhyn1JRhBWo7ByW4dfAZAJrR73NBQTa4Cxvfl?__cft__[0]=AZWB_hBa2s5GupkSHrXlH5Zcj26wjBc8BBYzRmce4qynk7RLQi0AT5EhNEmqpK4oo_Vxx494j9n68rpH7WfdCV9zPCPlP58ZdPlPB82zP6pSBG54wx-TB2Dr6u9zQujzJQkr8ci4bc_u-G2FggDTPvO9C5lC4eVq2ihcGsSEpZe6NvLqg6j5fH_n5Pm_2pIC5XwSpI7wAePu78obpD7gkDv8&__tn__=%2CO%2CP-R,11,0,positive,11
pfbid02J5QpX4Gun1GetJZY1QJy6dxnKHdNihbVAujPf2kX5fcAoKrLv38DVnoVis9JXfAsl,NVIDIA AI,0,20,0,0,0,0,0,0,20,1,"At Oracle #CloudWorld, our CEO Jensen Huang and Oracle's CEO Safra Catz discussed their companies’ expanding collaboration to speed up adoption of enterprise #AI.",2022-10-20T00:00:00,[],https://external.fcai19-7.fna.fbcdn.net/emg1/v/t13/1745696978976431333?url=https%3A%2F%2Fblogs.nvidia.com%2Fwp-content%2Fuploads%2F2022%2F10%2FSafra-Jensen-waving.jpg&fb_obo=1&utld=nvidia.com&stp=c0.5000x0.5000f_dst-jpg_flffffff_p500x261_q75&ccb=13-1&oh=06_AbGL4uVMryJbLn8QpioynciqMCANSZwMkgmTnbVVBrl6IQ&oe=64E0B7B4&_nc_sid=dbad39,https://www.facebook.com/NVIDIAAI/posts/pfbid02J5QpX4Gun1GetJZY1QJy6dxnKHdNihbVAujPf2kX5fcAoKrLv38DVnoVis9JXfAsl?__cft__[0]=AZV26HJoX5XXqDHRh_r5PfT7bAypBKyhVcNlvdDWJwy6nWszqQhx6MmlAU8ieQK1s0d8xPlVbxQsEOjwzZWZizw7cRG1Q3favv4wIpYBaNPhVTAZ8YiBxhgPlGNj3qTeZ1DS1pNLGERikX1lNWw9yIibQpSuM9tbOK_ILT_8Mbq1LN0Bms7Ag9LTCPkbxY3ly-wuv9hRAXm7fijKQHb8nnqU13lnEh86uz113aI92EfSmFpZeTgYdh1btrqXc2yhCIk&__tn__=%2CO%2CP-R,20,0,positive,20
pfbid0NjbgUv2bqVAtGWbCTBvbp2efUqfgwgRbJmuQvP5NYJez8MP8YyDzbKkx5m7Lh1sdl,NVIDIA AI,0,10,1,0,1,0,0,0,12,5,"Take the Fundamentals of Deep Learning workshop on how to use multi-layered artificial neural networks to deliver state-of-the-art accuracy in tasks such as object detection, speech recognition, and language translation. Register now: https://nvda.ws/3fEyIzD",2022-10-20T00:00:00,[],https://external.fcai19-7.fna.fbcdn.net/emg1/v/t13/10808576316329199456?url=https%3A%2F%2Fprod2-sprcdn-assets.sprinklr.com%2F50276%2Fc371012a-9ebf-4bcd-9d87-e071bc744e5e-1450463413%2Fdli-deep-learning-course-linke.jpg&fb_obo=1&utld=sprinklr.com&stp=c0.5000x0.5000f_dst-jpg_flffffff_p500x261_q75&ccb=13-1&oh=06_AbHa1EUshCwo5K3nYujbahHaSi6wOHd5GchZTjd89JR9uA&oe=64E05BFA&_nc_sid=dbad39,https://www.facebook.com/NVIDIAAI/posts/pfbid0NjbgUv2bqVAtGWbCTBvbp2efUqfgwgRbJmuQvP5NYJez8MP8YyDzbKkx5m7Lh1sdl?__cft__[0]=AZXu4Cvon3InN-6qiDRCxnEoSgGQkY6FUHgFDuDbuj1rlbNOZihsV6ErS64iOwER9OP2mOdn_HmRtiOHNNAWGU_5yHNFi1QCzyymjwDupT4sNt4lcYEqfod1FQiPrgVG68O-DmSI0bnikZBVcdbMfKqN_c13IBKuSZUEtU00-Ffgd2x099J6cyT0x-oIAKcmyGS-SFW8YGa47RSW7ayarUBi&__tn__=%2CO%2CP-R,12,0,positive,12
1058540268145575,NVIDIA AI,0,9,1,0,1,0,0,0,11,1,Interested in learning about Zero-Shot Multi-speaker text-to-speech? Join us at the inaugural NVIDIA Speech AI Summit on November 2nd! Register Free: https://nvda.ws/3reiNKW,2022-10-20T00:00:00,[],https://scontent.fcai19-7.fna.fbcdn.net/v/t39.30808-6/312209000_1058540261478909_5078126543107034809_n.jpg?stp=dst-jpg_p180x540&_nc_cat=101&ccb=1-7&_nc_sid=9267fe&_nc_ohc=yoLw4bGeNt4AX_ZJFS_&_nc_ht=scontent.fcai19-7.fna&oh=00_AfBdbN5lVSiVvTp5ud3Crux6TV0_FuRplT0FVwVR0EBiWA&oe=64E39342,https://www.facebook.com/NVIDIAAI/photos/a.119492422050369/1058540268145575/?__cft__[0]=AZVtl1Nu6CHVn_6kUyCGhHC_dSomKb7zyk42w8q08j-6PzFSqbPuDdNfwAbLK-hIkO_9gnq-clWFtWMR_bAnuHcrxz8XzS58QgQp1gPkdEU_OEvp5phtbL08eh6uWFwvP1xmYR2DlFP8yKdTwNMR3WbloylMGie5ISHFg0y-81bRVkBDkP8C4vty6nTsDi9eHKR37pd4nQY02N_UqG2ps_iK&__tn__=%2CO%2CP-R,11,0,positive,11
1058476124818656,NVIDIA AI,0,7,0,0,1,0,0,0,8,0,"T-5 days! Join this webinar and get an intro to ML applications in science and engineering, as well as take a deep dive into the code implementation, training, solution, and visualization aspects of a physics-ML workflow. Sign up today: https://nvda.ws/3T9bCQ7",2022-10-20T00:00:00,[],https://scontent.fcai19-7.fna.fbcdn.net/v/t39.30808-6/306745656_1058476121485323_2617710071164989465_n.jpg?stp=dst-jpg_p180x540&_nc_cat=109&ccb=1-7&_nc_sid=9267fe&_nc_ohc=7NTKsX_braEAX9cNMTA&_nc_ht=scontent.fcai19-7.fna&oh=00_AfA0VoqbzlOA8QPaMaFnF1CExWHLTyHtP0g3GePsJIQxqQ&oe=64E35C09,https://www.facebook.com/NVIDIAAI/photos/a.119492422050369/1058476124818656/?__cft__[0]=AZVzdnnH19km8nHA4fzcFccvWmiG_c6dExK52c_Ex8qIk2EqL3lW2MGfLXq8Ia2E-LM5ER74QI2vUY48Qowa7TibNBHRiUiL0JkiPHzTWyrSBwgdJBUhh9PwXydxru0Pw1d2LseAHcj5I2MjwG6fCgxMxuhIQLGBiGJJZX-XUxNDkJ9o97Ack_vXLcwGbmMPXTOyZZumPH9FFolHoATYs3gX&__tn__=%2CO%2CP-R,8,0,positive,8
pfbid032q8rUqHbLUEGHFmyx8BbHwUGw9HTzAbhWkBEpYUpSa5whrvGnRGeL1vAh5AhS3JFl,NVIDIA AI,0,12,0,0,1,0,0,0,13,0,See how #CohereAI accelerated language model #inference on NVIDIA GPUs and increased overall inference speed by 4x with NVIDIA Triton Inference Server. #LLMs #LLMinference https://nvda.ws/3sbPhpP,2022-10-20T00:00:00,[],https://external.fcai19-7.fna.fbcdn.net/emg1/v/t13/5629064352368036296?url=https%3A%2F%2Ftxt.cohere.ai%2Fcontent%2Fimages%2F2022%2F10%2Fcohere-nvidia.png&fb_obo=1&utld=cohere.ai&stp=c0.5000x0.5000f_dst-jpg_flffffff_p500x261_q75&ccb=13-1&oh=06_AbELJ1UQe4NJB1yulzDaVDzcodHr4rWtypRGQq4OTaazZw&oe=64E07FD7&_nc_sid=dbad39,https://www.facebook.com/NVIDIAAI/posts/pfbid032q8rUqHbLUEGHFmyx8BbHwUGw9HTzAbhWkBEpYUpSa5whrvGnRGeL1vAh5AhS3JFl?__cft__[0]=AZWixz0sMbXxkPxOXxbhV9suZjjlnnaC_kPfXs0KuzBHHlgh0SqNIM27l6e6wBisiBe2nkxE3QQb8hrG3XOj9bf-C5l17GJOT0KFTyQpyFh9i0MV4P0RgYYTpv1GzShwqDxkfaNTJg3OeNfhDuaXHG81y6uUomq14FL30uB1yp9TsojJstKY_ZawkDu_Ip2yBp9Mucuri_glLs8crs_e5nJs&__tn__=%2CO%2CP-R,13,0,positive,13
pfbid02vfFkTvfEujmXmVhYLvBMADbLMLDfEMuEjyaG72MGf1VQRjCQ8vPj7Ls6ESuNAUwHl,NVIDIA AI,0,5,0,0,1,0,0,0,6,0,Check out this new #AWSonAir episode featuring Amazon Web Services and NVIDIA Triton and NVIDIA TensorRT. Learn how NVIDIA's multi-framework inference-serving solution can help you address the complexities of #AI #inference. https://nvda.ws/3VJM9yP,2022-10-19T00:00:00,[],https://external.fcai19-7.fna.fbcdn.net/emg1/v/t13/14519816031614850108?url=https%3A%2F%2Fi.ytimg.com%2Fvi%2Fh60Pu2rQSVw%2Fmaxresdefault.jpg&fb_obo=1&utld=ytimg.com&stp=c0.5000x0.5000f_dst-jpg_flffffff_p500x261_q75&ccb=13-1&oh=06_AbGNDQNgqfMxDwLkij24iOG-RcJdIgYPBocs9y1-JL62PQ&oe=64E03117&_nc_sid=dbad39,https://www.facebook.com/NVIDIAAI/posts/pfbid02vfFkTvfEujmXmVhYLvBMADbLMLDfEMuEjyaG72MGf1VQRjCQ8vPj7Ls6ESuNAUwHl?__cft__[0]=AZWgbtCmqgT5PIOq86f_eCvYTWS_tniqFO_ri63ZXelb-ou83w6js199i6z4ahk2mHtb6Cta2iXvcd8KTGE_CdGim1wSMg41E_-kZBwxHk-PNyi3po7F9pzqOaKSa-c_fmh0lE9rFHweUu0of8VFUAtBp4V9BFhvRaVgx3SiL77rPYGcblN52IeZE9-2KMXA65Ma9u6PsSHSj2hC_mYp4IIv&__tn__=%2CO%2CP-R,6,0,positive,6
pfbid0226Yaf1qehv6vJV3LUFiHzn856AUZAC8qiKNeGR3awLGjY6dDxxWyE5qyA1ejADhtl,NVIDIA AI,0,9,0,0,1,0,0,0,10,2,"Deutsche Bank is increasing value and convenience for its customers by applying data-driven insights that use cloud, #AI, and #machinelearning. Watch the on-demand session featuring Deutsche Bank's Chief Technology, Data and Innovation Officer, and Member of the Management Board: https://nvda.ws/3rWQYqZ",2022-10-19T00:00:00,[],https://external.fcai19-7.fna.fbcdn.net/emg1/v/t13/13578281557585859193?url=https%3A%2F%2Fcdnsecakmi.kaltura.com%2Fp%2F2935771%2Fthumbnail%2Fentry_id%2F1_bizkkrre%2Fwidth%2F1200&fb_obo=1&utld=kaltura.com&stp=c0.5000x0.5000f_dst-jpg_flffffff_p500x261_q75&ccb=13-1&oh=06_AbHS9ek2AkJ1AkxvDa-jq_OrApKk7ESRZuVv4EbaTSo17A&oe=64E096D0&_nc_sid=dbad39,https://www.facebook.com/NVIDIAAI/posts/pfbid0226Yaf1qehv6vJV3LUFiHzn856AUZAC8qiKNeGR3awLGjY6dDxxWyE5qyA1ejADhtl?__cft__[0]=AZVEAu8ezlMUXFyw3saOacr-b_XQNMM2W7_YOyjsq68ZHcGyO69C61hP_pZZfGkJsxE7m5NaCUr6RcINiLWQ3iuwg0HLADFaiXBtB8Sun-U2Hih1rxFd3ZiUrOICEerXGNHxRw-sJzzxs9ff56Atu_uATIrnlQDZfgRRmiPKCd2WAaImEOkyQYT-h7cz5ugf3X_JqTAHGkXQWGFaOm5vVy1t&__tn__=%2CO%2CP-R,10,0,positive,10
1057906674875601,NVIDIA AI,0,7,0,0,1,0,0,0,8,3,How fast can you predict?Learn how we reduced training time from 69 minutes to 40 seconds for a scikit-learn based winning solution — a 103.5x speedup -- using cuML and changing only six lines of code! https://nvda.ws/3TCFUv8,2022-10-19T00:00:00,[],https://scontent.fcai19-7.fna.fbcdn.net/v/t39.30808-6/312343490_1057906664875602_6444633440433536996_n.jpg?stp=dst-jpg_p180x540&_nc_cat=104&ccb=1-7&_nc_sid=9267fe&_nc_ohc=dQBQF4FRRP4AX_hNqE0&_nc_ht=scontent.fcai19-7.fna&oh=00_AfD_Gx5v0REnQbVMo-EYbS0MAoFgao3ORiRGlmCMAMpkJg&oe=64E3CB60,https://www.facebook.com/NVIDIAAI/photos/a.119492422050369/1057906674875601/?__cft__[0]=AZXdv6ERwxfcEGFmJNsizFF8hRa0AU8IodLd2VV3oJ2AED-XHZYFgwoIV_CAjYioORPX7NlpH7hjQPefXK4G_FS2IUfOC74MGLho_b7thOcWX3eTdaLT6SJkGwSGq3wiGaSWKWfpFERfNrPxxiv14q6RdUsAwRTy53_GiF8u-F1rA3qDGI878kIcMz0AhILcf5JTI5HEb5NidaTBs81AXww_&__tn__=%2CO%2CP-R,8,0,positive,8
1057867948212807,NVIDIA AI,0,11,0,0,1,0,0,1,13,2,Join us at the NVIDIA Speech AI Summit to learn how Mozilla Common Voice and NVIDIA are working together to unlock speech AI technologies for the world's many languages. Register Free: https://nvda.ws/3reiNKW,2022-10-19T00:00:00,[],https://scontent.fcai19-7.fna.fbcdn.net/v/t39.30808-6/311150174_1057867938212808_2731171982212607290_n.jpg?stp=dst-jpg_p180x540&_nc_cat=109&ccb=1-7&_nc_sid=9267fe&_nc_ohc=vylSCZlrgicAX_-3Xbb&_nc_ht=scontent.fcai19-7.fna&oh=00_AfDoei0Z9QVp4TRQR0w9maGmvkGgnCVjrnwYkCT46Lkr9A&oe=64E2C43B,https://www.facebook.com/NVIDIAAI/photos/a.119492422050369/1057867948212807/?__cft__[0]=AZVcrSCG8EwCS57muB_WkUvKFd7qTZoPONGHmsSitlEdkhnIaC8Bt2KNkDv_NmatRNxtKnH254fpNoMNA-s8KdJ1OvC-JbjYMaG0zx6p-L7A2rB3FgXK5zAqVwMNaC8mLQUd3O6tADACgPwPtV4uaGZ0k9nSt3vGznaWYe9cPP8M5WE4VIEujqkhkQQ7AksVV9rUOurf784fUNNWvDAKwIvk&__tn__=%2CO%2CP-R,13,0,positive,13
pfbid035GEd4gQQnpNEie8T9YQkpsuGwo2eynRPXoXfdNwPzL9ZxQLnxZBDhTGgakNnozbcl,NVIDIA AI,0,9,0,0,1,0,0,0,10,1,"On November 9, don’t miss our Retail Edge Computing 101 introduction webinar, including which applications you should deploy at the #edge versus in the #cloud.Join us: https://nvda.ws/3yt53zV",2022-10-19T00:00:00,[],https://external.fcai19-7.fna.fbcdn.net/emg1/v/t13/11452804030803988545?url=https%3A%2F%2Fprod2-sprcdn-assets.sprinklr.com%2F50276%2F56a4dd9e-319d-4bdc-ba9a-442badf3523f-68451076%2Fsocial-edge-ai-computing-101-w.png&fb_obo=1&utld=sprinklr.com&stp=c0.5000x0.5000f_dst-jpg_flffffff_p500x261_q75&ccb=13-1&oh=06_AbHs1oxb4M1OnM2XP1JgbCW6evtfG5HwmGoWqxoMa5fhEw&oe=64E0A261&_nc_sid=dbad39,https://www.facebook.com/NVIDIAAI/posts/pfbid035GEd4gQQnpNEie8T9YQkpsuGwo2eynRPXoXfdNwPzL9ZxQLnxZBDhTGgakNnozbcl?__cft__[0]=AZWMZk4xl5lFONynVtb_89KzZTZg_kMzWOa5iH0IlYxD5cipiK9V5-6e75QE0P0VZl7kzwsaeYXzvWPpdfE9u-m0ZDlzkfN_ZCXte5s25YYrhIyHD1Tp5tilOdp-AEOEsUwHsOYFUPVpzBU8bnRwDTk7eTbblT-Vc-w8P33WLCAwB7HigGNHPLq-KfNpNpAage3C_fZ5hSEI_RTtB2A3W8ec&__tn__=%2CO%2CP-R,10,0,positive,10
1057201414946127,NVIDIA AI,0,8,0,0,1,0,0,0,9,0,"Next week on Oct 23-26, join Amazon Web Services and NVIDIA at #Money2020USA, to see how #AI, #machinelearning, and #datascience are driving innovation in the financial services industry. Learn more: https://nvda.ws/3RYB21T",2022-10-18T00:00:00,[],https://scontent.fcai19-7.fna.fbcdn.net/v/t39.30808-6/312284175_1057201411612794_1181283454076431072_n.jpg?stp=dst-jpg_p526x296&_nc_cat=103&ccb=1-7&_nc_sid=9267fe&_nc_ohc=tKLGuwOw45sAX9AIEiL&_nc_ht=scontent.fcai19-7.fna&oh=00_AfB7_oBi12CSAs82vnKOq0dqiI755620M-unoR90y1bNaQ&oe=64E2C5AD,https://www.facebook.com/NVIDIAAI/photos/a.119492422050369/1057201414946127/?__cft__[0]=AZW6ARQYtjP-0NHPq8XfU3OUumwZxaAXh7Wzdb0rsk15AjmiyDg5wwQqzXFEJZzJzi6HYMfYSeJ-pbvrZjeWeymOq3b1v5LA08UAyi-pGQS1iGX7lPjR4r7E3ucg5NTGhIxhE3iDTzg29z1MsqfRJLplZEvGykUPqSLu97XjdO1C6NchJOmYHg6mQ7tlXG1QxSqPWYE2pcQR8OG2XYDy3I-o&__tn__=%2CO%2CP-R,9,0,positive,9
pfbid0zpPfjQNgLnfJqfTrQJYngTzBpXh9QmXHnTJdbmnDxrhmrYy23Px1CoidRmgekUDjl,NVIDIA AI,0,7,1,0,1,0,0,0,9,0,"Today at #CloudWorld, we announced a multi-year partnership with Oracle to help customers solve business challenges with #AI. This collaboration aims to bring o… See more",2022-10-18T00:00:00,[],https://external.fcai19-7.fna.fbcdn.net/emg1/v/t13/8469430009045849992?url=https%3A%2F%2Fprod2-sprcdn-assets.sprinklr.com%2F50276%2Fcdd66a9d-48ee-4263-a966-c0901b98d407-881571320%2FCopy_of_oracle-logo-lockup-pro.png&fb_obo=1&utld=sprinklr.com&stp=c0.5000x0.5000f_dst-jpg_flffffff_p500x261_q75&ccb=13-1&oh=06_AbGsy4I2tJwunkb3RHc_CARwfPQGqhFzImIn_aunZc_yfA&oe=64E04614&_nc_sid=dbad39,https://www.facebook.com/NVIDIAAI/posts/pfbid0zpPfjQNgLnfJqfTrQJYngTzBpXh9QmXHnTJdbmnDxrhmrYy23Px1CoidRmgekUDjl?__cft__[0]=AZWjvgmbg3-AEqqZTIYLTvvIQ7AR5ik97sN063i6xaGuhQO7RjsS3e-3M2RGOSkY6wnG0RQ2HbV4TksvSYXPI4TG9CxyojdHOKxMnSiXcGvx_bgiuXVce406QN9D9HFtFo0Tbb7M4cXRc-J7VdXBKXZRQrBJMLtTn6EojaNgtLsEHxnul30iVeJ5qPCXh6nKbrLys4WYp-qBhiE9azqhyhmGY_QMbfHoUkiQatWarlk011OeLJ4Y9KYXB2XZpexUNKw&__tn__=%2CO%2CP-R,9,0,positive,9
pfbid02oxMiJE3nzG3eCP2wg3CYmGSRUNBraVY6aKANUwpTnoZBSB1G19LWaQVha7MmB8j2l,NVIDIA AI,0,7,0,0,1,0,0,0,8,0,"Don’t miss our keynote session at Global AI Community!NVIDIA's Manuvir Das reviews the impact of #AI on software development, and shares how NVIDIA is making … See more",2022-10-18T00:00:00,[],https://scontent.fcai19-7.fna.fbcdn.net/v/t39.30808-6/312229599_1430529537690518_4210251953822559048_n.png?stp=dst-png_p526x296&_nc_cat=107&ccb=1-7&_nc_sid=9267fe&_nc_ohc=YeECyGZhNigAX8K6hDk&_nc_ht=scontent.fcai19-7.fna&oh=00_AfBH72no3S8eeSEuf0m6bo-b4eaI8xdVSn-_mjQVeIvRQQ&oe=64E454A8,https://www.facebook.com/NVIDIAAI/posts/pfbid02oxMiJE3nzG3eCP2wg3CYmGSRUNBraVY6aKANUwpTnoZBSB1G19LWaQVha7MmB8j2l?__cft__[0]=AZU6sUgwtOKY-sJmrCTjSDpCcOVA_opTT7eOHwTrSwzWzyetdYeCLPnPLrWoKAsqKgu8lNBTY9ZHxJg5utTQKgCrHODFn6WqmQBBaAVgXlyP2--HDxiezF9UO6jP3_piZnuQ7ib81iR5FGvcZSqWgN0FwskFkr_tPDfHHbyB35mVaPTyBu2cRcqW9hOzUpwfh30RcPcfKF-WRQHoWjCjPrYn8dGqFGOSDpQNIVMjkGWt0VRRQveOpT7iDtzOo8e5ubdK56KIrFLJjDRHLvfEE_t4&__tn__=%2CO%2CP-R,8,0,positive,8
pfbid02sDHrYqju4myFQvfGh5Vc2G9gBX96iBZu5zQ1dLRbWoRDJw7vf9nzfHQv8EDwFCqtl,NVIDIA AI,0,7,0,0,0,0,0,0,7,3,Join NVIDIA Deep Learning Institute in an instructor-led workshop and learn about the fundamentals tools and techniques for accelerating C/C++ applications to run on massively parallel #GPUs with CUDA. Register now: https://nvda.ws/3CbbRUa,2022-10-18T00:00:00,[],https://external.fcai19-7.fna.fbcdn.net/emg1/v/t13/13252624424900670158?url=https%3A%2F%2Fprod2-sprcdn-assets.sprinklr.com%2F50276%2F09197d3a-61f3-4cc0-a436-509a874d03b4-1977537557%2Fdli-fundamentals-of-accelerate.jpg&fb_obo=1&utld=sprinklr.com&stp=c0.5000x0.5000f_dst-jpg_flffffff_p500x261_q75&ccb=13-1&oh=06_AbEf_wqLZG8RMb3kHLBnlW_Y6YrD0xrOJuHLu6VDeXJLQA&oe=64E0729D&_nc_sid=dbad39,https://www.facebook.com/NVIDIAAI/posts/pfbid02sDHrYqju4myFQvfGh5Vc2G9gBX96iBZu5zQ1dLRbWoRDJw7vf9nzfHQv8EDwFCqtl?__cft__[0]=AZX743dgLGdulWo6ZICHY1XSfbyUi4OyVTN_qKSIUlev9zhYwvwuIflaPBlC4ZEaQEHKNEKB4Y-GZufeg7gNkG-5Zn8u6txjj8PWn2x6-2ZX96OUwU_rCzK9IJEizJVpz2VrfZ-kHNAMWiQrv3jrTjExYMA2KSN8my9iXzX9uLbjjBrxgcnOPX3uOlkG9M8JTA_TQDBNQ8dO67G7WijFbOuF&__tn__=%2CO%2CP-R,7,0,positive,7
1056979358301666,NVIDIA AI,0,12,0,0,1,0,0,0,13,1,"Announced at #CloudWorld, @Oracle and NVIDIA partner to bring NVIDIA #AI platforms to OCI including NVIDIA Clara with additional AI-accelerated Oracle Cerner offerings for healthcare. https://nvda.ws/3MGMSww",2022-10-18T00:00:00,[],https://scontent.fcai19-7.fna.fbcdn.net/v/t39.30808-6/310561529_1056979351635000_2475811571999096111_n.png?stp=dst-png_p180x540&_nc_cat=102&ccb=1-7&_nc_sid=9267fe&_nc_ohc=kdXKpklbHu0AX-62Rat&_nc_ht=scontent.fcai19-7.fna&oh=00_AfACtc6ZEl4IKrA1OjftWRLQhCzP2NVvCEgjb2Fid4vTcg&oe=64E2BA3F,https://www.facebook.com/NVIDIAAI/photos/a.119492422050369/1056979358301666/?__cft__[0]=AZUVO0sP2FtnzEFEeYe_KPkBr2Cf_DMVqS48uMY8pbtq7-Zv1ZDUKe6jE_pTZeO4RMXfIQNTsXu4491xZewfBytRNSWMOATwo3Rn7TQvEkuUEaEwKWpJkhhgwPjj7WekeOlFoY3WelbSKSf7keqQJ6pvFAu5oo0ALHvrX7dD8MSt3pLgAN4ruYu_RTJJ-yN42yqwLY1N9WTzUc28W_E5D5zz&__tn__=%2CO%2CP-R,13,0,positive,13
pfbid0BN5Xj1BdQwGycGB6rm8BXHRbbf9i8wqDEFdXHx5w2tNHXe9Xr767EjntzbFy7SpCl,NVIDIA AI,0,41,5,0,0,0,0,0,46,6,"Interested to know why GPUs are important to #AI? Join us in the next NVIDIA Emerging Chapters Education Series and learn why they are an essential part of modern artificial intelligence infrastructure Oct 20, 2022 at 3PM GMT.Register now > https://nvda.ws/3VbyNeJ",2022-10-18T00:00:00,[],https://scontent.fcai19-7.fna.fbcdn.net/v/t39.30808-6/311176927_1424478604962278_2850599668465210971_n.jpg?stp=dst-jpg_p526x296&_nc_cat=107&ccb=1-7&_nc_sid=9267fe&_nc_ohc=9GntSbuwobgAX9TDIw0&_nc_ht=scontent.fcai19-7.fna&oh=00_AfBGB-526HopVncjikBTG3F5vK6Iowy44tZA98M0JQ481A&oe=64E343EB,https://www.facebook.com/NVIDIAAI/posts/pfbid0BN5Xj1BdQwGycGB6rm8BXHRbbf9i8wqDEFdXHx5w2tNHXe9Xr767EjntzbFy7SpCl?__cft__[0]=AZWGG94v9MdB7_NjSTVkS44piYuU9qXYOYP29ZaRPTXvW7h5jD_kJz0uJHoLucj1FnyjlyJv8V1z04V_-Zz2xUZjh6NPo_xd4HHDCJQws4L9sbhPlqtMh0AHimZ17YwWp96VvwltKjrlALt0HSe-Qs4NIP8NVLQbyPv294RyyVz1iIqkNDdR5pKYX3YNHFrdHZUGtQk1Vwt6UqFPTHNmoM-N03H4Whpw6UUsbse1YbJLSTmXIvFg_Hr85u8QTxDFyB1yPFWMc3ZZYVW26Zc89JaS&__tn__=%2CO%2CP-R,46,0,positive,46
1056914601641475,NVIDIA AI,0,9,1,0,1,0,0,0,11,4,Be sure to check out the new Edge AI and Robotics Teaching Kit release for qualified educators - available now! Download an NVIDIA Deep Learning Institute Teaching Kit today. https://nvda.ws/3S4kIN7,2022-10-18T00:00:00,[],https://scontent.fcai19-7.fna.fbcdn.net/v/t39.30808-6/312179739_1056914594974809_344495602103451067_n.jpg?stp=dst-jpg_p180x540&_nc_cat=111&ccb=1-7&_nc_sid=9267fe&_nc_ohc=pGH66N_phl8AX-kfuyz&_nc_ht=scontent.fcai19-7.fna&oh=00_AfBULvOsPNajm5LB2IU6dd96nRrA1eK98F8EbapPtgWXow&oe=64E3F33C,https://www.facebook.com/NVIDIAAI/photos/a.119492422050369/1056914601641475/?__cft__[0]=AZXogjC7DcaenX0b7BWWjUSHvWNZPhWgyu04eiR4qUs-eb7pyz5QHBNGnMuCjA3-YQ7jt987JEtr6_5tKBWStrZlVXr7mNpWevd5Wh9KfcrPgjXrdKOIZEALGkTGuKmfd8gLfjI99xWF8tIchgCn0QrBb6JX0qWD_jhuFCLpI9UHIkhJMVAEN1NYI0f9E_Nt66jeajr9O103Qp6qWu6hEvuQ&__tn__=%2CO%2CP-R,11,0,positive,11
1056881238311478,NVIDIA AI,0,9,0,0,1,0,0,0,10,1,"Don't miss out on NVIDIA's #MSIgnite sessions, available on-demand.Watch here: https://nvda.ws/3MvS46A#AI #MicrosoftCloud #AzureML #NVIDIATAO #NVIDIAOmniverse #DRIVESim",2022-10-18T00:00:00,[],https://scontent.fcai19-7.fna.fbcdn.net/v/t39.30808-6/312128997_1056881231644812_447144611962620959_n.jpg?stp=dst-jpg_s960x960&_nc_cat=110&ccb=1-7&_nc_sid=9267fe&_nc_ohc=I7ujKgFYXlMAX9rByxw&_nc_ht=scontent.fcai19-7.fna&oh=00_AfCINum6KYlNqIFNZyyA-evwBe71-urIvYHlJHSJXUGMLQ&oe=64E2BCF5,https://www.facebook.com/NVIDIAAI/photos/a.119492422050369/1056881238311478/?__cft__[0]=AZWnu8Tlfqtl-r55rVzspXKP37uxL08UfGwn4kxQx6-S0wmNrrmT4MOSNreekq9N_H273iYopRj4d-FeONM1xNJk7EMGaX15tXiOYLorCIeBr3lXcSncjJBInH6b9BHBC2u2L9yJ6f1b1ge-6_lKYyeGaakXgyacPRkDBXg664RoOGcpy6SiJ9r4nTtoqDpI4SQU4rBXoG6I-zlEPLRnNAbm&__tn__=%2CO%2CP-R,10,0,positive,10
pfbid032yYaxSQEpmR9taCR7tYx6unxPKHQ3iNPooYoiH4UBTPZEFQVumDkJYhqs35wiQQAl,NVIDIA AI,0,12,0,0,1,0,0,0,13,2,What is digital fingerprinting and how do you maximize its value? Learn how to safeguard your networks and assets with digital fingerprinting and NVIDIA Morpheus.,2022-10-18T00:00:00,[],https://external.fcai19-7.fna.fbcdn.net/emg1/v/t13/1484815288097441450?url=https%3A%2F%2Fdeveloper-blogs.nvidia.com%2Fwp-content%2Fuploads%2F2022%2F10%2Frouter-box-featured.jpg&fb_obo=1&utld=nvidia.com&stp=c0.5000x0.5000f_dst-jpg_flffffff_p500x261_q75&ccb=13-1&oh=06_AbEx8ExiebTPwZ6b1ViO9Qdq7SGl5ZlJEYL8rbtpbsdKTA&oe=64E076A1&_nc_sid=dbad39,https://www.facebook.com/NVIDIAAI/posts/pfbid032yYaxSQEpmR9taCR7tYx6unxPKHQ3iNPooYoiH4UBTPZEFQVumDkJYhqs35wiQQAl?__cft__[0]=AZVO5_2oNiiNeZY7FASfL26OIEn7HHhgem_dVzKZ7051ZRl9kKOcW_DIQQ3a46P_rc-v3CvAk4Ddysg15JbfuI6Xru18JZonJAwviW3GOhS9Tnvn6kS1spzuq_fyV7gJzoWGyLzQpEs5eLhzJp0g085t2f78Nu7tuIwP-x9r9X8fE7YRdnVTCdpTPItuD8678PvihCKZntO-2j7fNDvBAKpj&__tn__=%2CO%2CP-R,13,0,positive,13
pfbid02KQd6ALsa8o2PH1tSgpXwDZw5VoMs6Lp1MMTCHGqy5f6rCenNNA3tJ7kBaEQditkVl,NVIDIA AI,0,6,0,0,1,0,0,0,7,3,"Detecting cyber-threats in near real-time has never been more important. In NVIDIA's upcoming webinar, hear from Booz Allen Hamilton on the latest approaches to securing sensitive data and how federal agencies can get started today. Register now! #Cybersecurity",2022-10-17T00:00:00,[],https://external.fcai19-7.fna.fbcdn.net/emg1/v/t13/15427946589086348585?url=https%3A%2F%2Fprod2-sprcdn-assets.sprinklr.com%2F50276%2F605261c8-61b5-426a-abe8-f2ff46a661ed-1827243652%2Fgtc-22-spring-social-promo-pac.jpeg&fb_obo=1&utld=sprinklr.com&stp=c0.5000x0.5000f_dst-jpg_flffffff_p500x261_q75&ccb=13-1&oh=06_AbGf6yTa7IBcdXWmKEVT3F6eWASwUsCA2oXZYBHzo8P0tQ&oe=64E08459&_nc_sid=dbad39,https://www.facebook.com/NVIDIAAI/posts/pfbid02KQd6ALsa8o2PH1tSgpXwDZw5VoMs6Lp1MMTCHGqy5f6rCenNNA3tJ7kBaEQditkVl?__cft__[0]=AZUpUb3Wl92wo1M8WKaDvHvQ0Tv6llu3ddxF8B9M-63s-czwE8BOAnf0NRLcawScf2kgRUN7r_JYYo3UC5Bsu4c7bNNVTBfr7uAgOm9WqS66jNMNs8vzVIPs94tcGkWOcQQUxJ54JdXtgKMtH4-i2Jch3sM-8YLyAhX_Zh3NZCoxcExXvkRhn-5brhN-O668P7vC_p_MP2n92VFUfn-Nuy9k&__tn__=%2CO%2CP-R,7,0,positive,7
1056357271697208,NVIDIA AI,0,3,0,0,1,0,0,0,4,0,Explore our scheduling-in-practice sessions at #Informs to get training and insights on solving job shop scheduling problem. Register today! https://nvda.ws/3CxgN5S,2022-10-17T00:00:00,[],https://scontent.fcai19-7.fna.fbcdn.net/v/t39.30808-6/312131992_1056357265030542_738751340310210791_n.png?_nc_cat=101&ccb=1-7&_nc_sid=9267fe&_nc_ohc=ExdnFaLZuOYAX9t4Et0&_nc_ht=scontent.fcai19-7.fna&oh=00_AfCyKr8csnF95APm2dsZg01kO9nzEBSXbU_1XCpFPbxE4g&oe=64E2E337,https://www.facebook.com/NVIDIAAI/photos/a.119492422050369/1056357271697208/?__cft__[0]=AZXx7TnRbhHGi6QI0UfN4arc-QyrSegzqPMYCbrQ8Qm047QR_qqblgjziBWQc_s6Ptnyt18n9WQrQahiOMs7BbPyvz_TwX4CbF2PvbTkin_4RSPwAj3sChbQCVrQwP02EO-__E6l3W851L2Q1QIRJWc3RvySzVMR6DCIUaRliae6fcszLvHcER9xCc34xD4SYxGzZlv1CHxHkMehMBjKjkAI&__tn__=%2CO%2CP-R,4,0,positive,4
1056327151700220,NVIDIA AI,0,7,0,0,1,0,0,0,8,0,Transforming your data? Get tips on how to unlock peak performance using custom kernels and libcudf’s device-side utilities: https://nvda.ws/3TjNfiU,2022-10-17T00:00:00,[],https://scontent.fcai19-7.fna.fbcdn.net/v/t39.30808-6/312095631_1056327148366887_6775028026633090938_n.png?_nc_cat=106&ccb=1-7&_nc_sid=9267fe&_nc_ohc=VMz-4aIMIgMAX9EWD4w&_nc_ht=scontent.fcai19-7.fna&oh=00_AfDg2PtmZxr0td2zoBmvV_8E_N5kkxhLIIwDZV01ldBHdA&oe=64E4689A,https://www.facebook.com/NVIDIAAI/photos/a.119492422050369/1056327151700220/?__cft__[0]=AZU6iB0UJlEholVZqnAcdyp__GZcBOakC0HNr90udlcjYeWuIHbwKcvDtvUblBVDv4ySlRjpN1kHn0oPvwkMSGbEh3XPQvQdkRo6v2T3dJzbIJ4_syMIKABQ6L2Fsd7a8GUcdjKDSzruJew09hhcNVcTb6HyYDoSayQK8kjHYmRjuikjET66Mn9zlrmRZsDPbWSUd1SzGYo5qYoA1dIyvsyP&__tn__=%2CO%2CP-R,8,0,positive,8
1055740551758880,NVIDIA AI,0,16,2,0,1,0,0,0,19,4,"Build #SciML models that speed up simulations 100x to 1000x! Integrated with Azure NVIDIA #GPU Clusters, @RocketML's solutions allows users to instantly scale out complex #MachineLearning pipelines. https://nvda.ws/3JPhhHR",2022-10-16T00:00:00,[],https://scontent.fcai19-7.fna.fbcdn.net/v/t39.30808-6/312045828_1055740548425547_4044634200609541256_n.jpg?stp=dst-jpg_s600x600&_nc_cat=108&ccb=1-7&_nc_sid=9267fe&_nc_ohc=M3WIbcTGVUIAX-xzeQB&_nc_ht=scontent.fcai19-7.fna&oh=00_AfBXbtoHrYtbpYfDpmQUR0CuD19neWpKgOf7RhIP7r41Tw&oe=64E35E5A,https://www.facebook.com/NVIDIAAI/photos/a.119492422050369/1055740551758880/?__cft__[0]=AZUexl3TZgAmDmlAIbL8oQQ8es_B5wcGlklE9cB6-rxa7EbNJBDWzb1KZyeqTi-vxCpIUxu-PIZUp9OKaBjzOaKfH94trIAxMaq1K-6i4xpq8cT-hP5oZNQrnC12KbWCBDirPYgfY_Z_r15R-j5EBLTf496A9Ay9AAB0H9HA9gTtzvQAAW1VwwlQgZb1fJ_lddDPgFNP93P1PfvSnrRa8z9V&__tn__=%2CO%2CP-R,19,0,positive,19
1055685501764385,NVIDIA AI,0,6,0,0,1,0,0,0,7,1,"Learn how #NVIDIAOmniverse & #DRIVESim on #Azure are providing the digital twin environment to train, test & validate autonomous driving systems; streamline factory design; & create immersive experiences. Watch now! https://nvda.ws/3TmLIsh #MSIgnite",2022-10-16T00:00:00,[],https://scontent.fcai19-7.fna.fbcdn.net/v/t39.30808-6/312063847_1055685498431052_3888687547393209748_n.jpg?stp=dst-jpg_s960x960&_nc_cat=102&ccb=1-7&_nc_sid=9267fe&_nc_ohc=PRiC6UrnELIAX9myX3h&_nc_oc=AQmAN4pPTiuhpZKxCj78NTnN12-RRMY0L0eHArkVldSQV_MWr7va_u_toI9i8VVAI30&_nc_ht=scontent.fcai19-7.fna&oh=00_AfB-R1JY_XnxnCaxYEABbr0yAXcIUQjVBtrn2xjH5BhQow&oe=64E31E75,https://www.facebook.com/NVIDIAAI/photos/a.119492422050369/1055685501764385/?__cft__[0]=AZUjfDJUFNy9GkRlO7Zh1c2Sd7XklLmp8-jz3ajuxXbTSwL3mcC2tsPWjAgyzYLjFgRSoiEtdGrlp8p23rkHCZetpcCVXhj1lQjpmOjaN-RU6MHXoaVUSSn149Oib4EnZLZ_LcoNfuhv1dod_gpsZ7uS8i7OQeTbWeCbKbd-XiMWP4O3M0BGJZ9TYkCLszntcO25BbpelPW0y0pGxDTvnASI&__tn__=%2CO%2CP-R,7,0,positive,7
1055026845163584,NVIDIA AI,0,17,0,0,1,0,0,0,18,1,"Transform your risk processes with Riskfuel, powered by Azure and NVIDIA. Learn how ultra-fast and accurate derivatives pricing with #DeepLearning is accelerating the power of trading models. Watch here https://nvda.ws/3vZNHJK",2022-10-15T00:00:00,[],https://scontent.fcai19-7.fna.fbcdn.net/v/t39.30808-6/311994826_1055026841830251_4666571868416304540_n.png?_nc_cat=103&ccb=1-7&_nc_sid=9267fe&_nc_ohc=zRBKhxNaU1kAX_XH6ku&_nc_ht=scontent.fcai19-7.fna&oh=00_AfAtFTlghZo4hHt-UguDcbgVuTuiX9bbRjdq5OLpCzav8A&oe=64E42DD8,https://www.facebook.com/NVIDIAAI/photos/a.119492422050369/1055026845163584/?__cft__[0]=AZVk36m5afOeUuByht5z4SCa6KkUWum4cJr9x7lpEjGYpdt5w4kKOsSyq8YeIWcBwOfnGPsHzHc-57dNd2XveCjTAlSRbDPYXE574jabRiZ1ncM8fIrTg6q_EPBeqG3eMZUD6y5otq_0oabaWEyku0m9uK4wIR5rkHlsyASK3of5EztK03MWZ2VstcjC31YIihFCVrrJxm5Tp4VyxWKpSRIE&__tn__=%2CO%2CP-R,18,0,positive,18
1054970755169193,NVIDIA AI,0,7,1,0,1,0,0,0,9,2,"Learn how to create & deploy custom, production-ready #AI models with #NVIDIATAO & NVIDIA Triton on #AzureML. Watch now! https://nvda.ws/3EKD3Mi #MSIgnite",2022-10-15T00:00:00,[],https://scontent.fcai19-7.fna.fbcdn.net/v/t39.30808-6/311977091_1054970751835860_4796124185042602532_n.jpg?stp=dst-jpg_s960x960&_nc_cat=111&ccb=1-7&_nc_sid=9267fe&_nc_ohc=GfI-PVzk3zIAX9Uz9X-&_nc_ht=scontent.fcai19-7.fna&oh=00_AfBut8GeXbLa1jRAYYq79Q6VZxFTeExwbxFlo2-gOzDWww&oe=64E4A0F0,https://www.facebook.com/NVIDIAAI/photos/a.119492422050369/1054970755169193/?__cft__[0]=AZUcDnprAUCOb1-mWuqQ0Ukdmv_43_UvCfKH3V02RIj8L8envLNyNulrq801PiyNJfUgeHBf72-CPnXYK0_PBLQ_0EKKDmvPS-mu8sQ7pIM9xLp8mk9ZSxBobRvJZPbiCMbR9FRMJpEsX1g9NbbhxEcd6laS7YvK4oTe8b3uRWzmwa6KqqvUw4LlCjQ6VfKZ0Fhy-sG29e1FeZfpsXW69MUV&__tn__=%2CO%2CP-R,9,0,positive,9
pfbid025rxyhax1HYCCSXLHAmKepEzUy8Fra4j2oY4ZQwJKRFYUCDHw5ryQSetgHRKhvzFpl,NVIDIA AI,0,6,0,0,1,0,0,0,7,1,"Smart cities. Remote surgeries. Autonomous vehicles. Thanks to #edgecomputing, innovative technologies are made possible.But what is edge computing, and how does it work? Read this blog to find out. https://nvda.ws/3EGfZhG",2022-10-14T00:00:00,[],https://external.fcai19-7.fna.fbcdn.net/emg1/v/t13/5095659687877064035?url=https%3A%2F%2Fblogs.nvidia.com%2Fwp-content%2Fuploads%2F2019%2F10%2Fblog-edge-computing-301-1920x1080-1.jpg&fb_obo=1&utld=nvidia.com&stp=c0.5000x0.5000f_dst-jpg_flffffff_p500x261_q75&ccb=13-1&oh=06_AbFrzO_SnoKCtFQyOaGf_eBO7_MK6M6Y5LYomibC-Zq1tQ&oe=64E09F4B&_nc_sid=dbad39,https://www.facebook.com/NVIDIAAI/posts/pfbid025rxyhax1HYCCSXLHAmKepEzUy8Fra4j2oY4ZQwJKRFYUCDHw5ryQSetgHRKhvzFpl?__cft__[0]=AZU_VFTRqg5o-BCXy066YomMCmoQ_XlzwKS5doKR9LLSX0Yvr7bO9-qu3JhI4CtudzI2wU7VJdEkX-pYIcos-gn5I6IxkK53AT8P9hdQyT2a8OB3Uq2W-QBZ717jE2xY-73j4Zp_NmSGCML3N9boJ5k5UshHgOKLwS2u3adeBC8syN6Bpeb2Mw6jsC9oJUSrOLaYAsP3q4he2CCaJJ5MRzkJ&__tn__=%2CO%2CP-R,7,0,positive,7
pfbid0UH7XTZy6xTfPiqYksMwHxAgbavrwFYvPrAoAwUcN3h9nZU5jbVMSF76YEmbU5U11l,NVIDIA AI,3,10,1,0,1,0,0,0,12,1,What does it take to break into the field of #cybersecurity and #AI? Here are five tips for building a cybersecurity career in the Age of AI. #CybersecurityAwarenessMonth,2022-10-14T00:00:00,[],https://external.fcai19-7.fna.fbcdn.net/emg1/v/t13/11393138047782259480?url=https%3A%2F%2Fdeveloper-blogs.nvidia.com%2Fwp-content%2Fuploads%2F2022%2F10%2Fimage3-3.jpg&fb_obo=1&utld=nvidia.com&stp=c0.5000x0.5000f_dst-jpg_flffffff_p500x261_q75&ccb=13-1&oh=06_AbF1dKNg7eoQV0j7sB-6si2e-YHSLTy29AgAsTbZeygf9g&oe=64E01A83&_nc_sid=dbad39,https://www.facebook.com/NVIDIAAI/posts/pfbid0UH7XTZy6xTfPiqYksMwHxAgbavrwFYvPrAoAwUcN3h9nZU5jbVMSF76YEmbU5U11l?__cft__[0]=AZWk2kngM0iaiRQr_Ti0UcUh3Y653lBSBPL84KTi_t_P3U_DlWofr1qevOi262WU9Q-C9_IGuCt1R9vql5WO6aEMfhHwmI7n8GwXmRJdVYJ7dBNIB8cNDwJOkyh349FyW7VW65evPaNE6ddrXTsEZbIwOSEVpjZ7DolLIEAWEA-qkOZbSB0YNnQXVlpoMR6nZaVwdbeX7ubbexW8az532yeZ&__tn__=%2CO%2CP-R,15,0,positive,15
pfbid02G1AuV9x9UsL1fiU3MXuQjoXmSf2zHBRVrB2xGALaVvJmSRKp7pCzHS3JUdMLHvd5l,NVIDIA AI,0,9,0,0,1,0,0,0,10,0,"Don't miss this NVIDIA session at CAMLIS, taking place in Arlington, VA on October 20 at 10:30 a.m. ET. Tadesse ZeMicheal will dive into using heterogenous graph embedding for malicious Azure AD sign-in detection. Register now.",2022-10-14T00:00:00,[],https://external.fcai19-7.fna.fbcdn.net/emg1/v/t13/8007188236285082251?url=http%3A%2F%2Fstatic1.squarespace.com%2Fstatic%2F59b5d23659cc681cdd75f9dc%2Ft%2F5aec6fcd70a6ad2a295f2a9a%2F1647565518808%2Fcamlis%2Blogo%2Bblue.png%3Fformat%3D1500w&fb_obo=1&utld=squarespace.com&stp=c0.5000x0.5000f_dst-jpg_flffffff_p500x261_q75&ccb=13-1&oh=06_AbFPC3QIsT4CdUvkC47Ucm7wU2YUgkV4eFxCdUj7xbelvA&oe=64E09E9E&_nc_sid=dbad39,https://www.facebook.com/NVIDIAAI/posts/pfbid02G1AuV9x9UsL1fiU3MXuQjoXmSf2zHBRVrB2xGALaVvJmSRKp7pCzHS3JUdMLHvd5l?__cft__[0]=AZWYsMdtmwmpYL4Ontij7WENfpELb3CQqPeypQy-TKOGW-0Ge-qTGI-JwQ_XBvBmQbq-xzzBdhElxUG6wyakszYzdis-BiSiynLE72AesrVTvQZWbwK300OJgRxIKKnh-JqTYfOyLFON43aN8Xg0zfdO7XyrAlTnFKXc3EsGlSAIoDoyouTt28knzLe_q3rVx3TLAUT6TxOucRtwShLKdCgi&__tn__=%2CO%2CP-R,10,0,positive,10
pfbid0BMrqXN2yiQJqFCNsafyYxf2fhvzqJewN63rzS8y77D2a9BeX59nk21TkucHto1tAl,NVIDIA AI,0,6,0,0,0,0,0,0,6,1,NVIDIA and Oracle are delivering access to accelerated data processing in the cloud and supporting the fastest environment for the most demanding workloads. Register and join us as we explore the intersection of #AI and cloud computing at Oracle #CloudWorld. #OCW,2022-10-13T00:00:00,[],https://external.fcai19-7.fna.fbcdn.net/emg1/v/t13/6792682343729340796?url=https%3A%2F%2Fprod2-sprcdn-assets.sprinklr.com%2F50276%2Ff8417bf9-e890-4b8c-98c8-03b863e8e7fc-1366627474%2FCopy_of_oracle-logo-lockup-pro.png&fb_obo=1&utld=sprinklr.com&stp=c0.5000x0.5000f_dst-jpg_flffffff_p500x261_q75&ccb=13-1&oh=06_AbH6rnJTXL2x0sAnDCiLUUohNKENWY28VSk0QpZP6er59A&oe=64E08164&_nc_sid=dbad39,https://www.facebook.com/NVIDIAAI/posts/pfbid0BMrqXN2yiQJqFCNsafyYxf2fhvzqJewN63rzS8y77D2a9BeX59nk21TkucHto1tAl?__cft__[0]=AZXfaqbZhe0I5otSnFymu4eUJu1e6pZSZgsQ1zWS-QolNM27bn5Bds7HRQEIJnWf5iZOyjIJiRJg2F39FFunHnfYayhLvpHWrLhUd72Hi51GM49alNMPLsfiJgN_UXzEkmM7TnLThh2kG8KFP-s4PF_3d_IcPvv1J4iP3xgVxJyrud8N-t5lwu6DI2g3DjzjwxloQziuq1S7TwHf_ke_QVxrr3GF7dyhq-o_-TJAqspeqa1PORakO-V7ju3MsZOdyR8&__tn__=%2CO%2CP-R,6,0,positive,6
1053629025303366,NVIDIA AI,0,9,0,0,1,0,0,0,10,0,"In 2 weeks at #Money2020USA, meet the innovative fintechs that are using #AI and machine learning for #ESG, fraud prevention, lending, #payments, and more. Explore the Product and AI Innovation Zone, powered by Amazon Web Services and NVIDIA, to learn more: https://nvda.ws/3CNDe81",2022-10-13T00:00:00,[],https://scontent.fcai19-7.fna.fbcdn.net/v/t39.30808-6/311682702_1053629018636700_6399057604339250598_n.jpg?stp=dst-jpg_p526x296&_nc_cat=103&ccb=1-7&_nc_sid=9267fe&_nc_ohc=0t6WWoh7ujIAX8GleML&_nc_ht=scontent.fcai19-7.fna&oh=00_AfAFINXkgl67xZRB-0fFcfNwApwIKlILkoJkM8ZNoUbvKg&oe=64E2E300,https://www.facebook.com/NVIDIAAI/photos/a.119492422050369/1053629025303366/?__cft__[0]=AZUlb7P41RpSiguM11FFR8xpGcGaDHLiszbPbKnw1IFsJ75aheHMeAq07eaLJrwqruvSjYzxFRKdOcT8zZp6lLytuzLauTCLe4JeMb6Xk21NIQ7_IhFATJ6r26yR8bDOUNG0QoGcc44sDq7QUf3zrIEHFJ0lVxSeVX_U8Gd8t-X7qVU-09dt8JYbPJxrZ94Wu3MrhC2bOYCDkzJcgT11CyR1&__tn__=%2CO%2CP-R,10,0,positive,10
1053598458639756,NVIDIA AI,0,5,1,0,1,0,0,0,7,1,"Join our webinar on Oct 25th as we discuss how #deeplearning has enabled researchers to effectively search through chemical space, and design de novo molecules that aim to treat disease. #DrugDiscovery Register Today. https://nvda.ws/3fwtLsU",2022-10-13T00:00:00,[],https://scontent.fcai19-7.fna.fbcdn.net/v/t39.30808-6/311697084_1053598451973090_4209004265904153408_n.jpg?stp=dst-jpg_p180x540&_nc_cat=103&ccb=1-7&_nc_sid=9267fe&_nc_ohc=1vCS0wTAz4EAX_b_8Vm&_nc_ht=scontent.fcai19-7.fna&oh=00_AfAHg9o5DKB0Xda_I5zEbngtqp19bwyVRTlV57KH8z0DEA&oe=64E38951,https://www.facebook.com/NVIDIAAI/photos/a.119492422050369/1053598458639756/?__cft__[0]=AZV11jl8uUqIoJnG-h5yPu2v_q4EhfIGm4X4xC1SysEKD5gRCmdMEGrYpbswSVVqM4CTTibgk9tZwruqnQGj-TGTkK662Sp0M0-fKHnEJL_DDzU5bqQuR0AYHIVCGFo5KWZ8Dfrk7MV6cHwz1un4EUPnfXJlJUrhhgbe5zXiRHFfwqGJOlz-v7gRiE8sg_BTj3ITvPhNFdmi8Av-KhmENSkd&__tn__=%2CO%2CP-R,7,0,positive,7
1053569375309331,NVIDIA AI,0,6,0,0,1,0,0,0,7,0,Join our session at #Informs and learn how parallel vehicle routing optimization for heterogeneous fleets improved and the quality and efficiency of GPU-based vehicle routing solver: https://nvda.ws/3CTPAeT,2022-10-13T00:00:00,[],https://scontent.fcai19-7.fna.fbcdn.net/v/t39.30808-6/311661154_1053569371975998_7688653518169017079_n.png?_nc_cat=104&ccb=1-7&_nc_sid=9267fe&_nc_ohc=UqeLDgPh68EAX90mhTk&_nc_ht=scontent.fcai19-7.fna&oh=00_AfCr0X964Uw9deM3ECa_Cn29s5g4ClCUcSR5597puXP5uA&oe=64E32061,https://www.facebook.com/NVIDIAAI/photos/a.119492422050369/1053569375309331/?__cft__[0]=AZUn_MW01-K34m603zJ56f5GqYhDaQQV7DqhknU2tiBnync3Sb0pKC2syt19B695BopOFlKMmt9D90dx6LN-GDcPs-wx7v7ZwShl09ZLd4bP99ymVI8cQfh_vfdXBvwPQ2CQPNVYiURJP1JQtB9b5Vsff_hi4Jdpo2qzTi-Hx9lru62ik7do2d5jJLRHPWnU-D4ySJqTeS6poJVBJktOgArd&__tn__=%2CO%2CP-R,7,0,positive,7
1053536068645995,NVIDIA AI,0,5,0,0,1,0,0,0,6,2,Learn about speech representation learning and how it paved the way for textless NLP to generate expressive speech from Meta. Register free for the NVIDIA Speech AI Summit: https://nvda.ws/3EDb6WO,2022-10-13T00:00:00,[],https://scontent.fcai19-7.fna.fbcdn.net/v/t39.30808-6/311718485_1053536061979329_4701597964209273037_n.jpg?stp=dst-jpg_p180x540&_nc_cat=102&ccb=1-7&_nc_sid=9267fe&_nc_ohc=nv6LLdittL8AX_XCGp4&_nc_ht=scontent.fcai19-7.fna&oh=00_AfCYiOQ_MtbPeZBzWxhVtw5QrBkkymTOTWIqX-Qvlpc_ZA&oe=64E375C8,https://www.facebook.com/NVIDIAAI/photos/a.119492422050369/1053536068645995/?__cft__[0]=AZVosAfWH9zXygig1OaeiGw9cNW-rUMljoHCcaVYkzyM-QGooanX8GGUXNPiP0IJv3TTKfG3nJYpXBzL08JliPgTsA6zVDcazv1AzlLpe2Iz-iyb3Gd4DK5AxSaL3jrN3O0_yHm7zduD_kvlFOVlT_TBn6Uc9LZNHVFG1BqyofQv3pxiDNGrEeDN9AqF4fGYCpL0kth4uBHdPvFTKjYuswqG&__tn__=%2CO%2CP-R,6,0,positive,6
pfbid02F8c9p5sPoogr5rgN4C7YFMXCvFD2xR1sGMNZmVd5gxbFCMBjf4HNkBEbJcwctWqnl,NVIDIA AI,0,14,0,0,1,0,0,0,15,3,Learn how to implement multiple AI-based approaches to solve a specific use case of identifying network intrusions for telecommunications. Register now for the 11/16 workshop: https://nvda.ws/3CARG3a #NVDLI,2022-10-13T00:00:00,[],https://external.fcai19-7.fna.fbcdn.net/emg1/v/t13/570738748290468285?url=https%3A%2F%2Fprod2-sprcdn-assets.sprinklr.com%2F50276%2Fba2e71f2-a1fe-4a25-b38f-15dc965ffb15-681032142%2Fdli-workshops-anomaly-detectio.jpg&fb_obo=1&utld=sprinklr.com&stp=c0.5000x0.5000f_dst-jpg_flffffff_p500x261_q75&ccb=13-1&oh=06_AbGcsa-YkdM6jO8xpfUf-J806TMQnoIzHGChIL4D309uyQ&oe=64E06281&_nc_sid=dbad39,https://www.facebook.com/NVIDIAAI/posts/pfbid02F8c9p5sPoogr5rgN4C7YFMXCvFD2xR1sGMNZmVd5gxbFCMBjf4HNkBEbJcwctWqnl?__cft__[0]=AZXBs5IUnJOs-nZlvGjuTmZ3-jmjYgsU-ArKfQgGEea1P9UzFz12vs9s0dEZteRXGdo2aeNmRmqOTYrXlk6TzrITFW8OFrATOA_CHF7Dr7XkJHU_J-ZOA4m8Ljyrx8SJgE7-mFd1iAjt_HLm7jwAVMQvT8jACcd_WlicYXEi1VwKzMK4J-CRnGK6W6niRkRNH4LTQcCPdZ-1h7twPqpOfPWR&__tn__=%2CO%2CP-R,15,0,positive,15
